ds,name,civ,labor,emp,unemp
2000-01-01,Alabama,3370052,2155396,2054501,100895
2000-01-01,Alaska,434957,319633,299870,19763
2000-01-01,Arizona,3813839,2497340,2395317,102023
2000-01-01,Arkansas,2017825,1266292,1211679,54613
2000-01-01,California,24941075,16664807,15837398,827409
2000-01-01,Colorado,3232278,2350618,2285246,65372
2000-01-01,Connecticut,2590032,1760389,1721240,39149
2000-01-01,Delaware,594204,406118,392385,13733
2000-01-01,Florida,12407981,7822185,7531066,291119
2000-01-01,Georgia,6041316,4172874,4023896,148978
2000-01-01,Hawaii,902870,606243,578581,27662
2000-01-01,Idaho,943015,656618,626419,30199
2000-01-01,Illinois,9333119,6526981,6244525,282456
2000-01-01,Indiana,4587654,3135118,3038427,96691
2000-01-01,Iowa,2229700,1593903,1554073,39830
2000-01-01,Kansas,1997430,1409187,1358376,50811
2000-01-01,Kentucky,3077024,1955366,1875237,80129
2000-01-01,Louisiana,3287577,2031853,1932931,98922
2000-01-01,Maine,990197,681190,655933,25257
2000-01-01,Maryland,3975785,2783617,2691746,91871
2000-01-01,Massachusetts,4914798,3354162,3250508,103654
2000-01-01,Michigan,7493672,5153554,4983267,170287
2000-01-01,Minnesota,3708892,2776344,2696809,79535
2000-01-01,Mississippi,2093329,1307058,1236272,70786
2000-01-01,Missouri,4223368,2961435,2872340,89095
2000-01-01,Montana,683919,470003,446727,23276
2000-01-01,Nebraska,1280495,937258,911648,25610
2000-01-01,Nevada,1499999,1048870,1007988,40882
2000-01-01,Ohio,8608455,5797908,5553680,244228
2000-01-01,Oklahoma,2573844,1658242,1606427,51815
2000-01-01,Oregon,2629730,1805513,1714341,91172
2000-01-01,Pennsylvania,9482812,6094090,5839250,254840
2000-01-01,Tennessee,4341004,2848463,2740564,107899
2000-01-01,Texas,15081764,10374888,9882205,492683
2000-01-01,Utah,1570259,1132480,1096923,35557
2000-01-01,Vermont,470949,333451,324117,9334
2000-01-01,Virginia,5281445,3591840,3498977,92863
2000-01-01,Washington,4440427,3082251,2933306,148945
2000-01-01,Wisconsin,4070114,2976661,2885231,91430
2000-01-01,Wyoming,372599,265096,254385,10711
2000-02-01,Alabama,3370854,2155360,2055016,100344
2000-02-01,Alaska,435948,319868,300021,19847
2000-02-01,Arizona,3820622,2498683,2398154,100529
2000-02-01,Arkansas,2019236,1266602,1212498,54104
2000-02-01,California,24967167,16709195,15880102,829093
2000-02-01,Colorado,3238256,2352798,2288901,63897
2000-02-01,Connecticut,2590495,1763187,1724811,38376
2000-02-01,Delaware,594280,407498,393590,13908
2000-02-01,Florida,12424337,7847658,7555736,291922
2000-02-01,Georgia,6049327,4180891,4032279,148612
2000-02-01,Hawaii,903001,606667,579529,27138
2000-02-01,Idaho,945015,657658,627655,30003
2000-02-01,Illinois,9334368,6529947,6246588,283359
2000-02-01,Indiana,4588221,3135810,3039102,96708
2000-02-01,Iowa,2230028,1593990,1553843,40147
2000-02-01,Kansas,1997441,1409276,1357876,51400
2000-02-01,Kentucky,3078073,1956533,1877374,79159
2000-02-01,Louisiana,3287598,2032546,1933151,99395
2000-02-01,Maine,991173,682105,657687,24418
2000-02-01,Maryland,3977610,2786471,2693546,92925
2000-02-01,Massachusetts,4916788,3352184,3251345,100839
2000-02-01,Michigan,7495371,5157825,4990893,166932
2000-02-01,Minnesota,3712577,2781831,2701685,80146
2000-02-01,Mississippi,2093431,1310521,1238908,71613
2000-02-01,Missouri,4224950,2964402,2874153,90249
2000-02-01,Montana,684885,470860,447794,23066
2000-02-01,Nebraska,1281738,938453,912768,25685
2000-02-01,Nevada,1503925,1053251,1012120,41131
2000-02-01,Ohio,8607384,5798706,5555505,243201
2000-02-01,Oklahoma,2575032,1657431,1606463,50968
2000-02-01,Oregon,2632000,1808765,1717663,91102
2000-02-01,Pennsylvania,9482422,6094604,5842749,251855
2000-02-01,Tennessee,4343599,2851078,2743359,107719
2000-02-01,Texas,15101365,10385344,9897422,487922
2000-02-01,Utah,1572707,1134577,1099168,35409
2000-02-01,Vermont,471973,333755,324594,9161
2000-02-01,Virginia,5286573,3596089,3505996,90093
2000-02-01,Washington,4443671,3087622,2937092,150530
2000-02-01,Wisconsin,4072569,2979133,2887250,91883
2000-02-01,Wyoming,372620,265239,254918,10321
2000-03-01,Alabama,3371656,2154461,2054647,99814
2000-03-01,Alaska,435940,320075,300110,19965
2000-03-01,Arizona,3826406,2499507,2399905,99602
2000-03-01,Arkansas,2021648,1265831,1212273,53558
2000-03-01,California,24998258,16748830,15915844,832986
2000-03-01,Colorado,3243233,2354449,2291441,63008
2000-03-01,Connecticut,2590958,1764456,1726813,37643
2000-03-01,Delaware,595356,408910,394744,14166
2000-03-01,Florida,12441692,7869137,7575359,293778
2000-03-01,Georgia,6059337,4188003,4039056,148947
2000-03-01,Hawaii,903133,606814,580108,26706
2000-03-01,Idaho,946016,658517,628488,30029
2000-03-01,Illinois,9338617,6527138,6242216,284922
2000-03-01,Indiana,4590789,3134968,3037517,97451
2000-03-01,Iowa,2231356,1592732,1552218,40514
2000-03-01,Kansas,1998453,1408777,1356943,51834
2000-03-01,Kentucky,3080123,1957158,1878502,78656
2000-03-01,Louisiana,3287619,2032404,1932080,100324
2000-03-01,Maine,992150,682282,658651,23631
2000-03-01,Maryland,3980435,2788961,2694531,94430
2000-03-01,Massachusetts,4918778,3348539,3250360,98179
2000-03-01,Michigan,7497071,5161206,4993328,167878
2000-03-01,Minnesota,3717262,2785765,2705435,80330
2000-03-01,Mississippi,2094533,1313326,1240963,72363
2000-03-01,Missouri,4227531,2966277,2874900,91377
2000-03-01,Montana,684851,471352,448406,22946
2000-03-01,Nebraska,1281982,939217,913464,25753
2000-03-01,Nevada,1508850,1057299,1015788,41511
2000-03-01,Ohio,8608314,5796621,5554077,242544
2000-03-01,Oklahoma,2576221,1656371,1606060,50311
2000-03-01,Oregon,2633271,1811429,1719558,91871
2000-03-01,Pennsylvania,9484032,6094109,5843115,250994
2000-03-01,Tennessee,4346194,2852691,2744529,108162
2000-03-01,Texas,15122966,10387976,9907586,480390
2000-03-01,Utah,1574156,1136540,1100892,35648
2000-03-01,Vermont,471997,333880,324816,9064
2000-03-01,Virginia,5291701,3598402,3511053,87349
2000-03-01,Washington,4447914,3090786,2938274,152512
2000-03-01,Wisconsin,4075025,2981108,2887713,93395
2000-03-01,Wyoming,372642,265312,255278,10034
2000-04-01,Alabama,3374388,2152933,2053544,99389
2000-04-01,Alaska,434498,320208,300087,20121
2000-04-01,Arizona,3821926,2500107,2400733,99374
2000-04-01,Arkansas,2022461,1264225,1211183,53042
2000-04-01,California,25034666,16782816,15944622,838194
2000-04-01,Colorado,3245428,2355634,2292619,63015
2000-04-01,Connecticut,2589182,1764216,1727157,37059
2000-04-01,Delaware,594827,410285,395778,14507
2000-04-01,Florida,12431288,7886709,7590406,296303
2000-04-01,Georgia,6061556,4193495,4043703,149792
2000-04-01,Hawaii,898109,606544,580150,26394
2000-04-01,Idaho,946982,659204,628958,30246
2000-04-01,Illinois,9328045,6519408,6232675,286733
2000-04-01,Indiana,4591689,3133462,3034967,98495
2000-04-01,Iowa,2230938,1590764,1549882,40882
2000-04-01,Kansas,1997350,1407475,1355365,52110
2000-04-01,Kentucky,3080332,1957215,1878639,78576
2000-04-01,Louisiana,3287478,2030975,1929509,101466
2000-04-01,Maine,991786,681689,658698,22991
2000-04-01,Maryland,3981648,2791240,2694918,96322
2000-04-01,Massachusetts,4916613,3343298,3247355,95943
2000-04-01,Michigan,7502107,5163621,4989797,173824
2000-04-01,Minnesota,3719417,2788458,2707937,80521
2000-04-01,Mississippi,2092736,1315163,1242351,72812
2000-04-01,Missouri,4225858,2966814,2874298,92516
2000-04-01,Montana,685731,471489,448564,22925
2000-04-01,Nebraska,1281742,939417,913616,25801
2000-04-01,Nevada,1508246,1060995,1019028,41967
2000-04-01,Ohio,8611098,5792324,5549896,242428
2000-04-01,Oklahoma,2575814,1655441,1605448,49993
2000-04-01,Oregon,2634245,1813558,1720353,93205
2000-04-01,Pennsylvania,9475946,6093113,5840938,252175
2000-04-01,Tennessee,4346560,2853015,2743803,109212
2000-04-01,Texas,15133460,10384688,9912894,471794
2000-04-01,Utah,1574374,1138282,1102093,36189
2000-04-01,Vermont,473116,333850,324776,9074
2000-04-01,Virginia,5282458,3598550,3513704,84846
2000-04-01,Washington,4450803,3091286,2936523,154763
2000-04-01,Wisconsin,4077259,2982659,2886607,96052
2000-04-01,Wyoming,372257,265339,255457,9882
2000-05-01,Alabama,3376115,2150985,2051877,99108
2000-05-01,Alaska,434753,320231,299944,20287
2000-05-01,Arizona,3830993,2501145,2401520,99625
2000-05-01,Arkansas,2023966,1262138,1209613,52525
2000-05-01,California,25062445,16810519,15968867,841652
2000-05-01,Colorado,3252117,2356442,2292707,63735
2000-05-01,Connecticut,2590914,1762879,1726282,36597
2000-05-01,Delaware,595635,411530,396680,14850
2000-05-01,Florida,12448757,7900636,7602166,298470
2000-05-01,Georgia,6073419,4197324,4046670,150654
2000-05-01,Hawaii,898282,605902,579744,26158
2000-05-01,Idaho,948495,659726,629190,30536
2000-05-01,Illinois,9332844,6508674,6220982,287692
2000-05-01,Indiana,4595044,3131375,3032532,98843
2000-05-01,Iowa,2231626,1589019,1547705,41314
2000-05-01,Kansas,1998658,1405410,1353073,52337
2000-05-01,Kentucky,3082558,1956725,1877920,78805
2000-05-01,Louisiana,3288084,2028038,1925659,102379
2000-05-01,Maine,992520,680306,657796,22510
2000-05-01,Maryland,3985656,2793520,2695235,98285
2000-05-01,Massachusetts,4920344,3337096,3243031,94065
2000-05-01,Michigan,7507302,5164344,4981678,182666
2000-05-01,Minnesota,3723374,2790458,2709344,81114
2000-05-01,Mississippi,2094047,1315641,1243022,72619
2000-05-01,Missouri,4228880,2966631,2872430,94201
2000-05-01,Montana,686136,471303,448365,22938
2000-05-01,Nebraska,1282421,939063,913191,25872
2000-05-01,Nevada,1513401,1064454,1022010,42444
2000-05-01,Ohio,8614966,5786537,5544176,242361
2000-05-01,Oklahoma,2577332,1654880,1604931,49949
2000-05-01,Oregon,2636789,1814860,1720191,94669
2000-05-01,Pennsylvania,9477978,6092670,5838132,254538
2000-05-01,Tennessee,4350842,2851807,2741330,110477
2000-05-01,Texas,15156739,10378041,9915154,462887
2000-05-01,Utah,1577260,1139792,1102966,36826
2000-05-01,Vermont,473441,333746,324580,9166
2000-05-01,Virginia,5289327,3597380,3514656,82724
2000-05-01,Washington,4455649,3089352,2932549,156803
2000-05-01,Wisconsin,4080284,2983667,2884394,99273
2000-05-01,Wyoming,372357,265327,255504,9823
2000-06-01,Alabama,3378019,2148644,2049598,99046
2000-06-01,Alaska,435039,320117,299705,20412
2000-06-01,Arizona,3840218,2503023,2402986,100037
2000-06-01,Arkansas,2025602,1260023,1207919,52104
2000-06-01,California,25092141,16832375,15990881,841494
2000-06-01,Colorado,3258979,2356916,2292065,64851
2000-06-01,Connecticut,2592835,1761016,1724784,36232
2000-06-01,Delaware,596507,412534,397439,15095
2000-06-01,Florida,12467007,7911818,7612311,299507
2000-06-01,Georgia,6085633,4199914,4048982,150932
2000-06-01,Hawaii,898329,605064,579163,25901
2000-06-01,Idaho,950082,660119,629321,30798
2000-06-01,Illinois,9338109,6496583,6209465,287118
2000-06-01,Indiana,4598621,3127934,3030118,97816
2000-06-01,Iowa,2232483,1588514,1546565,41949
2000-06-01,Kansas,2000089,1402858,1350204,52654
2000-06-01,Kentucky,3084920,1955907,1876553,79354
2000-06-01,Louisiana,3288851,2024062,1920886,103176
2000-06-01,Maine,993373,678347,656162,22185
2000-06-01,Maryland,3989864,2795968,2695979,99989
2000-06-01,Massachusetts,4924321,3330999,3238498,92501
2000-06-01,Michigan,7512817,5162449,4971024,191425
2000-06-01,Minnesota,3727522,2792365,2709868,82497
2000-06-01,Mississippi,2095521,1314761,1242805,71956
2000-06-01,Missouri,4232096,2966275,2869637,96638
2000-06-01,Montana,686656,470868,447929,22939
2000-06-01,Nebraska,1283175,938411,912365,26046
2000-06-01,Nevada,1518690,1067871,1024845,43026
2000-06-01,Ohio,8619180,5779685,5537918,241767
2000-06-01,Oklahoma,2578950,1654551,1604477,50074
2000-06-01,Oregon,2639540,1815031,1718994,96037
2000-06-01,Pennsylvania,9480412,6093849,5836466,257383
2000-06-01,Tennessee,4355320,2849076,2737554,111522
2000-06-01,Texas,15181172,10371237,9916003,455234
2000-06-01,Utah,1580225,1141131,1103675,37456
2000-06-01,Vermont,473872,333622,324309,9313
2000-06-01,Virginia,5296457,3596215,3515274,80941
2000-06-01,Washington,4460652,3086127,2927485,158642
2000-06-01,Wisconsin,4083497,2983956,2881710,102246
2000-06-01,Wyoming,372540,265322,255494,9828
2000-07-01,Alabama,3379852,2145873,2046851,99022
2000-07-01,Alaska,435275,319867,299400,20467
2000-07-01,Arizona,3849529,2505807,2405631,100176
2000-07-01,Arkansas,2027169,1258163,1206327,51836
2000-07-01,California,25122108,16850862,16014170,836692
2000-07-01,Colorado,3265808,2357347,2291457,65890
2000-07-01,Connecticut,2594750,1759361,1723398,35963
2000-07-01,Delaware,597308,413349,398153,15196
2000-07-01,Florida,12485621,7922274,7623143,299131
2000-07-01,Georgia,6097791,4202076,4052099,149977
2000-07-01,Hawaii,898534,604284,578724,25560
2000-07-01,Idaho,951580,660540,629507,31033
2000-07-01,Illinois,9343505,6484866,6199132,285734
2000-07-01,Indiana,4602084,3123279,3028049,95230
2000-07-01,Iowa,2233194,1589606,1546820,42786
2000-07-01,Kansas,2001437,1400182,1347260,52922
2000-07-01,Kentucky,3087202,1955213,1875040,80173
2000-07-01,Louisiana,3289553,2020359,1916191,104168
2000-07-01,Maine,994123,676253,654293,21960
2000-07-01,Maryland,3994146,2799124,2697863,101261
2000-07-01,Massachusetts,4928325,3326572,3235403,91169
2000-07-01,Michigan,7518317,5157929,4960549,197380
2000-07-01,Minnesota,3731556,2795292,2710585,84707
2000-07-01,Mississippi,2096871,1312718,1241709,71009
2000-07-01,Missouri,4235242,2966424,2866872,99552
2000-07-01,Montana,687074,470286,447403,22883
2000-07-01,Nebraska,1283867,937760,911486,26274
2000-07-01,Nevada,1523973,1071444,1027679,43765
2000-07-01,Ohio,8623387,5772636,5532446,240190
2000-07-01,Oklahoma,2580531,1654254,1604129,50125
2000-07-01,Oregon,2642201,1814162,1717235,96927
2000-07-01,Pennsylvania,9482949,6097040,5837145,259895
2000-07-01,Tennessee,4359743,2845950,2733879,112071
2000-07-01,Texas,15205794,10367924,9918859,449065
2000-07-01,Utah,1583044,1142501,1104443,38058
2000-07-01,Vermont,474208,333546,324086,9460
2000-07-01,Virginia,5303617,3596648,3517376,79272
2000-07-01,Washington,4465758,3083380,2923136,160244
2000-07-01,Wisconsin,4086610,2984042,2879561,104481
2000-07-01,Wyoming,372630,265364,255502,9862
2000-08-01,Alabama,3381310,2143247,2044264,98983
2000-08-01,Alaska,435991,319621,299149,20472
2000-08-01,Arizona,3858859,2510014,2410099,99915
2000-08-01,Arkansas,2028445,1256863,1205114,51749
2000-08-01,California,25159823,16871299,16042831,828468
2000-08-01,Colorado,3273219,2358354,2292079,66275
2000-08-01,Connecticut,2596443,1758398,1722515,35883
2000-08-01,Delaware,597988,414252,399036,15216
2000-08-01,Florida,12508314,7934744,7636668,298076
2000-08-01,Georgia,6109604,4205615,4057671,147944
2000-08-01,Hawaii,899321,603799,578655,25144
2000-08-01,Idaho,953178,661239,630013,31226
2000-08-01,Illinois,9350076,6475245,6190137,285108
2000-08-01,Indiana,4604966,3118838,3026609,92229
2000-08-01,Iowa,2234016,1592249,1548545,43704
2000-08-01,Kansas,2002725,1398066,1344863,53203
2000-08-01,Kentucky,3089097,1955481,1874187,81294
2000-08-01,Louisiana,3290371,2018573,1913044,105529
2000-08-01,Maine,995112,674473,652725,21748
2000-08-01,Maryland,3999344,2803670,2701581,102089
2000-08-01,Massachusetts,4932825,3325514,3235303,90211
2000-08-01,Michigan,7523894,5152974,4952767,200207
2000-08-01,Minnesota,3736180,2800080,2712853,87227
2000-08-01,Mississippi,2097691,1310023,1240298,69725
2000-08-01,Missouri,4238910,2968461,2865279,103182
2000-08-01,Montana,687647,469716,446969,22747
2000-08-01,Nebraska,1284599,937517,911017,26500
2000-08-01,Nevada,1528991,1075476,1030790,44686
2000-08-01,Ohio,8628086,5767570,5529744,237826
2000-08-01,Oklahoma,2581871,1654069,1604248,49821
2000-08-01,Oregon,2645715,1812964,1715989,96975
2000-08-01,Pennsylvania,9486837,6102682,5841097,261585
2000-08-01,Tennessee,4363746,2844279,2732157,112122
2000-08-01,Texas,15232085,10371545,9927737,443808
2000-08-01,Utah,1586352,1144356,1105608,38748
2000-08-01,Vermont,474629,333652,324092,9560
2000-08-01,Virginia,5310692,3600535,3522749,77786
2000-08-01,Washington,4472133,3082534,2921222,161312
2000-08-01,Wisconsin,4090566,2984888,2879078,105810
2000-08-01,Wyoming,372824,265527,255633,9894
2000-09-01,Alabama,3382833,2141123,2042203,98920
2000-09-01,Alaska,436686,319468,299035,20433
2000-09-01,Arizona,3868349,2515959,2416580,99379
2000-09-01,Arkansas,2029809,1256360,1204522,51838
2000-09-01,California,25198907,16896624,16077742,818882
2000-09-01,Colorado,3280778,2360216,2294416,65800
2000-09-01,Connecticut,2598235,1757954,1721890,36064
2000-09-01,Delaware,598716,415453,400210,15243
2000-09-01,Florida,12531514,7950023,7652740,297283
2000-09-01,Georgia,6121592,4211500,4065922,145578
2000-09-01,Hawaii,900064,603783,579065,24718
2000-09-01,Idaho,954816,662304,631007,31297
2000-09-01,Illinois,9357007,6468288,6181872,286416
2000-09-01,Indiana,4607960,3115798,3025630,90168
2000-09-01,Iowa,2234909,1595899,1551361,44538
2000-09-01,Kansas,2004079,1397072,1343392,53680
2000-09-01,Kentucky,3091067,1956925,1874369,82556
2000-09-01,Louisiana,3291271,2019258,1912209,107049
2000-09-01,Maine,996165,673290,651738,21552
2000-09-01,Maryland,4004683,2809536,2707058,102478
2000-09-01,Massachusetts,4937430,3328808,3238983,89825
2000-09-01,Michigan,7529670,5150327,4948522,201805
2000-09-01,Minnesota,3740906,2806769,2717481,89288
2000-09-01,Mississippi,2098577,1307260,1239098,68162
2000-09-01,Missouri,4242677,2973070,2865361,107709
2000-09-01,Montana,688280,469254,446734,22520
2000-09-01,Nebraska,1285348,937888,911207,26681
2000-09-01,Nevada,1534032,1080030,1034296,45734
2000-09-01,Ohio,8633000,5766307,5531574,234733
2000-09-01,Oklahoma,2583304,1654299,1605173,49126
2000-09-01,Oregon,2649251,1812271,1716020,96251
2000-09-01,Pennsylvania,9490931,6110966,5848728,262238
2000-09-01,Tennessee,4367858,2844773,2732966,111807
2000-09-01,Texas,15259194,10382274,9943815,438459
2000-09-01,Utah,1589727,1146846,1107285,39561
2000-09-01,Vermont,475082,334008,324405,9603
2000-09-01,Virginia,5317939,3608457,3531752,76705
2000-09-01,Washington,4478629,3083855,2922175,161680
2000-09-01,Wisconsin,4094607,2987106,2880752,106354
2000-09-01,Wyoming,373051,265833,255942,9891
2000-10-01,Alabama,3384211,2139926,2041001,98925
2000-10-01,Alaska,437393,319403,299064,20339
2000-10-01,Arizona,3877696,2523954,2424942,99012
2000-10-01,Arkansas,2031078,1256632,1204595,52037
2000-10-01,California,25237042,16928452,16118306,810146
2000-10-01,Colorado,3288185,2362855,2298209,64646
2000-10-01,Connecticut,2599904,1757803,1721221,36582
2000-10-01,Delaware,599406,417048,401740,15308
2000-10-01,Florida,12554196,7968603,7671035,297568
2000-10-01,Georgia,6133273,4219708,4076029,143679
2000-10-01,Hawaii,900855,604311,579968,24343
2000-10-01,Idaho,956410,663771,632528,31243
2000-10-01,Illinois,9363515,6464848,6174523,290325
2000-10-01,Indiana,4610768,3115383,3025371,90012
2000-10-01,Iowa,2235750,1599621,1554252,45369
2000-10-01,Kansas,2005362,1397470,1343090,54380
2000-10-01,Kentucky,3092897,1959159,1875394,83765
2000-10-01,Louisiana,3292007,2022328,1913866,108462
2000-10-01,Maine,997202,672805,651444,21361
2000-10-01,Maryland,4009824,2816124,2713711,102413
2000-10-01,Massachusetts,4941860,3336722,3246473,90249
2000-10-01,Michigan,7535127,5152050,4947870,204180
2000-10-01,Minnesota,3745484,2815217,2724744,90473
2000-10-01,Mississippi,2099379,1305140,1238459,66681
2000-10-01,Missouri,4246319,2979947,2867305,112642
2000-10-01,Montana,688837,468924,446711,22213
2000-10-01,Nebraska,1286070,939042,912185,26857
2000-10-01,Nevada,1539014,1085010,1038180,46830
2000-10-01,Ohio,8637548,5769815,5539184,230631
2000-10-01,Oklahoma,2584571,1655384,1607005,48379
2000-10-01,Oregon,2652736,1812447,1717292,95155
2000-10-01,Pennsylvania,9494633,6122435,5860231,262204
2000-10-01,Tennessee,4371798,2846916,2735645,111271
2000-10-01,Texas,15285623,10398969,9966658,432311
2000-10-01,Utah,1593001,1149844,1109406,40438
2000-10-01,Vermont,475507,334594,324966,9628
2000-10-01,Virginia,5324945,3619961,3543654,76307
2000-10-01,Washington,4484987,3086855,2925177,161678
2000-10-01,Wisconsin,4098514,2991135,2884542,106593
2000-10-01,Wyoming,373242,266267,256419,9848
2000-11-01,Alabama,3385253,2139965,2040616,99349
2000-11-01,Alaska,438096,319460,299264,20196
2000-11-01,Arizona,3886639,2533900,2434431,99469
2000-11-01,Arkansas,2032150,1257547,1205079,52468
2000-11-01,California,25273037,16965953,16159985,805968
2000-11-01,Colorado,3295378,2365926,2302455,63471
2000-11-01,Connecticut,2601325,1757617,1720029,37588
2000-11-01,Delaware,600063,418924,403523,15401
2000-11-01,Florida,12575102,7989957,7689671,300286
2000-11-01,Georgia,6144529,4229457,4086197,143260
2000-11-01,Hawaii,901673,605309,581121,24188
2000-11-01,Idaho,957933,665633,634432,31201
2000-11-01,Illinois,9369166,6465149,6167385,297764
2000-11-01,Indiana,4613209,3118498,3025931,92567
2000-11-01,Iowa,2236321,1602761,1556340,46421
2000-11-01,Kansas,2006433,1398926,1343708,55218
2000-11-01,Kentucky,3094531,1961786,1876498,85288
2000-11-01,Louisiana,3292484,2026957,1917107,109850
2000-11-01,Maine,998094,672955,651688,21267
2000-11-01,Maryland,4014613,2822425,2720153,102272
2000-11-01,Massachusetts,4945759,3347925,3256027,91898
2000-11-01,Michigan,7539934,5158205,4949225,208980
2000-11-01,Minnesota,3749779,2824617,2733488,91129
2000-11-01,Mississippi,2099967,1304138,1238350,65788
2000-11-01,Missouri,4249529,2987904,2870358,117546
2000-11-01,Montana,689364,468687,446762,21925
2000-11-01,Nebraska,1286643,940867,913784,27083
2000-11-01,Nevada,1543911,1090188,1042157,48031
2000-11-01,Ohio,8641255,5777788,5551334,226454
2000-11-01,Oklahoma,2585631,1657371,1609291,48080
2000-11-01,Oregon,2655969,1813369,1718860,94509
2000-11-01,Pennsylvania,9497174,6136761,5874011,262750
2000-11-01,Tennessee,4375368,2850056,2739133,110923
2000-11-01,Texas,15310947,10419981,9992279,427702
2000-11-01,Utah,1596218,1153064,1111619,41445
2000-11-01,Vermont,475918,335315,325599,9716
2000-11-01,Virginia,5331526,3633438,3556205,77233
2000-11-01,Washington,4490922,3090504,2928278,162226
2000-11-01,Wisconsin,4102043,2996986,2889490,107496
2000-11-01,Wyoming,373446,266782,256975,9807
2000-12-01,Alabama,3386178,2140886,2040648,100238
2000-12-01,Alaska,438773,319644,299627,20017
2000-12-01,Arizona,3895390,2544844,2443973,100871
2000-12-01,Arkansas,2033134,1258869,1205680,53189
2000-12-01,California,25308044,17004221,16196430,807791
2000-12-01,Colorado,3302410,2369212,2306123,63089
2000-12-01,Connecticut,2602613,1757049,1717973,39076
2000-12-01,Delaware,600688,420792,405350,15442
2000-12-01,Florida,12595548,8011808,7706178,305630
2000-12-01,Georgia,6155531,4238961,4094380,144581
2000-12-01,Hawaii,902472,606510,582193,24317
2000-12-01,Idaho,959424,667767,636497,31270
2000-12-01,Illinois,9374457,6468207,6159884,308323
2000-12-01,Indiana,4615419,3124584,3026991,97593
2000-12-01,Iowa,2236772,1605280,1557642,47638
2000-12-01,Kansas,2007415,1400629,1344631,55998
2000-12-01,Kentucky,3096008,1964112,1876903,87209
2000-12-01,Louisiana,3292838,2031573,1920444,111129
2000-12-01,Maine,998941,673545,652145,21400
2000-12-01,Maryland,4019283,2827342,2725038,102304
2000-12-01,Massachusetts,4949449,3359793,3264889,94904
2000-12-01,Michigan,7544386,5167109,4950193,216916
2000-12-01,Minnesota,3753858,2833661,2741840,91821
2000-12-01,Mississippi,2100492,1304068,1238504,65564
2000-12-01,Missouri,4252557,2994981,2873210,121771
2000-12-01,Montana,689849,468491,446766,21725
2000-12-01,Nebraska,1287185,942907,915594,27313
2000-12-01,Nevada,1548738,1095217,1045870,49347
2000-12-01,Ohio,8644649,5788181,5564923,223258
2000-12-01,Oklahoma,2586577,1659710,1611353,48357
2000-12-01,Oregon,2659061,1814335,1719456,94879
2000-12-01,Pennsylvania,9499379,6151654,5887290,264364
2000-12-01,Tennessee,4378754,2854088,2743055,111033
2000-12-01,Texas,15335573,10442177,10015120,427057
2000-12-01,Utah,1599387,1156115,1113525,42590
2000-12-01,Vermont,476283,336031,326139,9892
2000-12-01,Virginia,5337913,3646707,3566772,79935
2000-12-01,Washington,4496757,3093714,2929874,163840
2000-12-01,Wisconsin,4105382,3004094,2894396,109698
2000-12-01,Wyoming,373611,267287,257505,9782
2001-01-01,Alabama,3387039,2141777,2040374,101403
2001-01-01,Alaska,439457,319846,300030,19816
2001-01-01,Arizona,3904061,2555178,2452258,102920
2001-01-01,Arkansas,2034063,1260049,1205911,54138
2001-01-01,California,25342675,17036516,16221805,814711
2001-01-01,Colorado,3309347,2372165,2308140,64025
2001-01-01,Connecticut,2603831,1755847,1714969,40878
2001-01-01,Delaware,601304,422324,406976,15348
2001-01-01,Florida,12615545,8031163,7718636,312527
2001-01-01,Georgia,6166480,4246253,4099176,147077
2001-01-01,Hawaii,903274,607571,582914,24657
2001-01-01,Idaho,960888,669930,638460,31470
2001-01-01,Illinois,9379497,6472722,6152750,319972
2001-01-01,Indiana,4617526,3131784,3027860,103924
2001-01-01,Iowa,2237196,1607287,1558411,48876
2001-01-01,Kansas,2008356,1401731,1345113,56618
2001-01-01,Kentucky,3097382,1965224,1875942,89282
2001-01-01,Louisiana,3293186,2034561,1922697,111864
2001-01-01,Maine,999732,674292,652495,21797
2001-01-01,Maryland,4023848,2830333,2727705,102628
2001-01-01,Massachusetts,4952972,3369977,3270951,99026
2001-01-01,Michigan,7548639,5175795,4948660,227135
2001-01-01,Minnesota,3757861,2841094,2748164,92930
2001-01-01,Mississippi,2100994,1304179,1238457,65722
2001-01-01,Missouri,4255432,2999349,2874567,124782
2001-01-01,Montana,690313,468240,446626,21614
2001-01-01,Nebraska,1287664,944664,917123,27541
2001-01-01,Nevada,1553524,1099598,1048953,50645
2001-01-01,Ohio,8647714,5798294,5576671,221623
2001-01-01,Oklahoma,2587395,1662044,1612914,49130
2001-01-01,Oregon,2662042,1814809,1718469,96340
2001-01-01,Pennsylvania,9501193,6164882,5897777,267105
2001-01-01,Tennessee,4381992,2857893,2746172,111721
2001-01-01,Texas,15360003,10462250,10030817,431433
2001-01-01,Utah,1602535,1158505,1114739,43766
2001-01-01,Vermont,476597,336609,326466,10143
2001-01-01,Virginia,5344116,3657773,3573374,84399
2001-01-01,Washington,4502401,3095476,2928958,166518
2001-01-01,Wisconsin,4108549,3011189,2898040,113149
2001-01-01,Wyoming,373775,267697,257920,9777
2001-02-01,Alabama,3387682,2141500,2038930,102570
2001-02-01,Alaska,440088,320026,300387,19639
2001-02-01,Arizona,3912564,2563946,2458846,105100
2001-02-01,Arkansas,2034883,1260761,1205527,55234
2001-02-01,California,25376427,17058192,16232819,825373
2001-02-01,Colorado,3316218,2374647,2308334,66313
2001-02-01,Connecticut,2604874,1754010,1711268,42742
2001-02-01,Delaware,601855,423256,408164,15092
2001-02-01,Florida,12634814,8045552,7725933,319619
2001-02-01,Georgia,6177204,4250445,4100338,150107
2001-02-01,Hawaii,903961,608291,583184,25107
2001-02-01,Idaho,962324,671958,640170,31788
2001-02-01,Illinois,9384194,6477254,6147239,330015
2001-02-01,Indiana,4619366,3137878,3027812,110066
2001-02-01,Iowa,2237469,1608759,1558748,50011
2001-02-01,Kansas,2009179,1401763,1344731,57032
2001-02-01,Kentucky,3098647,1964621,1873278,91343
2001-02-01,Louisiana,3293361,2035264,1923373,111891
2001-02-01,Maine,1000503,674993,652554,22439
2001-02-01,Maryland,4028165,2831516,2728083,103433
2001-02-01,Massachusetts,4956302,3376930,3273162,103768
2001-02-01,Michigan,7552510,5180402,4943477,236925
2001-02-01,Minnesota,3761681,2846314,2751524,94790
2001-02-01,Mississippi,2101429,1303459,1237565,65894
2001-02-01,Missouri,4258133,3000391,2873793,126598
2001-02-01,Montana,690759,467916,446355,21561
2001-02-01,Nebraska,1288101,945847,918063,27784
2001-02-01,Nevada,1558251,1103074,1051286,51788
2001-02-01,Ohio,8650413,5806144,5584368,221776
2001-02-01,Oklahoma,2588181,1664211,1613887,50324
2001-02-01,Oregon,2664923,1814784,1716005,98779
2001-02-01,Pennsylvania,9502499,6174916,5904081,270835
2001-02-01,Tennessee,4385065,2860066,2746928,113138
2001-02-01,Texas,15384055,10479048,10037850,441198
2001-02-01,Utah,1605693,1160008,1115153,44855
2001-02-01,Vermont,476959,337020,326597,10423
2001-02-01,Virginia,5350121,3665728,3575695,90033
2001-02-01,Washington,4507825,3095569,2925810,169759
2001-02-01,Wisconsin,4111573,3016984,2899630,117354
2001-02-01,Wyoming,373943,267992,258178,9814
2001-03-01,Alabama,3388360,2139257,2035813,103444
2001-03-01,Alaska,440714,320242,300708,19534
2001-03-01,Arizona,3920943,2570663,2463767,106896
2001-03-01,Arkansas,2035722,1260887,1204622,56265
2001-03-01,California,25408416,17067462,16229316,838146
2001-03-01,Colorado,3323001,2376838,2307202,69636
2001-03-01,Connecticut,2605932,1751602,1707158,44444
2001-03-01,Delaware,602431,423429,408737,14692
2001-03-01,Florida,12653862,8053803,7728117,325686
2001-03-01,Georgia,6187800,4251021,4098047,152974
2001-03-01,Hawaii,904557,608571,583097,25474
2001-03-01,Idaho,963750,673742,641583,32159
2001-03-01,Illinois,9388724,6479113,6142766,336347
2001-03-01,Indiana,4621335,3140939,3026034,114905
2001-03-01,Iowa,2237792,1609527,1558694,50833
2001-03-01,Kansas,2010010,1400671,1343513,57158
2001-03-01,Kentucky,3099936,1962263,1868983,93280
2001-03-01,Louisiana,3293479,2033367,1922359,111008
2001-03-01,Maine,1001284,675405,652184,23221
2001-03-01,Maryland,4032468,2831057,2726306,104751
2001-03-01,Massachusetts,4959688,3380386,3271755,108631
2001-03-01,Michigan,7556439,5178441,4934622,243819
2001-03-01,Minnesota,3765569,2848984,2751722,97262
2001-03-01,Mississippi,2101776,1301372,1235470,65902
2001-03-01,Missouri,4260879,2998294,2870983,127311
2001-03-01,Montana,691172,467435,445940,21495
2001-03-01,Nebraska,1288559,946352,918311,28041
2001-03-01,Nevada,1562928,1105674,1052888,52786
2001-03-01,Ohio,8653257,5810671,5587139,223532
2001-03-01,Oklahoma,2588891,1665929,1614117,51812
2001-03-01,Oregon,2667795,1814100,1712458,101642
2001-03-01,Pennsylvania,9504003,6180184,5905154,275030
2001-03-01,Tennessee,4388151,2859771,2744562,115209
2001-03-01,Texas,15407081,10492222,10037198,455024
2001-03-01,Utah,1608787,1160651,1114848,45803
2001-03-01,Vermont,477290,337288,326607,10681
2001-03-01,Virginia,5356063,3670733,3574644,96089
2001-03-01,Washington,4513254,3093906,2921179,172727
2001-03-01,Wisconsin,4114656,3020474,2898934,121540
2001-03-01,Wyoming,374064,268171,258287,9884
2001-04-01,Alabama,3389260,2135072,2030986,104086
2001-04-01,Alaska,441403,320488,300987,19501
2001-04-01,Arizona,3929648,2575436,2467052,108384
2001-04-01,Arkansas,2036681,1260413,1203276,57137
2001-04-01,California,25442952,17066003,16213500,852503
2001-04-01,Colorado,3330031,2379022,2305575,73447
2001-04-01,Connecticut,2607177,1748846,1702915,45931
2001-04-01,Delaware,603034,422887,408637,14250
2001-04-01,Florida,12673851,8057451,7726938,330513
2001-04-01,Georgia,6198801,4248265,4092954,155311
2001-04-01,Hawaii,905292,608338,582822,25516
2001-04-01,Idaho,965243,675268,642708,32560
2001-04-01,Illinois,9393943,6475826,6137057,338769
2001-04-01,Indiana,4623507,3140459,3022219,118240
2001-04-01,Iowa,2238220,1610026,1558753,51273
2001-04-01,Kansas,2010999,1398726,1341682,57044
2001-04-01,Kentucky,3101406,1958517,1863501,95016
2001-04-01,Louisiana,3293852,2029478,1920030,109448
2001-04-01,Maine,1002123,675436,651441,23995
2001-04-01,Maryland,4037045,2829251,2722683,106568
2001-04-01,Massachusetts,4963354,3381432,3268013,113419
2001-04-01,Michigan,7560859,5169900,4922437,247463
2001-04-01,Minnesota,3769673,2848906,2749027,99879
2001-04-01,Mississippi,2102305,1298215,1232251,65964
2001-04-01,Missouri,4263899,2993694,2866523,127171
2001-04-01,Montana,691662,466697,445317,21380
2001-04-01,Nebraska,1289076,946186,917886,28300
2001-04-01,Nevada,1567733,1107606,1053881,53725
2001-04-01,Ohio,8656582,5811816,5585021,226795
2001-04-01,Oklahoma,2589817,1666892,1613465,53427
2001-04-01,Oregon,2670864,1813028,1708533,104495
2001-04-01,Pennsylvania,9506024,6180288,5901257,279031
2001-04-01,Tennessee,4391508,2857284,2739708,117576
2001-04-01,Texas,15431594,10502031,10031118,470913
2001-04-01,Utah,1612034,1160695,1114003,46692
2001-04-01,Vermont,477637,337429,326558,10871
2001-04-01,Virginia,5362396,3673465,3571404,102061
2001-04-01,Washington,4518982,3090758,2915751,175007
2001-04-01,Wisconsin,4117964,3021235,2896277,124958
2001-04-01,Wyoming,374225,268260,258279,9981
2001-05-01,Alabama,3390258,2130035,2025197,104838
2001-05-01,Alaska,442100,320814,301260,19554
2001-05-01,Arizona,3938383,2579399,2469093,110306
2001-05-01,Arkansas,2037739,1259729,1201821,57908
2001-05-01,California,25477019,17061915,16191476,870439
2001-05-01,Colorado,3337135,2381894,2304342,77552
2001-05-01,Connecticut,2608492,1746614,1699291,47323
2001-05-01,Delaware,603678,421954,408021,13933
2001-05-01,Florida,12694136,8060205,7724967,335238
2001-05-01,Georgia,6209942,4244522,4086701,157821
2001-05-01,Hawaii,905953,607700,582487,25213
2001-05-01,Idaho,966791,676697,643669,33028
2001-05-01,Illinois,9399314,6468552,6129446,339106
2001-05-01,Indiana,4625967,3138280,3017196,121084
2001-05-01,Iowa,2238858,1610648,1559211,51437
2001-05-01,Kansas,2012049,1396636,1339756,56880
2001-05-01,Kentucky,3103053,1954385,1857689,96696
2001-05-01,Louisiana,3294280,2025314,1917313,108001
2001-05-01,Maine,1003074,675353,650651,24702
2001-05-01,Maryland,4041659,2827494,2718303,109191
2001-05-01,Massachusetts,4967224,3382048,3263771,118277
2001-05-01,Michigan,7565542,5157214,4907941,249273
2001-05-01,Minnesota,3774037,2847221,2744908,102313
2001-05-01,Mississippi,2102875,1294852,1228504,66348
2001-05-01,Missouri,4267104,2988304,2861336,126968
2001-05-01,Montana,692184,465819,444567,21252
2001-05-01,Nebraska,1289688,945687,917143,28544
2001-05-01,Nevada,1572539,1109352,1054604,54748
2001-05-01,Ohio,8660283,5812072,5580007,232065
2001-05-01,Oklahoma,2590836,1667424,1612236,55188
2001-05-01,Oregon,2674062,1812473,1705200,107273
2001-05-01,Pennsylvania,9508525,6177356,5894367,282989
2001-05-01,Tennessee,4395078,2854355,2734072,120283
2001-05-01,Texas,15456099,10511424,10023661,487763
2001-05-01,Utah,1615352,1160718,1112990,47728
2001-05-01,Vermont,478054,337553,326566,10987
2001-05-01,Virginia,5368787,3675170,3567108,108062
2001-05-01,Washington,4524913,3087259,2910430,176829
2001-05-01,Wisconsin,4121525,3020351,2892795,127556
2001-05-01,Wyoming,374421,268332,258220,10112
2001-06-01,Alabama,3391415,2125294,2019160,106134
2001-06-01,Alaska,442790,321252,301545,19707
2001-06-01,Arizona,3947379,2583941,2470488,113453
2001-06-01,Arkansas,2038912,1259197,1200558,58639
2001-06-01,California,25512789,17062514,16168434,894080
2001-06-01,Colorado,3344448,2386088,2303819,82269
2001-06-01,Connecticut,2609938,1745327,1696540,48787
2001-06-01,Delaware,604340,421064,407191,13873
2001-06-01,Florida,12715218,8064197,7722943,341254
2001-06-01,Georgia,6221345,4242516,4080730,161786
2001-06-01,Hawaii,906693,606975,582108,24867
2001-06-01,Idaho,968401,678132,644538,33594
2001-06-01,Illinois,9405189,6459192,6119367,339825
2001-06-01,Indiana,4628628,3137043,3012271,124772
2001-06-01,Iowa,2239580,1611094,1559480,51614
2001-06-01,Kansas,2013249,1395029,1338024,57005
2001-06-01,Kentucky,3104831,1950891,1852210,98681
2001-06-01,Louisiana,3294875,2022275,1914852,107423
2001-06-01,Maine,1004055,675346,650029,25317
2001-06-01,Maryland,4046455,2827207,2714274,112933
2001-06-01,Massachusetts,4971387,3383349,3259884,123465
2001-06-01,Michigan,7570642,5143387,4891453,251934
2001-06-01,Minnesota,3778582,2845315,2740838,104477
2001-06-01,Mississippi,2103548,1291859,1224684,67175
2001-06-01,Missouri,4270528,2983912,2855975,127937
2001-06-01,Montana,692756,464970,443817,21153
2001-06-01,Nebraska,1290397,945107,916309,28798
2001-06-01,Nevada,1577431,1111300,1055337,55963
2001-06-01,Ohio,8664455,5814261,5574358,239903
2001-06-01,Oklahoma,2591986,1668255,1611000,57255
2001-06-01,Oregon,2677372,1812656,1702502,110154
2001-06-01,Pennsylvania,9511507,6173797,5886204,287593
2001-06-01,Tennessee,4398768,2852236,2728708,123528
2001-06-01,Texas,15481630,10522773,10017556,505217
2001-06-01,Utah,1618754,1161120,1112080,49040
2001-06-01,Vermont,478500,337764,326706,11058
2001-06-01,Virginia,5375521,3677022,3562305,114717
2001-06-01,Washington,4531055,3084091,2905333,178758
2001-06-01,Wisconsin,4125319,3018999,2889072,129927
2001-06-01,Wyoming,374643,268413,258166,10247
2001-07-01,Alabama,3392436,2122119,2013716,108403
2001-07-01,Alaska,443480,321790,301846,19944
2001-07-01,Arizona,3956253,2590486,2472036,118450
2001-07-01,Arkansas,2040000,1259269,1199744,59525
2001-07-01,California,25547539,17073157,16148575,924582
2001-07-01,Colorado,3351629,2392144,2303968,88176
2001-07-01,Connecticut,2611305,1745050,1694574,50476
2001-07-01,Delaware,604959,420520,406419,14101
2001-07-01,Florida,12735879,8070383,7720797,349586
2001-07-01,Georgia,6232538,4244587,4076332,168255
2001-07-01,Hawaii,907380,606588,581723,24865
2001-07-01,Idaho,969962,679601,645370,34231
2001-07-01,Illinois,9410722,6450244,6107545,342699
2001-07-01,Indiana,4631127,3138321,3008039,130282
2001-07-01,Iowa,2240220,1611270,1559066,52204
2001-07-01,Kansas,2014364,1394452,1336746,57706
2001-07-01,Kentucky,3106501,1948804,1847523,101281
2001-07-01,Louisiana,3295346,2021385,1912999,108386
2001-07-01,Maine,1004970,675381,649543,25838
2001-07-01,Maryland,4051099,2829195,2711499,117696
2001-07-01,Massachusetts,4975374,3385812,3256581,129231
2001-07-01,Michigan,7575452,5131220,4873266,257954
2001-07-01,Minnesota,3782985,2844372,2737689,106683
2001-07-01,Mississippi,2104112,1289905,1221187,68718
2001-07-01,Missouri,4273800,2981618,2850902,130716
2001-07-01,Montana,693281,464267,443137,21130
2001-07-01,Nebraska,1291022,944777,915576,29201
2001-07-01,Nevada,1582281,1113746,1056285,57461
2001-07-01,Ohio,8668225,5819450,5569288,250162
2001-07-01,Oklahoma,2593022,1670245,1610316,59929
2001-07-01,Oregon,2680623,1813351,1699586,113765
2001-07-01,Pennsylvania,9514118,6171901,5878583,293318
2001-07-01,Tennessee,4402350,2851637,2724207,127430
2001-07-01,Texas,15506619,10537755,10013363,524392
2001-07-01,Utah,1622108,1162087,1111452,50635
2001-07-01,Vermont,478876,338109,326965,11144
2001-07-01,Virginia,5381987,3680168,3557698,122470
2001-07-01,Washington,4537005,3081703,2900044,181659
2001-07-01,Wisconsin,4128936,3018019,2885334,132685
2001-07-01,Wyoming,374826,268525,258174,10351
2001-08-01,Alabama,3393842,2120291,2008675,111616
2001-08-01,Alaska,444285,322275,302019,20256
2001-08-01,Arizona,3966230,2598978,2473638,125340
2001-08-01,Arkansas,2041352,1259971,1199157,60814
2001-08-01,California,25579419,17091666,16129846,961820
2001-08-01,Colorado,3356755,2399781,2303806,95975
2001-08-01,Connecticut,2613460,1745456,1692990,52466
2001-08-01,Delaware,605731,420277,405713,14564
2001-08-01,Florida,12760563,8076689,7716575,360114
2001-08-01,Georgia,6243529,4250549,4073248,177301
2001-08-01,Hawaii,908102,606629,581236,25393
2001-08-01,Idaho,971636,680932,645959,34973
2001-08-01,Illinois,9416565,6442403,6093093,349310
2001-08-01,Indiana,4633815,3141688,3003900,137788
2001-08-01,Iowa,2241032,1611115,1557650,53465
2001-08-01,Kansas,2015802,1394856,1335748,59108
2001-08-01,Kentucky,3108740,1947770,1843171,104599
2001-08-01,Louisiana,3296898,2022156,1911061,111095
2001-08-01,Maine,1006027,675280,648922,26358
2001-08-01,Maryland,4056512,2833098,2709783,123315
2001-08-01,Massachusetts,4978736,3388682,3253013,135669
2001-08-01,Michigan,7580334,5120998,4852419,268579
2001-08-01,Minnesota,3786891,2844775,2735241,109534
2001-08-01,Mississippi,2105002,1289104,1217850,71254
2001-08-01,Missouri,4277491,2980711,2845723,134988
2001-08-01,Montana,693935,463726,442516,21210
2001-08-01,Nebraska,1291856,944642,914791,29851
2001-08-01,Nevada,1587031,1116526,1057209,59317
2001-08-01,Ohio,8672828,5825748,5563407,262341
2001-08-01,Oklahoma,2594977,1673342,1609938,63404
2001-08-01,Oregon,2684522,1814343,1695571,118772
2001-08-01,Pennsylvania,9519305,6172531,5871636,300895
2001-08-01,Tennessee,4406467,2852352,2720048,132304
2001-08-01,Texas,15532102,10554649,10007996,546653
2001-08-01,Utah,1625142,1163273,1110823,52450
2001-08-01,Vermont,479322,338468,327180,11288
2001-08-01,Virginia,5388977,3684038,3552829,131209
2001-08-01,Washington,4543227,3080051,2893570,186481
2001-08-01,Wisconsin,4133051,3017389,2880946,136443
2001-08-01,Wyoming,375274,268596,258172,10424
2001-09-01,Alabama,3395327,2119126,2003790,115336
2001-09-01,Alaska,445086,322657,302053,20604
2001-09-01,Arizona,3976343,2608688,2475140,133548
2001-09-01,Arkansas,2042763,1261044,1198568,62476
2001-09-01,California,25612457,17114525,16111501,1003024
2001-09-01,Colorado,3362033,2408440,2302903,105537
2001-09-01,Connecticut,2615702,1746455,1691752,54703
2001-09-01,Delaware,606500,420226,405065,15161
2001-09-01,Florida,12785780,8080994,7709589,371405
2001-09-01,Georgia,6254668,4259318,4071269,188049
2001-09-01,Hawaii,908840,606885,580511,26374
2001-09-01,Idaho,973376,682023,646139,35884
2001-09-01,Illinois,9422769,6436126,6076326,359800
2001-09-01,Indiana,4636658,3146603,2999956,146647
2001-09-01,Iowa,2241912,1610881,1555541,55340
2001-09-01,Kansas,2017324,1396032,1334938,61094
2001-09-01,Kentucky,3111061,1947289,1838988,108301
2001-09-01,Louisiana,3298599,2023510,1908467,115043
2001-09-01,Maine,1007135,674951,648073,26878
2001-09-01,Maryland,4062032,2838500,2709147,129353
2001-09-01,Massachusetts,4982192,3391514,3248977,142537
2001-09-01,Michigan,7585464,5111382,4829210,282172
2001-09-01,Minnesota,3790917,2846603,2733236,113367
2001-09-01,Mississippi,2105990,1289177,1214659,74518
2001-09-01,Missouri,4281344,2980289,2840391,139898
2001-09-01,Montana,694619,463380,442031,21349
2001-09-01,Nebraska,1292727,944582,913864,30718
2001-09-01,Nevada,1591816,1119335,1057937,61398
2001-09-01,Ohio,8677675,5831547,5555756,275791
2001-09-01,Oklahoma,2596992,1676984,1609659,67325
2001-09-01,Oregon,2688495,1815624,1690500,125124
2001-09-01,Pennsylvania,9524726,6175610,5865302,310308
2001-09-01,Tennessee,4410746,2854605,2716455,138150
2001-09-01,Texas,15558281,10571682,10000407,571275
2001-09-01,Utah,1628218,1164418,1110022,54396
2001-09-01,Vermont,479777,338773,327299,11474
2001-09-01,Virginia,5396149,3688173,3547843,140330
2001-09-01,Washington,4549549,3079041,2886014,193027
2001-09-01,Wisconsin,4137216,3016955,2875462,141493
2001-09-01,Wyoming,375705,268547,258098,10449
2001-10-01,Alabama,3396655,2118136,1999094,119042
2001-10-01,Alaska,445888,323003,302033,20970
2001-10-01,Arizona,3986221,2618988,2476968,142020
2001-10-01,Arkansas,2044106,1262397,1198077,64320
2001-10-01,California,25644032,17139126,16095235,1043891
2001-10-01,Colorado,3367175,2417657,2301764,115893
2001-10-01,Connecticut,2617761,1748089,1691061,57028
2001-10-01,Delaware,607285,420247,404457,15790
2001-10-01,Florida,12809888,8007931,7610061,397870
2001-10-01,Georgia,6265646,4269917,4070697,199220
2001-10-01,Hawaii,909486,607057,579538,27519
2001-10-01,Idaho,975049,682863,645956,36907
2001-10-01,Illinois,9428484,6431162,6058843,372319
2001-10-01,Indiana,4639299,3151903,2996271,155632
2001-10-01,Iowa,2242738,1611068,1553561,57507
2001-10-01,Kansas,2018770,1397804,1334393,63411
2001-10-01,Kentucky,3113301,1947067,1835318,111749
2001-10-01,Louisiana,3300144,2024273,1905047,119226
2001-10-01,Maine,1008157,674462,647105,27357
2001-10-01,Maryland,4067332,2845034,2710063,134971
2001-10-01,Massachusetts,4985426,3394609,3245271,149338
2001-10-01,Michigan,7590159,5101413,4805317,296096
2001-10-01,Minnesota,3794796,2849487,2731592,117895
2001-10-01,Mississippi,2106910,1289626,1211802,77824
2001-10-01,Missouri,4284972,2980040,2835353,144687
2001-10-01,Montana,695276,463330,441818,21512
2001-10-01,Nebraska,1293543,944631,912954,31677
2001-10-01,Nevada,1596483,1122018,1058611,63407
2001-10-01,Ohio,8682072,5836269,5546560,289709
2001-10-01,Oklahoma,2598867,1680495,1609570,70925
2001-10-01,Oregon,2692299,1817205,1685269,131936
2001-10-01,Pennsylvania,9529554,6180689,5860262,320427
2001-10-01,Tennessee,4414767,2858509,2713982,144527
2001-10-01,Texas,15583700,10588115,9992389,595726
2001-10-01,Utah,1631320,1165570,1109225,56345
2001-10-01,Vermont,480215,339046,327378,11668
2001-10-01,Virginia,5403027,3692646,3543843,148803
2001-10-01,Washington,4555657,3078364,2878269,200095
2001-10-01,Wisconsin,4141269,3016564,2869184,147380
2001-10-01,Wyoming,376150,268424,257994,10430
2001-11-01,Alabama,3397377,2116512,1994393,122119
2001-11-01,Alaska,446603,323344,301982,21362
2001-11-01,Arizona,3995539,2628928,2479380,149548
2001-11-01,Arkansas,2045037,1263950,1197823,66127
2001-11-01,California,25672349,17161602,16081351,1080251
2001-11-01,Colorado,3371794,2426577,2300730,125847
2001-11-01,Connecticut,2619402,1750196,1690859,59337
2001-11-01,Delaware,607953,420223,403827,16396
2001-11-01,Florida,12831933,8010652,7600865,409787
2001-11-01,Georgia,6275466,4280798,4071417,209381
2001-11-01,Hawaii,910197,606823,578420,28403
2001-11-01,Idaho,976561,683401,645460,37941
2001-11-01,Illinois,9432664,6425773,6041133,384640
2001-11-01,Indiana,4641180,3155789,2992463,163326
2001-11-01,Iowa,2243111,1611932,1552302,59630
2001-11-01,Kansas,2019873,1399944,1334154,65790
2001-11-01,Kentucky,3115007,1946442,1832265,114177
2001-11-01,Louisiana,3301094,2023422,1900945,122477
2001-11-01,Maine,1009049,673926,646143,27783
2001-11-01,Maryland,4071927,2852049,2712532,139517
2001-11-01,Massachusetts,4987817,3398382,3242751,155631
2001-11-01,Michigan,7593576,5090268,4782389,307879
2001-11-01,Minnesota,3798068,2852819,2730169,122650
2001-11-01,Mississippi,2107407,1289887,1209224,80663
2001-11-01,Missouri,4287890,2979828,2830930,148898
2001-11-01,Montana,695802,463540,441864,21676
2001-11-01,Nebraska,1294148,944797,912172,32625
2001-11-01,Nevada,1600992,1124320,1059301,65019
2001-11-01,Ohio,8684968,5838599,5535574,303025
2001-11-01,Oklahoma,2600322,1683462,1609645,73817
2001-11-01,Oregon,2695721,1819144,1681041,138103
2001-11-01,Pennsylvania,9532737,6186948,5856987,329961
2001-11-01,Tennessee,4418100,2863235,2712599,150636
2001-11-01,Texas,15607012,10603199,9985772,617427
2001-11-01,Utah,1634134,1166683,1108531,58152
2001-11-01,Vermont,480606,339308,327472,11836
2001-11-01,Virginia,5409044,3697251,3541607,155644
2001-11-01,Washington,4561056,3078060,2871302,206758
2001-11-01,Wisconsin,4144622,3015925,2862532,153393
2001-11-01,Wyoming,376559,268296,257882,10414
2001-12-01,Alabama,3398108,2114191,1989957,124234
2001-12-01,Alaska,447347,323723,301961,21762
2001-12-01,Arizona,4004764,2638369,2482908,155461
2001-12-01,Arkansas,2046024,1265827,1198152,67675
2001-12-01,California,25700341,17181811,16071997,1109814
2001-12-01,Colorado,3376403,2434221,2300238,133983
2001-12-01,Connecticut,2621052,1752945,1691304,61641
2001-12-01,Delaware,608616,420130,403168,16962
2001-12-01,Florida,12853859,8009023,7594519,414504
2001-12-01,Georgia,6285374,4291293,4073637,217656
2001-12-01,Hawaii,910871,606078,577372,28706
2001-12-01,Idaho,978096,683725,644867,38858
2001-12-01,Illinois,9436821,6418978,6023568,395410
2001-12-01,Indiana,4643062,3158003,2989096,168907
2001-12-01,Iowa,2243507,1613910,1552463,61447
2001-12-01,Kansas,2020944,1402498,1334524,67974
2001-12-01,Kentucky,3116719,1945384,1830063,115321
2001-12-01,Louisiana,3302065,2021105,1896856,124249
2001-12-01,Maine,1009929,673557,645444,28113
2001-12-01,Maryland,4076605,2858910,2716339,142571
2001-12-01,Massachusetts,4990241,3404004,3242834,161170
2001-12-01,Michigan,7597070,5078323,4762583,315740
2001-12-01,Minnesota,3801321,2856276,2729268,127008
2001-12-01,Mississippi,2107926,1289822,1207000,82822
2001-12-01,Missouri,4290818,2979944,2827722,152222
2001-12-01,Montana,696333,463919,442104,21815
2001-12-01,Nebraska,1294719,945235,911738,33497
2001-12-01,Nevada,1605494,1126262,1060173,66089
2001-12-01,Ohio,8687916,5838840,5523828,315012
2001-12-01,Oklahoma,2601753,1686131,1610012,76119
2001-12-01,Oregon,2699120,1821580,1679028,142552
2001-12-01,Pennsylvania,9535917,6194821,5856844,337977
2001-12-01,Tennessee,4421453,2868147,2712678,155469
2001-12-01,Texas,15630107,10618828,9983496,635332
2001-12-01,Utah,1636921,1167932,1108131,59801
2001-12-01,Vermont,480956,339657,327689,11968
2001-12-01,Virginia,5415147,3702599,3542212,160387
2001-12-01,Washington,4566506,3078787,2866396,212391
2001-12-01,Wisconsin,4147972,3015244,2856597,158647
2001-12-01,Wyoming,376925,268265,257803,10462
2002-01-01,Alabama,3399005,2111713,1986380,125333
2002-01-01,Alaska,448136,324206,302056,22150
2002-01-01,Arizona,4014110,2647457,2487794,159663
2002-01-01,Arkansas,2047083,1268139,1199349,68790
2002-01-01,California,25729038,17200139,16068216,1131923
2002-01-01,Colorado,3381106,2440155,2300818,139337
2002-01-01,Connecticut,2622807,1756478,1692498,63980
2002-01-01,Delaware,609322,419914,402426,17488
2002-01-01,Florida,12876040,8008565,7593564,415001
2002-01-01,Georgia,6295616,4301092,4077221,223871
2002-01-01,Hawaii,911557,604976,576624,28352
2002-01-01,Idaho,979698,684000,644462,39538
2002-01-01,Illinois,9441311,6409946,6005946,404000
2002-01-01,Indiana,4645046,3159154,2987071,172083
2002-01-01,Iowa,2243962,1617279,1554488,62791
2002-01-01,Kansas,2022069,1405363,1335675,69688
2002-01-01,Kentucky,3118507,1944328,1828934,115394
2002-01-01,Louisiana,3303232,2017989,1893384,124605
2002-01-01,Maine,1010842,673611,645223,28388
2002-01-01,Maryland,4081417,2864897,2720786,144111
2002-01-01,Massachusetts,4992707,3411826,3246003,165823
2002-01-01,Michigan,7600764,5066583,4747137,319446
2002-01-01,Minnesota,3804678,2859285,2728922,130363
2002-01-01,Mississippi,2108546,1289645,1205447,84198
2002-01-01,Missouri,4293808,2980576,2825930,154646
2002-01-01,Montana,696879,464367,442450,21917
2002-01-01,Nebraska,1295374,946025,911808,34217
2002-01-01,Nevada,1609988,1127970,1061341,66629
2002-01-01,Ohio,8691057,5837148,5512148,325000
2002-01-01,Oklahoma,2603219,1688351,1610625,77726
2002-01-01,Oregon,2702531,1824184,1679563,144621
2002-01-01,Pennsylvania,9539280,6203483,5859751,343732
2002-01-01,Tennessee,4424888,2873062,2714853,158209
2002-01-01,Texas,15653763,10636473,9987112,649361
2002-01-01,Utah,1639828,1169481,1108155,61326
2002-01-01,Vermont,481315,340182,328107,12075
2002-01-01,Virginia,5421363,3708958,3545878,163080
2002-01-01,Washington,4571991,3080706,2864282,216424
2002-01-01,Wisconsin,4151392,3014685,2852321,162364
2002-01-01,Wyoming,377308,268360,257785,10575
2002-02-01,Alabama,3399402,2109535,1983890,125645
2002-02-01,Alaska,448798,324749,302240,22509
2002-02-01,Arizona,4022929,2655925,2493370,162555
2002-02-01,Arkansas,2047798,1270680,1201300,69380
2002-02-01,California,25755035,17215556,16068377,1147179
2002-02-01,Colorado,3385487,2443835,2302077,141758
2002-02-01,Connecticut,2624141,1760683,1694261,66422
2002-02-01,Delaware,609922,419539,401598,17941
2002-02-01,Florida,12896372,8011118,7598085,413033
2002-02-01,Georgia,6305144,4309744,4081734,228010
2002-02-01,Hawaii,912110,603721,576285,27436
2002-02-01,Idaho,981094,684249,644343,39906
2002-02-01,Illinois,9444668,6397958,5987195,410763
2002-02-01,Indiana,4646491,3159571,2986676,172895
2002-02-01,Iowa,2244055,1621675,1557984,63691
2002-02-01,Kansas,2022953,1408286,1337401,70885
2002-02-01,Kentucky,3119948,1943276,1828696,114580
2002-02-01,Louisiana,3303952,2014815,1890945,123870
2002-02-01,Maine,1011593,674227,645539,28688
2002-02-01,Maryland,4085716,2869442,2725106,144336
2002-02-01,Massachusetts,4994638,3420825,3251186,169639
2002-02-01,Michigan,7603498,5056176,4735820,320356
2002-02-01,Minnesota,3807582,2861594,2729260,132334
2002-02-01,Mississippi,2108953,1289529,1204671,84858
2002-02-01,Missouri,4296276,2981362,2824957,156405
2002-02-01,Montana,697360,464775,442794,21981
2002-02-01,Nebraska,1295829,947085,912326,34759
2002-02-01,Nevada,1614350,1129405,1062671,66734
2002-02-01,Ohio,8693156,5833268,5500685,332583
2002-02-01,Oklahoma,2604437,1689439,1610980,78459
2002-02-01,Oregon,2705630,1826495,1682135,144360
2002-02-01,Pennsylvania,9541334,6211418,5864420,346998
2002-02-01,Tennessee,4427865,2878124,2719470,158654
2002-02-01,Texas,15675829,10655526,9995460,660066
2002-02-01,Utah,1642558,1171223,1108460,62763
2002-02-01,Vermont,481654,340842,328669,12173
2002-02-01,Virginia,5427008,3715839,3551649,164190
2002-02-01,Washington,4577007,3083538,2864747,218791
2002-02-01,Wisconsin,4154323,3014014,2849862,164152
2002-02-01,Wyoming,377686,268531,257812,10719
2002-03-01,Alabama,3399942,2107910,1982330,125580
2002-03-01,Alaska,449530,325267,302442,22825
2002-03-01,Arizona,4031755,2663980,2499239,164741
2002-03-01,Arkansas,2048658,1273099,1203623,69476
2002-03-01,California,25780233,17227144,16069886,1157258
2002-03-01,Colorado,3389916,2445306,2303570,141736
2002-03-01,Connecticut,2625538,1765261,1696249,69012
2002-03-01,Delaware,610535,419073,400804,18269
2002-03-01,Florida,12916606,8016518,7606306,410212
2002-03-01,Georgia,6314817,4317457,4086971,230486
2002-03-01,Hawaii,912658,602580,576317,26263
2002-03-01,Idaho,982583,684479,644545,39934
2002-03-01,Illinois,9448199,6383575,5967568,416007
2002-03-01,Indiana,4648125,3159593,2987734,171859
2002-03-01,Iowa,2244254,1626062,1561775,64287
2002-03-01,Kansas,2023880,1411086,1339444,71642
2002-03-01,Kentucky,3121497,1942129,1828895,113234
2002-03-01,Louisiana,3304766,2012432,1889767,122665
2002-03-01,Maine,1012390,675390,646342,29048
2002-03-01,Maryland,4090119,2872651,2729044,143607
2002-03-01,Massachusetts,4996735,3429354,3256605,172749
2002-03-01,Michigan,7606496,5047529,4727781,319748
2002-03-01,Minnesota,3810635,2863548,2730645,132903
2002-03-01,Mississippi,2109384,1289263,1204384,84879
2002-03-01,Missouri,4298928,2981929,2824193,157736
2002-03-01,Montana,697821,465070,443095,21975
2002-03-01,Nebraska,1296333,948270,913155,35115
2002-03-01,Nevada,1618698,1130577,1064062,66515
2002-03-01,Ohio,8695571,5827892,5490075,337817
2002-03-01,Oklahoma,2605665,1689328,1610915,78413
2002-03-01,Oregon,2708829,1828427,1686101,142326
2002-03-01,Pennsylvania,9543727,6217942,5869958,347984
2002-03-01,Tennessee,4430974,2883280,2726126,157154
2002-03-01,Texas,15697510,10674926,10006541,668385
2002-03-01,Utah,1645359,1173064,1108928,64136
2002-03-01,Vermont,481999,341559,329266,12293
2002-03-01,Virginia,5432738,3722814,3558238,164576
2002-03-01,Washington,4582078,3087034,2867218,219816
2002-03-01,Wisconsin,4157408,3012899,2848653,164246
2002-03-01,Wyoming,378036,268700,257864,10836
2002-04-01,Alabama,3400511,2107382,1981979,125403
2002-04-01,Alaska,450277,325811,302703,23108
2002-04-01,Arizona,4040671,2672076,2505719,166357
2002-04-01,Arkansas,2049502,1275392,1206255,69137
2002-04-01,California,25806595,17236951,16073530,1163421
2002-04-01,Colorado,3394409,2445804,2305382,140422
2002-04-01,Connecticut,2627024,1769952,1698245,71707
2002-04-01,Delaware,611183,418664,400248,18416
2002-04-01,Florida,12937202,8024970,7617735,407235
2002-04-01,Georgia,6324507,4325366,4093644,231722
2002-04-01,Hawaii,913296,601922,576688,25234
2002-04-01,Idaho,984072,684753,645116,39637
2002-04-01,Illinois,9451880,6368422,5949351,419071
2002-04-01,Indiana,4649772,3160170,2990511,169659
2002-04-01,Iowa,2244508,1629632,1564963,64669
2002-04-01,Kansas,2024833,1413886,1341873,72013
2002-04-01,Kentucky,3123099,1941430,1829467,111963
2002-04-01,Louisiana,3305599,2011560,1890066,121494
2002-04-01,Maine,1013225,676912,647467,29445
2002-04-01,Maryland,4094526,2875219,2733014,142205
2002-04-01,Massachusetts,4998907,3436229,3260976,175253
2002-04-01,Michigan,7609548,5041205,4723168,318037
2002-04-01,Minnesota,3813741,2866169,2733848,132321
2002-04-01,Mississippi,2109787,1288839,1204581,84258
2002-04-01,Missouri,4301583,2982422,2823829,158593
2002-04-01,Montana,698307,465289,443450,21839
2002-04-01,Nebraska,1296857,949620,914323,35297
2002-04-01,Nevada,1623098,1131648,1065636,66012
2002-04-01,Ohio,8698086,5823063,5482432,340631
2002-04-01,Oklahoma,2606960,1688588,1610736,77852
2002-04-01,Oregon,2712033,1830284,1690967,139317
2002-04-01,Pennsylvania,9546247,6223297,5876225,347072
2002-04-01,Tennessee,4434095,2888581,2734191,154390
2002-04-01,Texas,15719749,10695524,10020652,674872
2002-04-01,Utah,1648148,1175078,1109675,65403
2002-04-01,Vermont,482348,342300,329847,12453
2002-04-01,Virginia,5438518,3730064,3565303,164761
2002-04-01,Washington,4587299,3091399,2871449,219950
2002-04-01,Wisconsin,4160519,3011789,2848650,163139
2002-04-01,Wyoming,378392,268859,257984,10875
2002-05-01,Alabama,3401328,2108221,1982996,125225
2002-05-01,Alaska,451047,326413,303052,23361
2002-05-01,Arizona,4049916,2679893,2512557,167336
2002-05-01,Arkansas,2050547,1277481,1209000,68481
2002-05-01,California,25833940,17246156,16079713,1166443
2002-05-01,Colorado,3399138,2446512,2307558,138954
2002-05-01,Connecticut,2628719,1774362,1699923,74439
2002-05-01,Delaware,611867,418337,399979,18358
2002-05-01,Florida,12959162,8036185,7632061,404124
2002-05-01,Georgia,6334589,4333843,4101879,231964
2002-05-01,Hawaii,913889,601851,577294,24557
2002-05-01,Idaho,985659,685086,646021,39065
2002-05-01,Illinois,9456254,6353351,5933361,419990
2002-05-01,Indiana,4651908,3161568,2994729,166839
2002-05-01,Iowa,2245018,1632129,1567238,64891
2002-05-01,Kansas,2026012,1416809,1344642,72167
2002-05-01,Kentucky,3125031,1941560,1830478,111082
2002-05-01,Louisiana,3306659,2012044,1891573,120471
2002-05-01,Maine,1014188,678458,648669,29789
2002-05-01,Maryland,4099229,2877225,2737013,140212
2002-05-01,Massachusetts,5001592,3441058,3263768,177290
2002-05-01,Michigan,7613320,5037273,4721769,315504
2002-05-01,Minnesota,3817273,2869777,2738822,130955
2002-05-01,Mississippi,2110317,1288593,1205341,83252
2002-05-01,Missouri,4304730,2982808,2823997,158811
2002-05-01,Montana,698870,465503,443942,21561
2002-05-01,Nebraska,1297541,951090,915764,35326
2002-05-01,Nevada,1627566,1132733,1067427,65306
2002-05-01,Ohio,8701460,5820418,5479111,341307
2002-05-01,Oklahoma,2608481,1687674,1610573,77101
2002-05-01,Oregon,2715529,1832213,1695980,136233
2002-05-01,Pennsylvania,9549866,6227212,5882425,344787
2002-05-01,Tennessee,4437612,2894186,2743111,151075
2002-05-01,Texas,15742777,10717572,10037909,679663
2002-05-01,Utah,1651119,1177223,1110738,66485
2002-05-01,Vermont,482761,343007,330354,12653
2002-05-01,Virginia,5444702,3737322,3572609,164713
2002-05-01,Washington,4592891,3096484,2876853,219631
2002-05-01,Wisconsin,4164122,3011225,2849894,161331
2002-05-01,Wyoming,378808,269012,258203,10809
2002-06-01,Alabama,3402356,2110206,1985266,124940
2002-06-01,Alaska,451808,327004,303460,23544
2002-06-01,Arizona,4059426,2686901,2519224,167677
2002-06-01,Arkansas,2051705,1279123,1211468,67655
2002-06-01,California,25863088,17254392,16088050,1166342
2002-06-01,Colorado,3404075,2447907,2310088,137819
2002-06-01,Connecticut,2630600,1778355,1701245,77110
2002-06-01,Delaware,612606,417966,399841,18125
2002-06-01,Florida,12981925,8048829,7648435,400394
2002-06-01,Georgia,6344978,4342259,4111004,231255
2002-06-01,Hawaii,914553,602060,577963,24097
2002-06-01,Idaho,987341,685432,647086,38346
2002-06-01,Illinois,9461164,6339698,5920394,419304
2002-06-01,Indiana,4654304,3163193,2999422,163771
2002-06-01,Iowa,2245696,1633682,1568717,64965
2002-06-01,Kansas,2027326,1419829,1347595,72234
2002-06-01,Kentucky,3127066,1942475,1832009,110466
2002-06-01,Louisiana,3307869,2013274,1893725,119549
2002-06-01,Maine,1015204,679698,649682,30016
2002-06-01,Maryland,4104114,2878361,2740615,137746
2002-06-01,Massachusetts,5004538,3444134,3265227,178907
2002-06-01,Michigan,7617506,5034600,4722820,311780
2002-06-01,Minnesota,3821031,2874032,2744983,129049
2002-06-01,Mississippi,2111014,1288848,1206658,82190
2002-06-01,Missouri,4308070,2982883,2824655,158228
2002-06-01,Montana,699484,465763,444586,21177
2002-06-01,Nebraska,1298295,952567,917366,35201
2002-06-01,Nevada,1632156,1133856,1069391,64465
2002-06-01,Ohio,8705279,5820023,5479885,340138
2002-06-01,Oklahoma,2610169,1686526,1610231,76295
2002-06-01,Oregon,2719230,1834422,1700621,133801
2002-06-01,Pennsylvania,9554009,6229197,5887715,341482
2002-06-01,Tennessee,4441378,2900132,2752527,147605
2002-06-01,Texas,15766911,10739964,10057469,682495
2002-06-01,Utah,1654153,1179393,1112082,67311
2002-06-01,Vermont,483209,343619,330746,12873
2002-06-01,Virginia,5451225,3743911,3579785,164126
2002-06-01,Washington,4598753,3101726,2882720,219006
2002-06-01,Wisconsin,4167960,3011622,2852461,159161
2002-06-01,Wyoming,379237,269166,258506,10660
2002-07-01,Alabama,3403420,2112596,1987969,124627
2002-07-01,Alaska,452597,327506,303837,23669
2002-07-01,Arizona,4068974,2692591,2524962,167629
2002-07-01,Arkansas,2052905,1280081,1213231,66850
2002-07-01,California,25892172,17260607,16095366,1165241
2002-07-01,Colorado,3409041,2449523,2312334,137189
2002-07-01,Connecticut,2632445,1781679,1701951,79728
2002-07-01,Delaware,613315,417436,399636,17800
2002-07-01,Florida,13004706,8060559,7664361,396198
2002-07-01,Georgia,6355530,4349470,4119340,230130
2002-07-01,Hawaii,915205,602074,578420,23654
2002-07-01,Idaho,988987,685732,647998,37734
2002-07-01,Illinois,9466124,6327972,5910199,417773
2002-07-01,Indiana,4656712,3164269,3003252,161017
2002-07-01,Iowa,2246337,1634265,1569350,64915
2002-07-01,Kansas,2028625,1422571,1350263,72308
2002-07-01,Kentucky,3129155,1943823,1833625,110198
2002-07-01,Louisiana,3309155,2014218,1895402,118816
2002-07-01,Maine,1016191,680428,650251,30177
2002-07-01,Maryland,4109054,2878111,2742834,135277
2002-07-01,Massachusetts,5007522,3445684,3265298,180386
2002-07-01,Michigan,7621745,5031493,4724391,307102
2002-07-01,Minnesota,3824792,2877941,2750961,126980
2002-07-01,Mississippi,2111700,1289511,1208173,81338
2002-07-01,Missouri,4311449,2982468,2825178,157290
2002-07-01,Montana,700089,466129,445329,20800
2002-07-01,Nebraska,1299061,953908,918901,35007
2002-07-01,Nevada,1636758,1134916,1071236,63680
2002-07-01,Ohio,8709127,5820692,5482728,337964
2002-07-01,Oklahoma,2611859,1684995,1609314,75681
2002-07-01,Oregon,2722882,1836586,1704155,132431
2002-07-01,Pennsylvania,9558096,6228505,5889692,338813
2002-07-01,Tennessee,4445160,2905747,2761269,144478
2002-07-01,Texas,15791186,10760392,10076730,683662
2002-07-01,Utah,1657216,1181394,1113419,67975
2002-07-01,Vermont,483617,344083,330964,13119
2002-07-01,Virginia,5457742,3748794,3585682,163112
2002-07-01,Washington,4604606,3106198,2887777,218421
2002-07-01,Wisconsin,4171808,3012919,2855666,157253
2002-07-01,Wyoming,379662,269315,258805,10510
2002-08-01,Alabama,3405507,2114858,1990399,124459
2002-08-01,Alaska,453243,327961,304190,23771
2002-08-01,Arizona,4078506,2696958,2529718,167240
2002-08-01,Arkansas,2054532,1280510,1214201,66309
2002-08-01,California,25923440,17265303,16099903,1165400
2002-08-01,Colorado,3413275,2451231,2314156,137075
2002-08-01,Connecticut,2634571,1784019,1701698,82321
2002-08-01,Delaware,614168,416806,399339,17467
2002-08-01,Florida,13027230,8070560,7678422,392138
2002-08-01,Georgia,6365990,4355484,4126146,229338
2002-08-01,Hawaii,915763,601792,578604,23188
2002-08-01,Idaho,990626,686082,648680,37402
2002-08-01,Illinois,9471904,6318598,5902542,416056
2002-08-01,Indiana,4660120,3164621,3005770,158851
2002-08-01,Iowa,2247235,1633924,1569033,64891
2002-08-01,Kansas,2030028,1424813,1352395,72418
2002-08-01,Kentucky,3132038,1945275,1834920,110355
2002-08-01,Louisiana,3311148,2014494,1896156,118338
2002-08-01,Maine,1017263,680726,650354,30372
2002-08-01,Maryland,4113818,2876523,2743404,133119
2002-08-01,Massachusetts,5010165,3446164,3264164,182000
2002-08-01,Michigan,7626953,5027686,4725022,302664
2002-08-01,Minnesota,3828391,2880766,2755464,125302
2002-08-01,Mississippi,2112746,1290526,1209520,81006
2002-08-01,Missouri,4315054,2981884,2825233,156651
2002-08-01,Montana,700879,466655,446100,20555
2002-08-01,Nebraska,1299957,955197,920328,34869
2002-08-01,Nevada,1641510,1135935,1072869,63066
2002-08-01,Ohio,8714246,5822931,5486972,335959
2002-08-01,Oklahoma,2613541,1683619,1607957,75662
2002-08-01,Oregon,2726154,1838336,1706157,132179
2002-08-01,Pennsylvania,9563962,6224755,5886632,338123
2002-08-01,Tennessee,4449931,2910334,2768269,142065
2002-08-01,Texas,15815630,10778290,10093709,684581
2002-08-01,Utah,1660075,1183190,1114653,68537
2002-08-01,Vermont,484042,344417,331009,13408
2002-08-01,Virginia,5463319,3752059,3589982,162077
2002-08-01,Washington,4609900,3109557,2891346,218211
2002-08-01,Wisconsin,4175782,3015304,2858986,156318
2002-08-01,Wyoming,379950,269529,259072,10457
2002-09-01,Alabama,3407668,2116974,1992438,124536
2002-09-01,Alaska,453876,328484,304566,23918
2002-09-01,Arizona,4088189,2700112,2533571,166541
2002-09-01,Arkansas,2056241,1280684,1214407,66277
2002-09-01,California,25955547,17268697,16099890,1168807
2002-09-01,Colorado,3417582,2453132,2315596,137536
2002-09-01,Connecticut,2636738,1785478,1700557,84921
2002-09-01,Delaware,615047,416098,398862,17236
2002-09-01,Florida,13050162,8078773,7689746,389027
2002-09-01,Georgia,6376576,4360866,4131553,229313
2002-09-01,Hawaii,916404,601409,578670,22739
2002-09-01,Idaho,992340,686570,649216,37354
2002-09-01,Illinois,9477986,6311232,5896080,415152
2002-09-01,Indiana,4663649,3164383,3006927,157456
2002-09-01,Iowa,2248220,1632768,1567716,65052
2002-09-01,Kansas,2031501,1426508,1353983,72525
2002-09-01,Kentucky,3135036,1946797,1835666,111131
2002-09-01,Louisiana,3313261,2014574,1896307,118267
2002-09-01,Maine,1018360,680833,650081,30752
2002-09-01,Maryland,4118710,2874021,2742430,131591
2002-09-01,Massachusetts,5012887,3445655,3261712,183943
2002-09-01,Michigan,7632348,5024354,4723612,300742
2002-09-01,Minnesota,3832098,2882351,2757782,124569
2002-09-01,Mississippi,2113865,1291902,1210628,81274
2002-09-01,Missouri,4318745,2981296,2824655,156641
2002-09-01,Montana,701723,467314,446788,20526
2002-09-01,Nebraska,1300847,956546,921663,34883
2002-09-01,Nevada,1646297,1136979,1074275,62704
2002-09-01,Ohio,8719586,5827378,5491953,335425
2002-09-01,Oklahoma,2615302,1682961,1606327,76634
2002-09-01,Oregon,2729478,1839579,1706691,132888
2002-09-01,Pennsylvania,9570058,6217593,5877648,339945
2002-09-01,Tennessee,4454783,2913326,2772574,140752
2002-09-01,Texas,15840524,10794488,10106672,687816
2002-09-01,Utah,1662991,1184766,1115744,69022
2002-09-01,Vermont,484500,344668,330912,13756
2002-09-01,Virginia,5469003,3754158,3592628,161530
2002-09-01,Washington,4615349,3112187,2893420,218767
2002-09-01,Wisconsin,4179843,3018972,2862220,156752
2002-09-01,Wyoming,380242,269879,259292,10587
2002-10-01,Alabama,3409782,2118563,1993897,124666
2002-10-01,Alaska,454550,329033,304907,24126
2002-10-01,Arizona,4097842,2701676,2536063,165613
2002-10-01,Arkansas,2057929,1280542,1213757,66785
2002-10-01,California,25987483,17268118,16092890,1175228
2002-10-01,Colorado,3421889,2454819,2316185,138634
2002-10-01,Connecticut,2638916,1786092,1698628,87464
2002-10-01,Delaware,615913,415257,398035,17222
2002-10-01,Florida,13072974,8084293,7697494,386799
2002-10-01,Georgia,6387104,4365598,4135682,229916
2002-10-01,Hawaii,916970,601047,578693,22354
2002-10-01,Idaho,993976,687096,649596,37500
2002-10-01,Illinois,9483893,6304651,5888844,415807
2002-10-01,Indiana,4667145,3163767,3006965,156802
2002-10-01,Iowa,2249163,1630876,1565447,65429
2002-10-01,Kansas,2032959,1427543,1354925,72618
2002-10-01,Kentucky,3137960,1948234,1835707,112527
2002-10-01,Louisiana,3315312,2014905,1896063,118842
2002-10-01,Maine,1019471,680949,649562,31387
2002-10-01,Maryland,4123542,2870999,2739807,131192
2002-10-01,Massachusetts,5015587,3443173,3257011,186162
2002-10-01,Michigan,7637675,5021939,4719012,302927
2002-10-01,Minnesota,3835796,2882473,2757696,124777
2002-10-01,Mississippi,2114928,1293356,1211458,81898
2002-10-01,Missouri,4322412,2980257,2823047,157210
2002-10-01,Montana,702522,467923,447239,20684
2002-10-01,Nebraska,1301784,957799,922727,35072
2002-10-01,Nevada,1651061,1137876,1075294,62582
2002-10-01,Ohio,8724813,5833088,5495762,337326
2002-10-01,Oklahoma,2617031,1682784,1604244,78540
2002-10-01,Oregon,2732802,1840350,1706094,134256
2002-10-01,Pennsylvania,9576039,6206961,5862924,344037
2002-10-01,Tennessee,4459606,2914147,2773397,140750
2002-10-01,Texas,15865366,10808640,10114032,694608
2002-10-01,Utah,1665919,1185876,1116475,69401
2002-10-01,Vermont,484964,344833,330700,14133
2002-10-01,Virginia,5474685,3755197,3593456,161741
2002-10-01,Washington,4620749,3114211,2894005,220206
2002-10-01,Wisconsin,4183908,3023489,2865025,158464
2002-10-01,Wyoming,380549,270285,259390,10895
2002-11-01,Alabama,3411574,2119803,1995132,124671
2002-11-01,Alaska,455168,329561,305214,24347
2002-11-01,Arizona,4107099,2702200,2537727,164473
2002-11-01,Arkansas,2059408,1280124,1212489,67635
2002-11-01,California,26017694,17264788,16082472,1182316
2002-11-01,Colorado,3425994,2456738,2316466,140272
2002-11-01,Connecticut,2640838,1786347,1696550,89797
2002-11-01,Delaware,616748,414331,396891,17440
2002-11-01,Florida,13094247,8087760,7702971,384789
2002-11-01,Georgia,6397237,4370581,4139819,230762
2002-11-01,Hawaii,917617,600874,578794,22080
2002-11-01,Idaho,995570,687674,649955,37719
2002-11-01,Illinois,9489084,6299115,5881874,417241
2002-11-01,Indiana,4670256,3163560,3006919,156641
2002-11-01,Iowa,2249894,1628403,1562380,66023
2002-11-01,Kansas,2034195,1428217,1355511,72706
2002-11-01,Kentucky,3140683,1949751,1835512,114239
2002-11-01,Louisiana,3317084,2016048,1895925,120123
2002-11-01,Maine,1020485,681308,649075,32233
2002-11-01,Maryland,4128063,2868616,2736752,131864
2002-11-01,Massachusetts,5017859,3438660,3250328,188332
2002-11-01,Michigan,7642325,5020648,4711670,308978
2002-11-01,Minnesota,3839158,2881948,2756295,125653
2002-11-01,Mississippi,2115799,1294795,1212275,82520
2002-11-01,Missouri,4325706,2978936,2820955,157981
2002-11-01,Montana,703286,468428,447486,20942
2002-11-01,Nebraska,1302594,959078,923669,35409
2002-11-01,Nevada,1655768,1138723,1076155,62568
2002-11-01,Ohio,8729243,5840339,5498811,341528
2002-11-01,Oklahoma,2618501,1682745,1601941,80804
2002-11-01,Oregon,2735886,1840953,1704920,136033
2002-11-01,Pennsylvania,9580992,6194252,5845199,349053
2002-11-01,Tennessee,4464120,2913309,2771330,141979
2002-11-01,Texas,15889181,10822271,10118547,703724
2002-11-01,Utah,1668693,1186629,1117065,69564
2002-11-01,Vermont,485392,344987,330485,14502
2002-11-01,Virginia,5479937,3756070,3593538,162532
2002-11-01,Washington,4625771,3115768,2893803,221965
2002-11-01,Wisconsin,4187575,3028698,2867607,161091
2002-11-01,Wyoming,380830,270700,259405,11295
2002-12-01,Alabama,3412910,2120743,1996169,124574
2002-12-01,Alaska,455741,330077,305512,24565
2002-12-01,Arizona,4115824,2702525,2539424,163101
2002-12-01,Arkansas,2060635,1279487,1210881,68606
2002-12-01,California,26044606,17259702,16072079,1187623
2002-12-01,Colorado,3429650,2459550,2317145,142405
2002-12-01,Connecticut,2642420,1786393,1694632,91761
2002-12-01,Delaware,617498,413430,395638,17792
2002-12-01,Florida,13113801,8089532,7707195,382337
2002-12-01,Georgia,6406507,4376391,4144964,231427
2002-12-01,Hawaii,918142,600976,579036,21940
2002-12-01,Idaho,997058,688330,650391,37939
2002-12-01,Illinois,9493053,6293961,5876027,417934
2002-12-01,Indiana,4672749,3163872,3007178,156694
2002-12-01,Iowa,2250292,1625147,1558284,66863
2002-12-01,Kansas,2035183,1428762,1355925,72837
2002-12-01,Kentucky,3142981,1951266,1835308,115958
2002-12-01,Louisiana,3318446,2017967,1896200,121767
2002-12-01,Maine,1021339,681961,648763,33198
2002-12-01,Maryland,4132076,2867840,2734613,133227
2002-12-01,Massachusetts,5019466,3432610,3242442,190168
2002-12-01,Michigan,7646000,5020290,4702396,317894
2002-12-01,Minnesota,3842000,2881762,2754830,126932
2002-12-01,Mississippi,2116412,1295935,1213122,82813
2002-12-01,Missouri,4328401,2977790,2818837,158953
2002-12-01,Montana,703932,468847,447631,21216
2002-12-01,Nebraska,1303218,960489,924626,35863
2002-12-01,Nevada,1660229,1139620,1077130,62490
2002-12-01,Ohio,8732536,5848913,5501775,347138
2002-12-01,Oklahoma,2619600,1682720,1599750,82970
2002-12-01,Oregon,2738585,1841458,1703299,138159
2002-12-01,Pennsylvania,9584675,6180604,5827257,353347
2002-12-01,Tennessee,4468035,2911657,2767381,144276
2002-12-01,Texas,15910931,10836094,10123165,712929
2002-12-01,Utah,1671298,1187177,1117801,69376
2002-12-01,Vermont,485718,345139,330307,14832
2002-12-01,Virginia,5484530,3757075,3593715,163360
2002-12-01,Washington,4630181,3116864,2893327,223537
2002-12-01,Wisconsin,4190712,3033987,2869859,164128
2002-12-01,Wyoming,381063,271097,259410,11687
2003-01-01,Alabama,3414396,2121823,1997102,124721
2003-01-01,Alaska,456362,330628,305820,24808
2003-01-01,Arizona,4124592,2703900,2542108,161792
2003-01-01,Arkansas,2061880,1278953,1209257,69696
2003-01-01,California,26072135,17257209,16065489,1191720
2003-01-01,Colorado,3433355,2463721,2318615,145106
2003-01-01,Connecticut,2644003,1786460,1693003,93457
2003-01-01,Delaware,618270,412823,394645,18178
2003-01-01,Florida,13133514,8090994,7711130,379864
2003-01-01,Georgia,6415943,4383758,4151643,232115
2003-01-01,Hawaii,918710,601347,579331,22016
2003-01-01,Idaho,998526,689165,650994,38171
2003-01-01,Illinois,9497119,6290665,5872615,418050
2003-01-01,Indiana,4675288,3165387,3008223,157164
2003-01-01,Iowa,2250711,1621262,1553269,67993
2003-01-01,Kansas,2036212,1429715,1356442,73273
2003-01-01,Kentucky,3145239,1953079,1835364,117715
2003-01-01,Louisiana,3319932,2020780,1897054,123726
2003-01-01,Maine,1022204,682795,648641,34154
2003-01-01,Maryland,4136125,2869408,2734262,135146
2003-01-01,Massachusetts,5021081,3426342,3234426,191916
2003-01-01,Michigan,7649678,5022005,4693211,328794
2003-01-01,Minnesota,3844875,2883046,2754332,128714
2003-01-01,Mississippi,2117100,1296920,1214017,82903
2003-01-01,Missouri,4331112,2977841,2817329,160512
2003-01-01,Montana,704588,469189,447718,21471
2003-01-01,Nebraska,1303840,962142,925697,36445
2003-01-01,Nevada,1664718,1140824,1078469,62355
2003-01-01,Ohio,8735841,5859072,5505111,353961
2003-01-01,Oklahoma,2620758,1683263,1598051,85212
2003-01-01,Oregon,2741263,1842347,1701450,140897
2003-01-01,Pennsylvania,9588389,6168386,5812280,356106
2003-01-01,Tennessee,4471905,2910775,2763203,147572
2003-01-01,Texas,15933096,10852761,10130478,722283
2003-01-01,Utah,1673900,1187935,1118968,68967
2003-01-01,Vermont,486043,345314,330207,15107
2003-01-01,Virginia,5489117,3758558,3594457,164101
2003-01-01,Washington,4634614,3118244,2893139,225105
2003-01-01,Wisconsin,4193845,3039340,2871983,167357
2003-01-01,Wyoming,381254,271487,259482,12005
2003-02-01,Alabama,3414778,2123538,1998284,125254
2003-02-01,Alaska,456807,331210,306142,25068
2003-02-01,Arizona,4132450,2707087,2546216,160871
2003-02-01,Arkansas,2062580,1278812,1207914,70898
2003-02-01,California,26094053,17260877,16065354,1195523
2003-02-01,Colorado,3436189,2469409,2321211,148198
2003-02-01,Connecticut,2644968,1786818,1691836,94982
2003-02-01,Delaware,618854,412703,394190,18513
2003-02-01,Florida,13150127,8093533,7715910,377623
2003-02-01,Georgia,6423477,4392942,4159791,233151
2003-02-01,Hawaii,918969,601953,579595,22358
2003-02-01,Idaho,999754,690153,651733,38420
2003-02-01,Illinois,9498837,6291417,5873456,417961
2003-02-01,Indiana,4676608,3168763,3010266,158497
2003-02-01,Iowa,2250583,1617184,1547884,69300
2003-02-01,Kansas,2036703,1431658,1357353,74305
2003-02-01,Kentucky,3146771,1955720,1836063,119657
2003-02-01,Louisiana,3320353,2024386,1898235,126151
2003-02-01,Maine,1022832,683619,648651,34968
2003-02-01,Maryland,4139046,2873220,2735901,137319
2003-02-01,Massachusetts,5021549,3421546,3227814,193732
2003-02-01,Michigan,7651421,5026534,4686189,340345
2003-02-01,Minnesota,3846805,2886146,2755130,131016
2003-02-01,Mississippi,2117143,1298228,1215235,82993
2003-02-01,Missouri,4332750,2979689,2817042,162647
2003-02-01,Montana,705108,469389,447712,21677
2003-02-01,Nebraska,1304155,963983,926878,37105
2003-02-01,Nevada,1668826,1142496,1080294,62202
2003-02-01,Ohio,8737003,5870822,5509218,361604
2003-02-01,Oklahoma,2621249,1684854,1597145,87709
2003-02-01,Oregon,2743343,1843851,1699566,144285
2003-02-01,Pennsylvania,9589850,6159680,5802424,357256
2003-02-01,Tennessee,4474672,2911211,2759640,151571
2003-02-01,Texas,15951655,10873455,10141790,731665
2003-02-01,Utah,1676103,1189174,1120709,68465
2003-02-01,Vermont,486328,345555,330229,15326
2003-02-01,Virginia,5492366,3760778,3595995,164783
2003-02-01,Washington,4637971,3120445,2893714,226731
2003-02-01,Wisconsin,4195995,3044768,2874343,170425
2003-02-01,Wyoming,381432,271871,259674,12197
2003-03-01,Alabama,3415165,2125759,1999675,126084
2003-03-01,Alaska,457242,331713,306393,25320
2003-03-01,Arizona,4140103,2711777,2551211,160566
2003-03-01,Arkansas,2063221,1279094,1206946,72148
2003-03-01,California,26113712,17269010,16069800,1199210
2003-03-01,Colorado,3438934,2476117,2324818,151299
2003-03-01,Connecticut,2645875,1787321,1690969,96352
2003-03-01,Delaware,619442,413055,394290,18765
2003-03-01,Florida,13165982,8096655,7721190,375465
2003-03-01,Georgia,6430745,4402771,4168351,234420
2003-03-01,Hawaii,919140,602598,579724,22874
2003-03-01,Idaho,1000990,691062,652351,38711
2003-03-01,Illinois,9500180,6296371,5877884,418487
2003-03-01,Indiana,4677936,3173810,3012924,160886
2003-03-01,Iowa,2250457,1613222,1542602,70620
2003-03-01,Kansas,2037190,1434427,1358496,75931
2003-03-01,Kentucky,3148265,1959031,1837422,121609
2003-03-01,Louisiana,3320700,2027988,1898999,128989
2003-03-01,Maine,1023474,684207,648663,35544
2003-03-01,Maryland,4141769,2877933,2738709,139224
2003-03-01,Massachusetts,5021914,3418751,3223170,195581
2003-03-01,Michigan,7653059,5032775,4681665,351110
2003-03-01,Minnesota,3848728,2890205,2756587,133618
2003-03-01,Mississippi,2117085,1300092,1216916,83176
2003-03-01,Missouri,4334368,2982773,2817521,165252
2003-03-01,Montana,705616,469459,447617,21842
2003-03-01,Nebraska,1304463,965709,927963,37746
2003-03-01,Nevada,1672836,1144406,1082404,62002
2003-03-01,Ohio,8738069,5881930,5513335,368595
2003-03-01,Oklahoma,2621697,1686997,1596735,90262
2003-03-01,Oregon,2745383,1845493,1697569,147924
2003-03-01,Pennsylvania,9591186,6154613,5797686,356927
2003-03-01,Tennessee,4477375,2911978,2756243,155735
2003-03-01,Texas,15968829,10895560,10155181,740379
2003-03-01,Utah,1678267,1190721,1122826,67895
2003-03-01,Vermont,486559,345800,330347,15453
2003-03-01,Virginia,5495405,3763269,3598178,165091
2003-03-01,Washington,4641204,3123196,2894938,228258
2003-03-01,Wisconsin,4198093,3049303,2876330,172973
2003-03-01,Wyoming,381562,272209,259961,12248
2003-04-01,Alabama,3415998,2127689,2000568,127121
2003-04-01,Alaska,457783,332007,306473,25534
2003-04-01,Arizona,4148283,2717061,2556062,160999
2003-04-01,Arkansas,2064161,1279520,1206122,73398
2003-04-01,California,26137633,17276048,16072953,1203095
2003-04-01,Colorado,3442163,2482465,2328555,153910
2003-04-01,Connecticut,2647132,1787410,1689813,97597
2003-04-01,Delaware,620089,413703,394764,18939
2003-04-01,Florida,13183724,8099233,7725653,373580
2003-04-01,Georgia,6438979,4411122,4175537,235585
2003-04-01,Hawaii,919533,603039,579580,23459
2003-04-01,Idaho,1002322,691574,652536,39038
2003-04-01,Illinois,9502880,6303732,5882376,421356
2003-04-01,Indiana,4679781,3178702,3014768,163934
2003-04-01,Iowa,2250596,1609268,1537462,71806
2003-04-01,Kansas,2037898,1437328,1359347,77981
2003-04-01,Kentucky,3150164,1962327,1838964,123363
2003-04-01,Louisiana,3321512,2030239,1898379,131860
2003-04-01,Maine,1024226,684459,648585,35874
2003-04-01,Maryland,4145133,2881713,2741220,140493
2003-04-01,Massachusetts,5022946,3417530,3220113,197417
2003-04-01,Michigan,7655628,5038479,4678151,360328
2003-04-01,Minnesota,3851087,2893808,2757485,136323
2003-04-01,Mississippi,2117354,1302002,1218670,83332
2003-04-01,Missouri,4336500,2985771,2817464,168307
2003-04-01,Montana,706169,469443,447423,22020
2003-04-01,Nebraska,1304918,966889,928577,38312
2003-04-01,Nevada,1677090,1146247,1084395,61852
2003-04-01,Ohio,8740208,5888502,5514713,373789
2003-04-01,Oklahoma,2622439,1688823,1596225,92598
2003-04-01,Oregon,2747730,1846465,1695149,151316
2003-04-01,Pennsylvania,9593671,6151610,5795712,355898
2003-04-01,Tennessee,4480603,2911558,2751937,159621
2003-04-01,Texas,15988591,10914382,10166243,748139
2003-04-01,Utah,1680654,1192248,1124891,67357
2003-04-01,Vermont,486858,345952,330449,15503
2003-04-01,Virginia,5499170,3765173,3600147,165026
2003-04-01,Washington,4645066,3125925,2896270,229655
2003-04-01,Wisconsin,4200667,3051560,2876683,174877
2003-04-01,Wyoming,381725,272451,260258,12193
2003-05-01,Alabama,3417808,2128612,2000426,128186
2003-05-01,Alaska,458416,332068,306377,25691
2003-05-01,Arizona,4157421,2722263,2560450,161813
2003-05-01,Arkansas,2065680,1279954,1205338,74616
2003-05-01,California,26166389,17277573,16070128,1207445
2003-05-01,Colorado,3446297,2487392,2331724,155668
2003-05-01,Connecticut,2649006,1786680,1687977,98703
2003-05-01,Delaware,620936,414471,395441,19030
2003-05-01,Florida,13204215,8101013,7729028,371985
2003-05-01,Georgia,6449263,4416278,4180089,236189
2003-05-01,Hawaii,920043,603185,579162,24023
2003-05-01,Idaho,1003977,691579,652227,39352
2003-05-01,Illinois,9508070,6310771,5884178,426593
2003-05-01,Indiana,4683141,3181578,3014778,166800
2003-05-01,Iowa,2251443,1605585,1532841,72744
2003-05-01,Kansas,2039274,1439617,1359507,80110
2003-05-01,Kentucky,3153011,1965019,1840231,124788
2003-05-01,Louisiana,3323414,2030426,1896284,134142
2003-05-01,Maine,1025280,684413,648376,36037
2003-05-01,Maryland,4149472,2883328,2742266,141062
2003-05-01,Massachusetts,5025332,3417015,3217898,199117
2003-05-01,Michigan,7660435,5041951,4673980,367971
2003-05-01,Minnesota,3854699,2895878,2756921,138957
2003-05-01,Mississippi,2118291,1303461,1220150,83311
2003-05-01,Missouri,4339886,2987377,2815900,171477
2003-05-01,Montana,706947,469424,447206,22218
2003-05-01,Nebraska,1305813,967308,928510,38798
2003-05-01,Nevada,1681640,1147822,1086007,61815
2003-05-01,Ohio,8744855,5887473,5511232,376241
2003-05-01,Oklahoma,2623999,1689767,1595331,94436
2003-05-01,Oregon,2750824,1846543,1692712,153831
2003-05-01,Pennsylvania,9598714,6149152,5794052,355100
2003-05-01,Tennessee,4485189,2909176,2746286,162890
2003-05-01,Texas,16012098,10925861,10171387,754474
2003-05-01,Utah,1683758,1193559,1126613,66946
2003-05-01,Vermont,487311,345974,330456,15518
2003-05-01,Virginia,5504445,3766108,3601264,164844
2003-05-01,Washington,4650109,3128353,2897598,230755
2003-05-01,Wisconsin,4204541,3050805,2874680,176125
2003-05-01,Wyoming,382030,272567,260498,12069
2003-06-01,Alabama,3419291,2128804,1999701,129103
2003-06-01,Alaska,459028,332043,306239,25804
2003-06-01,Arizona,4166328,2727006,2564885,162121
2003-06-01,Arkansas,2066999,1280646,1204963,75683
2003-06-01,California,26194176,17275195,16063917,1211278
2003-06-01,Colorado,3450142,2491025,2334532,156493
2003-06-01,Connecticut,2650723,1785544,1685978,99566
2003-06-01,Delaware,621700,415324,396290,19034
2003-06-01,Florida,13224481,8104217,7734089,370128
2003-06-01,Georgia,6458596,4418916,4183266,235650
2003-06-01,Hawaii,920534,603222,578749,24473
2003-06-01,Idaho,1005541,691330,651775,39555
2003-06-01,Illinois,9512364,6316222,5883562,432660
2003-06-01,Indiana,4685927,3181931,3013693,168238
2003-06-01,Iowa,2252059,1602990,1529681,73309
2003-06-01,Kansas,2040395,1441198,1359313,81885
2003-06-01,Kentucky,3155471,1967061,1841327,125734
2003-06-01,Louisiana,3324821,2028933,1893949,134984
2003-06-01,Maine,1026241,684333,648247,36086
2003-06-01,Maryland,4153573,2883042,2742191,140851
2003-06-01,Massachusetts,5027336,3417145,3216757,200388
2003-06-01,Michigan,7664493,5043417,4669927,373490
2003-06-01,Minnesota,3857860,2896560,2755275,141285
2003-06-01,Mississippi,2118933,1304538,1221716,82822
2003-06-01,Missouri,4342876,2987369,2813329,174040
2003-06-01,Montana,707670,469560,447142,22418
2003-06-01,Nebraska,1306572,967242,928079,39163
2003-06-01,Nevada,1686175,1149241,1087432,61809
2003-06-01,Ohio,8748623,5879773,5504397,375376
2003-06-01,Oklahoma,2625260,1689877,1594367,95510
2003-06-01,Oregon,2753736,1846252,1691406,154846
2003-06-01,Pennsylvania,9603140,6147708,5793050,354658
2003-06-01,Tennessee,4489233,2905614,2740213,165401
2003-06-01,Texas,16034567,10929937,10172062,757875
2003-06-01,Utah,1686441,1194843,1128161,66682
2003-06-01,Vermont,487704,345951,330455,15496
2003-06-01,Virginia,5509213,3767138,3602525,164613
2003-06-01,Washington,4654799,3131155,2899925,231230
2003-06-01,Wisconsin,4208041,3048023,2871404,176619
2003-06-01,Wyoming,382297,272638,260714,11924
2003-07-01,Alabama,3421104,2128750,1999284,129466
2003-07-01,Alaska,459663,332097,306247,25850
2003-07-01,Arizona,4175564,2731033,2569956,161077
2003-07-01,Arkansas,2068537,1281653,1205346,76307
2003-07-01,California,26223362,17270209,16059225,1210984
2003-07-01,Colorado,3454238,2493863,2337595,156268
2003-07-01,Connecticut,2652706,1784434,1684501,99933
2003-07-01,Delaware,622538,416187,397233,18954
2003-07-01,Florida,13245749,8110290,7743475,366815
2003-07-01,Georgia,6468625,4420118,4186992,233126
2003-07-01,Hawaii,921097,603389,578677,24712
2003-07-01,Idaho,1007178,691170,651690,39480
2003-07-01,Illinois,9517498,6319227,5881948,437279
2003-07-01,Indiana,4689150,3184984,3012381,172603
2003-07-01,Iowa,2252879,1601794,1528425,73369
2003-07-01,Kansas,2041713,1442340,1359351,82989
2003-07-01,Kentucky,3158261,1968616,1842812,125804
2003-07-01,Louisiana,3326586,2026467,1892790,133677
2003-07-01,Maine,1027304,684502,648501,36001
2003-07-01,Maryland,4157985,2881933,2742022,139911
2003-07-01,Massachusetts,5029743,3417448,3216813,200635
2003-07-01,Michigan,7669272,5042857,4667405,375452
2003-07-01,Minnesota,3861413,2896186,2753315,142871
2003-07-01,Mississippi,2119791,1305402,1223833,81569
2003-07-01,Missouri,4346246,2986021,2810931,175090
2003-07-01,Montana,708447,469905,447344,22561
2003-07-01,Nebraska,1307432,967005,927760,39245
2003-07-01,Nevada,1690819,1150665,1089097,61568
2003-07-01,Ohio,8753223,5868132,5496831,371301
2003-07-01,Oklahoma,2626741,1689067,1593599,95468
2003-07-01,Oregon,2756849,1846103,1692219,153884
2003-07-01,Pennsylvania,9608391,6147794,5794429,353365
2003-07-01,Tennessee,4493757,2901590,2734779,166811
2003-07-01,Texas,16058127,10927994,10172127,755867
2003-07-01,Utah,1689284,1196359,1129956,66403
2003-07-01,Vermont,488147,346000,330591,15409
2003-07-01,Virginia,5514506,3769197,3605103,164094
2003-07-01,Washington,4659866,3134825,2904280,230545
2003-07-01,Wisconsin,4211892,3044763,2868700,176063
2003-07-01,Wyoming,382570,272733,260963,11770
2003-08-01,Alabama,3423238,2129017,1999855,129162
2003-08-01,Alaska,460685,332332,306517,25815
2003-08-01,Arizona,4186779,2734633,2575892,158741
2003-08-01,Arkansas,2070283,1282903,1206566,76337
2003-08-01,California,26250052,17265087,16060723,1204364
2003-08-01,Colorado,3457413,2496348,2341278,155070
2003-08-01,Connecticut,2654002,1783860,1684158,99702
2003-08-01,Delaware,623435,416949,398144,18805
2003-08-01,Florida,13274309,8119870,7758518,361352
2003-08-01,Georgia,6479064,4420604,4192012,228592
2003-08-01,Hawaii,922997,603776,579109,24667
2003-08-01,Idaho,1008996,691271,652165,39106
2003-08-01,Illinois,9521732,6319651,5881117,438534
2003-08-01,Indiana,4691592,3185326,3011148,174178
2003-08-01,Iowa,2253922,1601957,1529011,72946
2003-08-01,Kansas,2042694,1443351,1360039,83312
2003-08-01,Kentucky,3159839,1969986,1845195,124791
2003-08-01,Louisiana,3327995,2023769,1893321,130448
2003-08-01,Maine,1028102,684986,649213,35773
2003-08-01,Maryland,4162588,2881078,2742425,138653
2003-08-01,Massachusetts,5031325,3417555,3217956,199599
2003-08-01,Michigan,7673132,5040339,4667414,372925
2003-08-01,Minnesota,3864387,2895313,2751827,143486
2003-08-01,Mississippi,2121239,1306240,1226606,79634
2003-08-01,Missouri,4349981,2983820,2809610,174210
2003-08-01,Montana,709324,470428,447793,22635
2003-08-01,Nebraska,1308155,966945,927921,39024
2003-08-01,Nevada,1696711,1152200,1091261,60939
2003-08-01,Ohio,8756563,5854949,5489480,365469
2003-08-01,Oklahoma,2627866,1687374,1593130,94244
2003-08-01,Oregon,2759073,1846248,1694882,151366
2003-08-01,Pennsylvania,9612804,6149847,5799235,350612
2003-08-01,Tennessee,4497989,2897894,2731083,166811
2003-08-01,Texas,16081863,10922719,10174868,747851
2003-08-01,Utah,1692910,1198297,1132248,66049
2003-08-01,Vermont,488487,346211,330950,15261
2003-08-01,Virginia,5523829,3772572,3609338,163234
2003-08-01,Washington,4667040,3139210,2910556,228654
2003-08-01,Wisconsin,4215263,3042098,2867777,174321
2003-08-01,Wyoming,382889,272882,261257,11625
2003-09-01,Alabama,3425643,2129622,2001329,128293
2003-09-01,Alaska,461755,332691,306977,25714
2003-09-01,Arizona,4198248,2738684,2583001,155683
2003-09-01,Arkansas,2072182,1284302,1208502,75800
2003-09-01,California,26278279,17263667,16072530,1191137
2003-09-01,Colorado,3460845,2499159,2345933,153226
2003-09-01,Connecticut,2655410,1784048,1685164,98884
2003-09-01,Delaware,624382,417632,399074,18558
2003-09-01,Florida,13303522,8133676,7779744,353932
2003-09-01,Georgia,6490033,4421083,4198374,222709
2003-09-01,Hawaii,924992,604305,579989,24316
2003-09-01,Idaho,1010917,691656,653166,38490
2003-09-01,Illinois,9526623,6318480,5883328,435152
2003-09-01,Indiana,4694387,3183267,3009839,173428
2003-09-01,Iowa,2255124,1603110,1530971,72139
2003-09-01,Kansas,2043838,1444510,1361564,82946
2003-09-01,Kentucky,3161670,1970945,1848250,122695
2003-09-01,Louisiana,3329678,2021343,1895184,126159
2003-09-01,Maine,1028984,685706,650325,35381
2003-09-01,Maryland,4167436,2881086,2743719,137367
2003-09-01,Massachusetts,5033162,3417557,3220236,197321
2003-09-01,Michigan,7677527,5036588,4670668,365920
2003-09-01,Minnesota,3867659,2894312,2751315,142997
2003-09-01,Mississippi,2122873,1307127,1229625,77502
2003-09-01,Missouri,4354009,2981706,2809905,171801
2003-09-01,Montana,710264,471079,448428,22651
2003-09-01,Nebraska,1308971,967363,928751,38612
2003-09-01,Nevada,1702703,1153973,1094058,59915
2003-09-01,Ohio,8760450,5842700,5483261,359439
2003-09-01,Oklahoma,2629174,1685365,1593198,92167
2003-09-01,Oregon,2761466,1846243,1698110,148133
2003-09-01,Pennsylvania,9617686,6154445,5807656,346789
2003-09-01,Tennessee,4502551,2895997,2730811,165186
2003-09-01,Texas,16106743,10917190,10182968,734222
2003-09-01,Utah,1696697,1200793,1135187,65606
2003-09-01,Vermont,488848,346597,331542,15055
2003-09-01,Virginia,5533516,3777038,3615047,161991
2003-09-01,Washington,4674477,3143660,2917929,225731
2003-09-01,Wisconsin,4218887,3040587,2869153,171434
2003-09-01,Wyoming,383278,273101,261603,11498
2003-10-01,Alabama,3428231,2130528,2003261,127267
2003-10-01,Alaska,462857,333167,307559,25608
2003-10-01,Arizona,4209900,2744026,2591421,152605
2003-10-01,Arkansas,2074201,1285880,1210857,75023
2003-10-01,California,26307573,17269193,16094450,1174743
2003-10-01,Colorado,3464444,2502946,2351616,151330
2003-10-01,Connecticut,2656933,1784796,1687054,97742
2003-10-01,Delaware,625360,418372,400154,18218
2003-10-01,Florida,13333328,8151977,7805958,346019
2003-10-01,Georgia,6501406,4422206,4205499,216707
2003-10-01,Hawaii,926990,604988,581186,23802
2003-10-01,Idaho,1012861,692353,654562,37791
2003-10-01,Illinois,9532034,6317462,5889487,427975
2003-10-01,Indiana,4697419,3179816,3008157,171659
2003-10-01,Iowa,2256451,1604550,1533278,71272
2003-10-01,Kansas,2045110,1446147,1363822,82325
2003-10-01,Kentucky,3163657,1971376,1851332,120044
2003-10-01,Louisiana,3331606,2019694,1897863,121831
2003-10-01,Maine,1029897,686502,651594,34908
2003-10-01,Maryland,4172517,2882205,2745964,136241
2003-10-01,Massachusetts,5035257,3418074,3223709,194365
2003-10-01,Michigan,7682318,5033675,4676707,356968
2003-10-01,Minnesota,3871115,2894068,2751990,142078
2003-10-01,Mississippi,2124659,1308109,1232402,75707
2003-10-01,Missouri,4358264,2980658,2811647,169011
2003-10-01,Montana,711223,471769,449135,22634
2003-10-01,Nebraska,1309858,968311,930113,38198
2003-10-01,Nevada,1708723,1156108,1097432,58676
2003-10-01,Ohio,8764783,5834868,5479949,354919
2003-10-01,Oklahoma,2630617,1683879,1593970,89909
2003-10-01,Oregon,2763994,1846070,1700683,145387
2003-10-01,Pennsylvania,9623058,6161444,5818505,342939
2003-10-01,Tennessee,4507358,2897192,2734732,162460
2003-10-01,Texas,16132392,10914620,10196142,718478
2003-10-01,Utah,1700614,1203895,1138743,65152
2003-10-01,Vermont,489284,347093,332278,14815
2003-10-01,Virginia,5543519,3782228,3621422,160806
2003-10-01,Washington,4682139,3148255,2925796,222459
2003-10-01,Wisconsin,4222784,3040588,2872503,168085
2003-10-01,Wyoming,383660,273397,261989,11408
2003-11-01,Alabama,3430170,2131842,2005331,126511
2003-11-01,Alaska,463911,333763,308198,25565
2003-11-01,Arizona,4220869,2750731,2600436,150295
2003-11-01,Arkansas,2075835,1287593,1213244,74349
2003-11-01,California,26333470,17281265,16121723,1159542
2003-11-01,Colorado,3467548,2507509,2357816,149693
2003-11-01,Connecticut,2658035,1785439,1688882,96557
2003-11-01,Delaware,626250,419202,401340,17862
2003-11-01,Florida,13360573,8174013,7834864,339149
2003-11-01,Georgia,6511724,4423796,4212058,211738
2003-11-01,Hawaii,928979,605792,582527,23265
2003-11-01,Idaho,1014648,693226,656127,37099
2003-11-01,Illinois,9535761,6317719,5898467,419252
2003-11-01,Indiana,4699675,3176445,3006203,170242
2003-11-01,Iowa,2257338,1605690,1535107,70583
2003-11-01,Kansas,2045976,1448307,1366448,81859
2003-11-01,Kentucky,3165112,1971533,1853982,117551
2003-11-01,Louisiana,3332888,2019200,1900665,118535
2003-11-01,Maine,1030670,687101,652696,34405
2003-11-01,Maryland,4176911,2883747,2748357,135390
2003-11-01,Massachusetts,5036488,3419070,3227750,191320
2003-11-01,Michigan,7685770,5032945,4684308,348637
2003-11-01,Minnesota,3873956,2894698,2753577,141121
2003-11-01,Mississippi,2126027,1309185,1234681,74504
2003-11-01,Missouri,4361784,2980796,2813972,166824
2003-11-01,Montana,712076,472455,449865,22590
2003-11-01,Nebraska,1310533,969517,931612,37905
2003-11-01,Nevada,1714576,1158519,1101069,57450
2003-11-01,Ohio,8767557,5832832,5479600,353232
2003-11-01,Oklahoma,2631551,1683396,1595323,88073
2003-11-01,Oregon,2766049,1845891,1702166,143725
2003-11-01,Pennsylvania,9626595,6169696,5829763,339933
2003-11-01,Tennessee,4511411,2901005,2741593,159412
2003-11-01,Texas,16155874,10916509,10211768,704741
2003-11-01,Utah,1704232,1207415,1142603,64812
2003-11-01,Vermont,489616,347579,333022,14557
2003-11-01,Virginia,5552661,3787379,3627313,160066
2003-11-01,Washington,4689061,3153213,2933779,219434
2003-11-01,Wisconsin,4225924,3041626,2876787,164839
2003-11-01,Wyoming,383993,273715,262374,11341
2003-12-01,Alabama,3431807,2133454,2007337,126117
2003-12-01,Alaska,464858,334331,308764,25567
2003-12-01,Arizona,4231303,2757982,2608899,149083
2003-12-01,Arkansas,2077275,1289246,1215325,73921
2003-12-01,California,26356013,17296238,16148787,1147451
2003-12-01,Colorado,3470280,2512316,2364038,148278
2003-12-01,Connecticut,2658866,1785366,1689903,95463
2003-12-01,Delaware,627048,419970,402384,17586
2003-12-01,Florida,13386234,8198317,7864381,333936
2003-12-01,Georgia,6521486,4425357,4216858,208499
2003-12-01,Hawaii,930848,606630,583854,22776
2003-12-01,Idaho,1016340,694026,657598,36428
2003-12-01,Illinois,9538602,6320242,5908710,411532
2003-12-01,Indiana,4701502,3173945,3003831,170114
2003-12-01,Iowa,2258018,1606085,1535920,70165
2003-12-01,Kansas,2046639,1450811,1369067,81744
2003-12-01,Kentucky,3166269,1971526,1855980,115546
2003-12-01,Louisiana,3333925,2019717,1902785,116932
2003-12-01,Maine,1031313,687266,653415,33851
2003-12-01,Maryland,4180924,2884706,2749938,134768
2003-12-01,Massachusetts,5037233,3419585,3231161,188424
2003-12-01,Michigan,7688514,5034154,4691877,342277
2003-12-01,Minnesota,3876409,2895470,2755484,139986
2003-12-01,Mississippi,2127213,1310365,1236306,74059
2003-12-01,Missouri,4364893,2981753,2816016,165737
2003-12-01,Montana,712868,473096,450588,22508
2003-12-01,Nebraska,1311049,970633,932873,37760
2003-12-01,Nevada,1720218,1160955,1104598,56357
2003-12-01,Ohio,8769517,5834737,5480533,354204
2003-12-01,Oklahoma,2632214,1683573,1596931,86642
2003-12-01,Oregon,2767811,1845845,1702937,142908
2003-12-01,Pennsylvania,9629193,6177952,5840068,337884
2003-12-01,Tennessee,4515018,2905059,2748669,156390
2003-12-01,Texas,16177465,10921845,10227213,694632
2003-12-01,Utah,1707689,1210983,1146380,64603
2003-12-01,Vermont,489876,347928,333636,14292
2003-12-01,Virginia,5561272,3791774,3631928,159846
2003-12-01,Washington,4695514,3158238,2941507,216731
2003-12-01,Wisconsin,4228696,3042705,2880690,162015
2003-12-01,Wyoming,384284,273956,262705,11251
2004-01-01,Alabama,3433085,2135079,2009233,125846
2004-01-01,Alaska,465863,334741,309147,25594
2004-01-01,Arizona,4241467,2764569,2615971,148598
2004-01-01,Arkansas,2078485,1290641,1216905,73736
2004-01-01,California,26377278,17309407,16171157,1138250
2004-01-01,Colorado,3472675,2516896,2369974,146922
2004-01-01,Connecticut,2659392,1784241,1689747,94494
2004-01-01,Delaware,627838,420491,403050,17441
2004-01-01,Florida,13410688,8222986,7892825,330161
2004-01-01,Georgia,6530444,4426692,4219452,207240
2004-01-01,Hawaii,932670,607403,585087,22316
2004-01-01,Idaho,1017947,694609,658773,35836
2004-01-01,Illinois,9540419,6323763,5918111,405652
2004-01-01,Indiana,4702738,3169561,3000682,168879
2004-01-01,Iowa,2258410,1605504,1535411,70093
2004-01-01,Kansas,2047136,1453222,1371321,81901
2004-01-01,Kentucky,3167008,1971320,1857263,114057
2004-01-01,Louisiana,3334560,2020598,1903715,116883
2004-01-01,Maine,1031825,686975,653703,33272
2004-01-01,Maryland,4184452,2884243,2750195,134048
2004-01-01,Massachusetts,5037389,3418790,3233088,185702
2004-01-01,Michigan,7690309,5035899,4697353,338546
2004-01-01,Minnesota,3878373,2895742,2757083,138659
2004-01-01,Mississippi,2128150,1311475,1237222,74253
2004-01-01,Missouri,4367411,2982863,2817084,165779
2004-01-01,Montana,713535,473764,451372,22392
2004-01-01,Nebraska,1311438,971430,933710,37720
2004-01-01,Nevada,1725746,1163180,1107754,55426
2004-01-01,Ohio,8770391,5837546,5481118,356428
2004-01-01,Oklahoma,2632625,1683822,1598419,85403
2004-01-01,Oregon,2769240,1845768,1703314,142454
2004-01-01,Pennsylvania,9630651,6184757,5847893,336864
2004-01-01,Tennessee,4518034,2907164,2753587,153577
2004-01-01,Texas,16197933,10928063,10240704,687359
2004-01-01,Utah,1710973,1214258,1149805,64453
2004-01-01,Vermont,490092,348063,334025,14038
2004-01-01,Virginia,5569244,3794851,3634949,159902
2004-01-01,Washington,4701428,3163028,2948817,214211
2004-01-01,Wisconsin,4230892,3042711,2882994,159717
2004-01-01,Wyoming,384501,274065,262943,11122
2004-02-01,Alabama,3434233,2136691,2011207,125484
2004-02-01,Alaska,466768,335025,309418,25607
2004-02-01,Arizona,4251399,2770136,2621950,148186
2004-02-01,Arkansas,2079612,1291843,1218111,73732
2004-02-01,California,26397491,17319192,16188165,1131027
2004-02-01,Colorado,3475004,2521021,2375527,145494
2004-02-01,Connecticut,2659831,1782166,1688517,93649
2004-02-01,Delaware,628564,420727,403296,17431
2004-02-01,Florida,13434633,8247628,7920060,327568
2004-02-01,Georgia,6539377,4428141,4220186,207955
2004-02-01,Hawaii,934399,608045,586207,21838
2004-02-01,Idaho,1019480,695078,659740,35338
2004-02-01,Illinois,9542153,6326743,5925269,401474
2004-02-01,Indiana,4703907,3171522,2997382,174140
2004-02-01,Iowa,2258753,1604405,1534065,70340
2004-02-01,Kansas,2047513,1455058,1373033,82025
2004-02-01,Kentucky,3167748,1971186,1858197,112989
2004-02-01,Louisiana,3335103,2021542,1903786,117756
2004-02-01,Maine,1032322,686333,653662,32671
2004-02-01,Maryland,4187889,2882230,2749114,133116
2004-02-01,Massachusetts,5037486,3416688,3233494,183194
2004-02-01,Michigan,7691969,5037351,4699682,337669
2004-02-01,Minnesota,3880315,2895200,2758035,137165
2004-02-01,Mississippi,2129087,1312472,1237618,74854
2004-02-01,Missouri,4369873,2983993,2816937,167056
2004-02-01,Montana,714239,474629,452382,22247
2004-02-01,Nebraska,1311808,971902,934181,37721
2004-02-01,Nevada,1731208,1165251,1110585,54666
2004-02-01,Ohio,8771140,5839665,5481024,358641
2004-02-01,Oklahoma,2632965,1684158,1599873,84285
2004-02-01,Oregon,2770623,1845673,1703875,141798
2004-02-01,Pennsylvania,9631959,6189449,5852887,336562
2004-02-01,Tennessee,4521058,2907162,2756040,151122
2004-02-01,Texas,16218019,10934073,10252267,681806
2004-02-01,Utah,1714254,1217238,1152913,64325
2004-02-01,Vermont,490317,347989,334196,13793
2004-02-01,Virginia,5577107,3796863,3636925,159938
2004-02-01,Washington,4707256,3167586,2955903,211683
2004-02-01,Wisconsin,4233063,3041271,2883526,157745
2004-02-01,Wyoming,384777,274060,263110,10950
2004-03-01,Alabama,3435850,2138605,2013596,125009
2004-03-01,Alaska,467758,335316,309738,25578
2004-03-01,Arizona,4261812,2775047,2627781,147266
2004-03-01,Arkansas,2081054,1293256,1219410,73846
2004-03-01,California,26419460,17329131,16204247,1124884
2004-03-01,Colorado,3477768,2525009,2380909,144100
2004-03-01,Connecticut,2660629,1779987,1687010,92977
2004-03-01,Delaware,629366,420756,403235,17521
2004-03-01,Florida,13459929,8273038,7947207,325831
2004-03-01,Georgia,6549133,4431236,4220519,210717
2004-03-01,Hawaii,936221,608704,587346,21358
2004-03-01,Idaho,1021205,695801,660870,34931
2004-03-01,Illinois,9544949,6329748,5930867,398881
2004-03-01,Indiana,4705775,3167017,2994955,172062
2004-03-01,Iowa,2259439,1603910,1533044,70866
2004-03-01,Kansas,2048199,1456522,1374489,82033
2004-03-01,Kentucky,3168939,1971631,1859288,112343
2004-03-01,Louisiana,3336134,2022748,1904059,118689
2004-03-01,Maine,1032983,685653,653529,32124
2004-03-01,Maryland,4191851,2879702,2747423,132279
2004-03-01,Massachusetts,5038294,3414103,3233044,181059
2004-03-01,Michigan,7694720,5039531,4699967,339564
2004-03-01,Minnesota,3882829,2894398,2758479,135919
2004-03-01,Mississippi,2130299,1313652,1237802,75850
2004-03-01,Missouri,4373001,2985981,2816387,169594
2004-03-01,Montana,715014,475728,453632,22096
2004-03-01,Nebraska,1312336,972345,934610,37735
2004-03-01,Nevada,1736796,1167541,1113440,54101
2004-03-01,Ohio,8773158,5841740,5481099,360641
2004-03-01,Oklahoma,2633657,1684796,1601607,83189
2004-03-01,Oregon,2772385,1846069,1705242,140827
2004-03-01,Pennsylvania,9634546,6193295,5856438,336857
2004-03-01,Tennessee,4524708,2906276,2756818,149458
2004-03-01,Texas,16239300,10941915,10264447,677468
2004-03-01,Utah,1717784,1220277,1156051,64226
2004-03-01,Vermont,490608,347863,334289,13574
2004-03-01,Virginia,5585695,3798909,3638949,159960
2004-03-01,Washington,4713701,3172374,2963181,209193
2004-03-01,Wisconsin,4235849,3039707,2883699,156008
2004-03-01,Wyoming,385078,274053,263295,10758
2004-04-01,Alabama,3437710,2140692,2016465,124227
2004-04-01,Alaska,468813,335671,310191,25480
2004-04-01,Arizona,4272474,2779124,2633732,145392
2004-04-01,Arkansas,2082594,1295055,1221231,73824
2004-04-01,California,26443652,17340053,16223005,1117048
2004-04-01,Colorado,3480753,2529027,2386328,142699
2004-04-01,Connecticut,2661640,1778337,1686019,92318
2004-04-01,Delaware,630222,420683,403023,17660
2004-04-01,Florida,13486273,8297196,7973417,323779
2004-04-01,Georgia,6559211,4436733,4221874,214859
2004-04-01,Hawaii,938135,609424,588582,20842
2004-04-01,Idaho,1022949,697000,662386,34614
2004-04-01,Illinois,9548361,6332906,5936524,396382
2004-04-01,Indiana,4707896,3164103,2993722,170381
2004-04-01,Iowa,2260263,1604462,1532911,71551
2004-04-01,Kansas,2048978,1457910,1376040,81870
2004-04-01,Kentucky,3170338,1972417,1860709,111708
2004-04-01,Louisiana,3337310,2024070,1905177,118893
2004-04-01,Maine,1033682,685146,653463,31683
2004-04-01,Maryland,4196057,2877711,2746027,131684
2004-04-01,Massachusetts,5039418,3411106,3232101,179005
2004-04-01,Michigan,7697912,5042439,4699668,342771
2004-04-01,Minnesota,3885547,2893583,2758465,135118
2004-04-01,Mississippi,2131602,1315051,1237981,77070
2004-04-01,Missouri,4376314,2989077,2816352,172725
2004-04-01,Montana,715828,476879,454943,21936
2004-04-01,Nebraska,1312946,972956,935234,37722
2004-04-01,Nevada,1742523,1170127,1116534,53593
2004-04-01,Ohio,8775765,5843709,5481800,361909
2004-04-01,Oklahoma,2634528,1685600,1603693,81907
2004-04-01,Oregon,2774282,1846876,1707383,139493
2004-04-01,Pennsylvania,9637810,6197231,5860184,337047
2004-04-01,Tennessee,4528589,2904703,2755839,148864
2004-04-01,Texas,16261719,10951500,10279305,672195
2004-04-01,Utah,1721363,1223417,1159431,63986
2004-04-01,Vermont,490939,347778,334426,13352
2004-04-01,Virginia,5594632,3801263,3641669,159594
2004-04-01,Washington,4720436,3177125,2970663,206462
2004-04-01,Wisconsin,4238868,3038689,2884436,154253
2004-04-01,Wyoming,385368,274101,263530,10571
2004-05-01,Alabama,3439685,2142378,2019286,123092
2004-05-01,Alaska,469843,336120,310799,25321
2004-05-01,Arizona,4283321,2782662,2639904,142758
2004-05-01,Arkansas,2084280,1297196,1223700,73496
2004-05-01,California,26467780,17351446,16245756,1105690
2004-05-01,Colorado,3483817,2533306,2391942,141364
2004-05-01,Connecticut,2662777,1777246,1685699,91547
2004-05-01,Delaware,631130,420645,402806,17839
2004-05-01,Florida,13513490,8318017,7997178,320839
2004-05-01,Georgia,6569512,4444641,4225018,219623
2004-05-01,Hawaii,940006,610172,589865,20307
2004-05-01,Idaho,1024783,698687,664281,34406
2004-05-01,Illinois,9552159,6336758,5943302,393456
2004-05-01,Indiana,4710339,3162596,2993555,169041
2004-05-01,Iowa,2261286,1605634,1533356,72278
2004-05-01,Kansas,2049973,1459262,1377763,81499
2004-05-01,Kentucky,3171919,1972864,1862183,110681
2004-05-01,Louisiana,3338628,2025407,1907175,118232
2004-05-01,Maine,1034531,684872,653504,31368
2004-05-01,Maryland,4200421,2877036,2745676,131360
2004-05-01,Massachusetts,5040822,3407545,3230748,176797
2004-05-01,Michigan,7701567,5045752,4699968,345784
2004-05-01,Minnesota,3888600,2892939,2758324,134615
2004-05-01,Mississippi,2132985,1316291,1237915,78376
2004-05-01,Missouri,4380004,2992854,2817116,175738
2004-05-01,Montana,716704,477899,456110,21789
2004-05-01,Nebraska,1313691,973713,936041,37672
2004-05-01,Nevada,1748307,1172939,1119945,52994
2004-05-01,Ohio,8778817,5845975,5483256,362719
2004-05-01,Oklahoma,2635506,1686500,1606078,80422
2004-05-01,Oregon,2776406,1847565,1709650,137915
2004-05-01,Pennsylvania,9641784,6201909,5865330,336579
2004-05-01,Tennessee,4532727,2902053,2752673,149380
2004-05-01,Texas,16284426,10962640,10297656,664984
2004-05-01,Utah,1725073,1226615,1163120,63495
2004-05-01,Vermont,491303,347714,334625,13089
2004-05-01,Virginia,5603790,3804208,3645645,158563
2004-05-01,Washington,4727430,3181517,2978056,203461
2004-05-01,Wisconsin,4242228,3038020,2885519,152501
2004-05-01,Wyoming,385715,274229,263790,10439
2004-06-01,Alabama,3441786,2143069,2021471,121598
2004-06-01,Alaska,470883,336707,311581,25126
2004-06-01,Arizona,4294298,2786277,2646350,139927
2004-06-01,Arkansas,2086030,1299548,1226676,72872
2004-06-01,California,26492860,17363109,16272306,1090803
2004-06-01,Colorado,3487031,2537859,2397607,140252
2004-06-01,Connecticut,2663930,1776345,1685705,90640
2004-06-01,Delaware,632012,420730,402703,18027
2004-06-01,Florida,13540882,8336128,8019091,317037
2004-06-01,Georgia,6579965,4454231,4229741,224490
2004-06-01,Hawaii,941951,611002,591160,19842
2004-06-01,Idaho,1026647,700708,666437,34271
2004-06-01,Illinois,9556128,6341581,5950845,390736
2004-06-01,Indiana,4712898,3161918,2993593,168325
2004-06-01,Iowa,2262389,1606835,1533841,72994
2004-06-01,Kansas,2050940,1460394,1379416,80978
2004-06-01,Kentucky,3173568,1972555,1863418,109137
2004-06-01,Louisiana,3340023,2026903,1909929,116974
2004-06-01,Maine,1035353,684887,653682,31205
2004-06-01,Maryland,4204763,2878179,2746789,131390
2004-06-01,Massachusetts,5042398,3403327,3228938,174389
2004-06-01,Michigan,7705357,5049747,4701330,348417
2004-06-01,Minnesota,3891730,2892661,2758493,134168
2004-06-01,Mississippi,2134430,1316915,1237209,79706
2004-06-01,Missouri,4383735,2996620,2818440,178180
2004-06-01,Montana,717613,478665,457011,21654
2004-06-01,Nebraska,1314476,974426,936811,37615
2004-06-01,Nevada,1754092,1175947,1123666,52281
2004-06-01,Ohio,8782026,5849182,5484934,364248
2004-06-01,Oklahoma,2636585,1687695,1608727,78968
2004-06-01,Oregon,2778594,1847646,1711208,136438
2004-06-01,Pennsylvania,9645900,6207464,5871779,335685
2004-06-01,Tennessee,4536945,2898638,2747836,150802
2004-06-01,Texas,16307728,10975531,10318766,656765
2004-06-01,Utah,1728855,1229847,1167114,62733
2004-06-01,Vermont,491680,347631,334829,12802
2004-06-01,Virginia,5613034,3807970,3650944,157026
2004-06-01,Washington,4734536,3185496,2985114,200382
2004-06-01,Wisconsin,4245720,3037358,2886459,150899
2004-06-01,Wyoming,386088,274429,264047,10382
2004-07-01,Alabama,3443779,2142414,2022549,119865
2004-07-01,Alaska,471914,337419,312484,24935
2004-07-01,Arizona,4305236,2790248,2652981,137267
2004-07-01,Arkansas,2087718,1302202,1229988,72214
2004-07-01,California,26517866,17376345,16301677,1074668
2004-07-01,Colorado,3490155,2542645,2402909,139736
2004-07-01,Connecticut,2665072,1775671,1685982,89689
2004-07-01,Delaware,632901,420927,402739,18188
2004-07-01,Florida,13568246,8353823,8040978,312845
2004-07-01,Georgia,6590261,4464814,4235369,229445
2004-07-01,Hawaii,943836,611924,592411,19513
2004-07-01,Idaho,1028503,702889,668697,34192
2004-07-01,Illinois,9559957,6347448,5958454,388994
2004-07-01,Indiana,4715326,3161766,2993388,168378
2004-07-01,Iowa,2263438,1607946,1534316,73630
2004-07-01,Kansas,2051917,1461071,1380689,80382
2004-07-01,Kentucky,3175141,1971264,1864071,107193
2004-07-01,Louisiana,3341331,2028909,1913454,115455
2004-07-01,Maine,1036156,685158,653951,31207
2004-07-01,Maryland,4209075,2880951,2749214,131737
2004-07-01,Massachusetts,5043821,3398885,3226927,171958
2004-07-01,Michigan,7708983,5055411,4703673,351738
2004-07-01,Minnesota,3894760,2893170,2759581,133589
2004-07-01,Mississippi,2135811,1316784,1235652,81132
2004-07-01,Missouri,4387385,2999666,2819812,179854
2004-07-01,Montana,718478,479201,457706,21495
2004-07-01,Nebraska,1315209,974888,937285,37603
2004-07-01,Nevada,1759901,1179137,1127564,51573
2004-07-01,Ohio,8785028,5853902,5487103,366799
2004-07-01,Oklahoma,2637604,1689415,1611650,77765
2004-07-01,Oregon,2780722,1847125,1711794,135331
2004-07-01,Pennsylvania,9649782,6213955,5879097,334858
2004-07-01,Tennessee,4541057,2895791,2742822,152969
2004-07-01,Texas,16331058,10991436,10341395,650041
2004-07-01,Utah,1732590,1233083,1171302,61781
2004-07-01,Vermont,492034,347484,334961,12523
2004-07-01,Virginia,5622191,3812653,3657321,155332
2004-07-01,Washington,4741529,3189546,2991920,197626
2004-07-01,Wisconsin,4249079,3036243,2886811,149432
2004-07-01,Wyoming,386429,274680,264294,10386
2004-08-01,Alabama,3446834,2140490,2022542,117948
2004-08-01,Alaska,472628,338166,313397,24769
2004-08-01,Arizona,4319535,2794295,2659587,134708
2004-08-01,Arkansas,2089956,1305072,1233356,71716
2004-08-01,California,26540808,17389930,16330923,1059007
2004-08-01,Colorado,3495242,2547078,2407412,139666
2004-08-01,Connecticut,2666291,1775120,1686356,88764
2004-08-01,Delaware,633994,421158,402827,18331
2004-08-01,Florida,13598789,8372814,8064221,308593
2004-08-01,Georgia,6604308,4475645,4241376,234269
2004-08-01,Hawaii,944472,612844,593528,19316
2004-08-01,Idaho,1030964,705141,671045,34096
2004-08-01,Illinois,9564987,6354195,5966219,387976
2004-08-01,Indiana,4718862,3161814,2992678,169136
2004-08-01,Iowa,2264596,1608630,1534570,74060
2004-08-01,Kansas,2053427,1461198,1381424,79774
2004-08-01,Kentucky,3178077,1969188,1863931,105257
2004-08-01,Louisiana,3342934,2031535,1917672,113863
2004-08-01,Maine,1036856,685539,654211,31328
2004-08-01,Maryland,4213352,2884556,2752351,132205
2004-08-01,Massachusetts,5045874,3394330,3224738,169592
2004-08-01,Michigan,7712018,5061889,4706244,355645
2004-08-01,Minnesota,3897847,2893925,2761403,132522
2004-08-01,Mississippi,2137314,1316021,1233477,82544
2004-08-01,Missouri,4391827,3001647,2820934,180713
2004-08-01,Montana,719343,479547,458244,21303
2004-08-01,Nebraska,1316060,974901,937248,37653
2004-08-01,Nevada,1765131,1182474,1131457,51017
2004-08-01,Ohio,8788758,5858754,5489638,369116
2004-08-01,Oklahoma,2639439,1691534,1614626,76908
2004-08-01,Oregon,2784563,1845970,1711747,134223
2004-08-01,Pennsylvania,9655149,6220769,5887051,333718
2004-08-01,Tennessee,4547265,2893404,2737780,155624
2004-08-01,Texas,16356646,11010492,10364409,646083
2004-08-01,Utah,1736464,1236257,1175539,60718
2004-08-01,Vermont,492352,347236,334965,12271
2004-08-01,Virginia,5629892,3817970,3664274,153696
2004-08-01,Washington,4748214,3194261,2998871,195390
2004-08-01,Wisconsin,4252495,3034311,2886205,148106
2004-08-01,Wyoming,386726,274947,264529,10418
2004-09-01,Alabama,3449856,2137912,2021961,115951
2004-09-01,Alaska,473333,338908,314260,24648
2004-09-01,Arizona,4333748,2797989,2665712,132277
2004-09-01,Arkansas,2092188,1308106,1236602,71504
2004-09-01,California,26563611,17401640,16356394,1045246
2004-09-01,Colorado,3500274,2550329,2410731,139598
2004-09-01,Connecticut,2667497,1774206,1686219,87987
2004-09-01,Delaware,635071,421318,402828,18490
2004-09-01,Florida,13629175,8393668,8089209,304459
2004-09-01,Georgia,6618221,4485994,4246915,239079
2004-09-01,Hawaii,945118,613770,594526,19244
2004-09-01,Idaho,1033418,707505,673611,33894
2004-09-01,Illinois,9569964,6361016,5973680,387336
2004-09-01,Indiana,4722340,3162109,2991472,170637
2004-09-01,Iowa,2265799,1608698,1534430,74268
2004-09-01,Kansas,2054915,1460850,1381552,79298
2004-09-01,Kentucky,3180947,1967219,1863350,103869
2004-09-01,Louisiana,3344535,2034732,1922049,112683
2004-09-01,Maine,1037513,685894,654352,31542
2004-09-01,Maryland,4217571,2888178,2755412,132766
2004-09-01,Massachusetts,5047836,3389536,3222035,167501
2004-09-01,Michigan,7714892,5067304,4707661,359643
2004-09-01,Minnesota,3900940,2893676,2762929,130747
2004-09-01,Mississippi,2138807,1315041,1231164,83877
2004-09-01,Missouri,4396196,3002704,2821759,180945
2004-09-01,Montana,720237,479803,458684,21119
2004-09-01,Nebraska,1316936,974455,936692,37763
2004-09-01,Nevada,1770335,1185922,1135183,50739
2004-09-01,Ohio,8792357,5861798,5491127,370671
2004-09-01,Oklahoma,2641207,1693664,1617221,76443
2004-09-01,Oregon,2788374,1844455,1711773,132682
2004-09-01,Pennsylvania,9660361,6226813,5895143,331670
2004-09-01,Tennessee,4553381,2890258,2731743,158515
2004-09-01,Texas,16382090,11031545,10386154,645391
2004-09-01,Utah,1740320,1239371,1179706,59665
2004-09-01,Vermont,492644,346887,334809,12078
2004-09-01,Virginia,5637496,3823527,3671229,152298
2004-09-01,Washington,4754811,3199823,3006002,193821
2004-09-01,Wisconsin,4255875,3031344,2884270,147074
2004-09-01,Wyoming,387024,275180,264746,10434
2004-10-01,Alabama,3452951,2135435,2021520,113915
2004-10-01,Alaska,474064,339619,315045,24574
2004-10-01,Arizona,4348147,2801087,2670776,130311
2004-10-01,Arkansas,2094464,1311214,1239659,71555
2004-10-01,California,26587015,17410849,16376888,1033961
2004-10-01,Colorado,3505410,2552184,2412847,139337
2004-10-01,Connecticut,2668743,1773072,1685602,87470
2004-10-01,Delaware,636204,421353,402703,18650
2004-10-01,Florida,13660059,8416258,8115866,300392
2004-10-01,Georgia,6632340,4495936,4251657,244279
2004-10-01,Hawaii,945789,614700,595481,19219
2004-10-01,Idaho,1035876,709974,676484,33490
2004-10-01,Illinois,9575124,6366944,5980251,386693
2004-10-01,Indiana,4725924,3162880,2990119,172761
2004-10-01,Iowa,2266982,1608704,1534379,74325
2004-10-01,Kansas,2056435,1460286,1381290,78996
2004-10-01,Kentucky,3183913,1966154,1862742,103412
2004-10-01,Louisiana,3346145,2037986,1925636,112350
2004-10-01,Maine,1038218,686180,654358,31822
2004-10-01,Maryland,4221895,2891348,2757770,133578
2004-10-01,Massachusetts,5049924,3384634,3218714,165920
2004-10-01,Michigan,7718019,5070143,4707409,362734
2004-10-01,Minnesota,3904112,2891183,2762767,128416
2004-10-01,Mississippi,2140328,1314472,1229171,85301
2004-10-01,Missouri,4400691,3003305,2822567,180738
2004-10-01,Montana,721107,480123,459133,20990
2004-10-01,Nebraska,1317804,973912,935937,37975
2004-10-01,Nevada,1775557,1189438,1138683,50755
2004-10-01,Ohio,8796157,5861874,5490021,371853
2004-10-01,Oklahoma,2643012,1695658,1619246,76412
2004-10-01,Oregon,2792241,1842831,1712380,130451
2004-10-01,Pennsylvania,9665811,6231696,5902258,329438
2004-10-01,Tennessee,4559601,2885829,2724645,161184
2004-10-01,Texas,16407952,11052652,10405657,646995
2004-10-01,Utah,1744191,1242536,1183774,58762
2004-10-01,Vermont,493024,346518,334548,11970
2004-10-01,Virginia,5645219,3829026,3677759,151267
2004-10-01,Washington,4761572,3205718,3012926,192792
2004-10-01,Wisconsin,4259357,3027357,2881043,146314
2004-10-01,Wyoming,387319,275357,264960,10397
2004-11-01,Alabama,3455389,2133332,2021719,111613
2004-11-01,Alaska,474732,340258,315753,24505
2004-11-01,Arizona,4361732,2804115,2675079,129036
2004-11-01,Arkansas,2096365,1314212,1242580,71632
2004-11-01,California,26606532,17417930,16394216,1023714
2004-11-01,Colorado,3510005,2553001,2414109,138892
2004-11-01,Connecticut,2669573,1772446,1685246,87200
2004-11-01,Delaware,637179,421408,402655,18753
2004-11-01,Florida,13688136,8440010,8143940,296070
2004-11-01,Georgia,6645274,4505826,4256148,249678
2004-11-01,Hawaii,946406,615625,596478,19147
2004-11-01,Idaho,1038176,712525,679697,32828
2004-11-01,Illinois,9578688,6371477,5986076,385401
2004-11-01,Indiana,4728736,3164300,2989333,174967
2004-11-01,Iowa,2267796,1609289,1535112,74177
2004-11-01,Kansas,2057633,1459668,1380894,78774
2004-11-01,Kentucky,3186350,1966299,1862347,103952
2004-11-01,Louisiana,3347153,2040782,1928071,112711
2004-11-01,Maine,1038776,686474,654333,32141
2004-11-01,Maryland,4225446,2893990,2759355,134635
2004-11-01,Massachusetts,5051159,3380049,3215202,164847
2004-11-01,Michigan,7719740,5070334,4706109,364225
2004-11-01,Minnesota,3906683,2886465,2760586,125879
2004-11-01,Mississippi,2141445,1314607,1227778,86829
2004-11-01,Missouri,4404412,3003914,2823628,180286
2004-11-01,Montana,721908,480537,459632,20905
2004-11-01,Nebraska,1318498,973503,935239,38264
2004-11-01,Nevada,1780588,1193034,1142139,50895
2004-11-01,Ohio,8798349,5859524,5487261,372263
2004-11-01,Oklahoma,2644429,1697444,1620792,76652
2004-11-01,Oregon,2795684,1841275,1713800,127475
2004-11-01,Pennsylvania,9669418,6235083,5907502,327581
2004-11-01,Tennessee,4565066,2880946,2717840,163106
2004-11-01,Texas,16431310,11071593,10423472,648121
2004-11-01,Utah,1747839,1245923,1187918,58005
2004-11-01,Vermont,493261,346241,334309,11932
2004-11-01,Virginia,5652057,3834654,3684017,150637
2004-11-01,Washington,4767571,3211380,3019465,191915
2004-11-01,Wisconsin,4262165,3022811,2877339,145472
2004-11-01,Wyoming,387592,275494,265208,10286
2004-12-01,Alabama,3457864,2132075,2023018,109057
2004-12-01,Alaska,475388,340858,316435,24423
2004-12-01,Arizona,4375260,2808145,2679413,128732
2004-12-01,Arkansas,2098297,1317182,1245566,71616
2004-12-01,California,26625485,17426935,16412579,1014356
2004-12-01,Colorado,3514580,2553668,2415136,138532
2004-12-01,Connecticut,2670352,1773105,1685851,87254
2004-12-01,Delaware,638163,421836,403030,18806
2004-12-01,Florida,13716053,8465429,8173938,291491
2004-12-01,Georgia,6658325,4516765,4261626,255139
2004-12-01,Hawaii,947015,616613,597609,19004
2004-12-01,Idaho,1040488,715232,683201,32031
2004-12-01,Illinois,9582205,6375784,5991999,383785
2004-12-01,Indiana,4731573,3167353,2990614,176739
2004-12-01,Iowa,2268621,1611006,1537097,73909
2004-12-01,Kansas,2058823,1459201,1380607,78594
2004-12-01,Kentucky,3188808,1968075,1862538,105537
2004-12-01,Louisiana,3348219,2043263,1929847,113416
2004-12-01,Maine,1039312,687027,654455,32572
2004-12-01,Maryland,4229035,2896823,2760926,135897
2004-12-01,Massachusetts,5052390,3377131,3212696,164435
2004-12-01,Michigan,7721554,5069863,4705231,364632
2004-12-01,Minnesota,3909235,2881623,2757665,123958
2004-12-01,Mississippi,2142612,1315639,1227296,88343
2004-12-01,Missouri,4408140,3005007,2825149,179858
2004-12-01,Montana,722675,481009,460157,20852
2004-12-01,Nebraska,1319186,973347,934740,38607
2004-12-01,Nevada,1785562,1196891,1145822,51069
2004-12-01,Ohio,8800590,5858060,5486004,372056
2004-12-01,Oklahoma,2645828,1699186,1622239,76947
2004-12-01,Oregon,2799092,1840401,1716027,124374
2004-12-01,Pennsylvania,9673014,6238050,5911684,326366
2004-12-01,Tennessee,4570542,2877576,2713075,164501
2004-12-01,Texas,16454361,11089089,10441184,647905
2004-12-01,Utah,1751435,1249798,1192371,57427
2004-12-01,Vermont,493498,346179,334240,11939
2004-12-01,Virginia,5658923,3841612,3690869,150743
2004-12-01,Washington,4773559,3217289,3026064,191225
2004-12-01,Wisconsin,4264967,3018970,2874349,144621
2004-12-01,Wyoming,387828,275664,265528,10136
2005-01-01,Alabama,3460380,2131703,2025399,106304
2005-01-01,Alaska,476092,341438,317165,24273
2005-01-01,Arizona,4388833,2813887,2684510,129377
2005-01-01,Arkansas,2100215,1320144,1248822,71322
2005-01-01,California,26644965,17439739,16435427,1004312
2005-01-01,Colorado,3519168,2554891,2416722,138169
2005-01-01,Connecticut,2671146,1775159,1687677,87482
2005-01-01,Delaware,639183,422854,404007,18847
2005-01-01,Florida,13744074,8492386,8206242,286144
2005-01-01,Georgia,6671455,4529287,4269353,259934
2005-01-01,Hawaii,947670,617673,598918,18755
2005-01-01,Idaho,1042808,718063,686859,31204
2005-01-01,Illinois,9585780,6380668,5998455,382213
2005-01-01,Indiana,4734369,3172050,2994570,177480
2005-01-01,Iowa,2269436,1613752,1540278,73474
2005-01-01,Kansas,2060008,1458973,1380627,78346
2005-01-01,Kentucky,3191213,1971250,1863475,107775
2005-01-01,Louisiana,3349336,2045557,1931637,113920
2005-01-01,Maine,1039810,687951,654877,33074
2005-01-01,Maryland,4232709,2900672,2763621,137051
2005-01-01,Massachusetts,5053578,3376327,3211964,164363
2005-01-01,Michigan,7723279,5069412,4705996,363416
2005-01-01,Minnesota,3911758,2878253,2755477,122776
2005-01-01,Mississippi,2143800,1317464,1227658,89806
2005-01-01,Missouri,4411851,3006569,2827349,179220
2005-01-01,Montana,723461,481501,460719,20782
2005-01-01,Nebraska,1319812,973373,934503,38870
2005-01-01,Nevada,1790521,1201124,1149962,51162
2005-01-01,Ohio,8802792,5859119,5488022,371097
2005-01-01,Oklahoma,2647195,1700922,1623958,76964
2005-01-01,Oregon,2802431,1840535,1719030,121505
2005-01-01,Pennsylvania,9676572,6241271,5916028,325243
2005-01-01,Tennessee,4576008,2876208,2710731,165477
2005-01-01,Texas,16477714,11104720,10460250,644470
2005-01-01,Utah,1755023,1254218,1197310,56908
2005-01-01,Vermont,493748,346365,334412,11953
2005-01-01,Virginia,5665801,3850656,3699201,151455
2005-01-01,Washington,4779499,3223554,3033132,190422
2005-01-01,Wisconsin,4267697,3016579,2872890,143689
2005-01-01,Wyoming,388071,275949,265961,9988
2005-02-01,Alabama,3462717,2131888,2028403,103485
2005-02-01,Alaska,476716,341972,317924,24048
2005-02-01,Arizona,4402003,2821319,2690651,130668
2005-02-01,Arkansas,2101950,1323041,1252355,70686
2005-02-01,California,26662446,17455416,16463071,992345
2005-02-01,Colorado,3523573,2556829,2419263,137566
2005-02-01,Connecticut,2671679,1778212,1690532,87680
2005-02-01,Delaware,640133,424441,405516,18925
2005-02-01,Florida,13770467,8519788,8240124,279664
2005-02-01,Georgia,6684496,4543128,4279783,263345
2005-02-01,Hawaii,948189,618846,600440,18406
2005-02-01,Idaho,1045018,720965,690455,30510
2005-02-01,Illinois,9588823,6385992,6004806,381186
2005-02-01,Indiana,4736904,3177325,3000375,176950
2005-02-01,Iowa,2269999,1616939,1544054,72885
2005-02-01,Kansas,2061041,1458867,1380967,77900
2005-02-01,Kentucky,3193509,1975095,1864921,110174
2005-02-01,Louisiana,3350321,2047645,1933747,113898
2005-02-01,Maine,1040231,689243,655688,33555
2005-02-01,Maryland,4236127,2905808,2768164,137644
2005-02-01,Massachusetts,5054419,3377030,3212794,164236
2005-02-01,Michigan,7724621,5069092,4708726,360366
2005-02-01,Minnesota,3914076,2876919,2754981,121938
2005-02-01,Mississippi,2144960,1319560,1228513,91047
2005-02-01,Missouri,4415325,3008233,2830213,178020
2005-02-01,Montana,724169,481942,461273,20669
2005-02-01,Nebraska,1320408,973423,934480,38943
2005-02-01,Nevada,1795391,1205680,1154565,51115
2005-02-01,Ohio,8804440,5861578,5493034,368544
2005-02-01,Oklahoma,2648385,1702422,1625949,76473
2005-02-01,Oregon,2805596,1841539,1722403,119136
2005-02-01,Pennsylvania,9679271,6244682,5921082,323600
2005-02-01,Tennessee,4581243,2876117,2710274,165843
2005-02-01,Texas,16500347,11116844,10480729,636115
2005-02-01,Utah,1758684,1259004,1202700,56304
2005-02-01,Vermont,493996,346736,334776,11960
2005-02-01,Virginia,5672429,3861571,3709239,152332
2005-02-01,Washington,4785133,3229985,3040798,189187
2005-02-01,Wisconsin,4270211,3015702,2872864,142838
2005-02-01,Wyoming,388301,276375,266495,9880
2005-03-01,Alabama,3465050,2132542,2032012,100530
2005-03-01,Alaska,477365,342453,318673,23780
2005-03-01,Arizona,4415083,2830147,2698108,132039
2005-03-01,Arkansas,2103753,1325810,1255998,69812
2005-03-01,California,26678872,17473771,16495869,977902
2005-03-01,Colorado,3527977,2559265,2422811,136454
2005-03-01,Connecticut,2672291,1781743,1694123,87620
2005-03-01,Delaware,641082,426475,407433,19042
2005-03-01,Florida,13796773,8548127,8276228,271899
2005-03-01,Georgia,6697423,4557632,4292843,264789
2005-03-01,Hawaii,948653,620188,602193,17995
2005-03-01,Idaho,1047271,723846,693803,30043
2005-03-01,Illinois,9591812,6391368,6011404,379964
2005-03-01,Indiana,4739527,3182356,3007192,175164
2005-03-01,Iowa,2270656,1620079,1547950,72129
2005-03-01,Kansas,2062079,1458695,1381581,77114
2005-03-01,Kentucky,3195814,1979166,1867008,112158
2005-03-01,Louisiana,3351321,2049886,1936392,113494
2005-03-01,Maine,1040705,690827,656915,33912
2005-03-01,Maryland,4239551,2912173,2774885,137288
2005-03-01,Massachusetts,5055380,3378721,3215059,163662
2005-03-01,Michigan,7726034,5069101,4713415,355686
2005-03-01,Minnesota,3916435,2877593,2756754,120839
2005-03-01,Mississippi,2146056,1321680,1229790,91890
2005-03-01,Missouri,4418842,3009365,2833780,175585
2005-03-01,Montana,724891,482380,461878,20502
2005-03-01,Nebraska,1320998,973356,934634,38722
2005-03-01,Nevada,1800253,1210546,1159620,50926
2005-03-01,Ohio,8806322,5864576,5500803,363773
2005-03-01,Oklahoma,2649591,1703928,1628305,75623
2005-03-01,Oregon,2808757,1843099,1725739,117360
2005-03-01,Pennsylvania,9682205,6248159,5927206,320953
2005-03-01,Tennessee,4586532,2877240,2712037,165203
2005-03-01,Texas,16522317,11125846,10502785,623061
2005-03-01,Utah,1762308,1264021,1208513,55508
2005-03-01,Vermont,494236,347219,335273,11946
2005-03-01,Virginia,5679045,3873810,3720949,152861
2005-03-01,Washington,4790818,3236835,3049422,187413
2005-03-01,Wisconsin,4272766,3016078,2873999,142079
2005-03-01,Wyoming,388553,276936,267105,9831
2005-04-01,Alabama,3467687,2133797,2036225,97572
2005-04-01,Alaska,478096,342940,319427,23513
2005-04-01,Arizona,4428692,2840229,2707135,133094
2005-04-01,Arkansas,2105716,1328586,1259507,69079
2005-04-01,California,26698527,17496205,16533791,962414
2005-04-01,Colorado,3532733,2562139,2427282,134857
2005-04-01,Connecticut,2673108,1785633,1698358,87275
2005-04-01,Delaware,642098,428767,409590,19177
2005-04-01,Florida,13824542,8579298,8316002,263296
2005-04-01,Georgia,6710913,4572349,4307651,264698
2005-04-01,Hawaii,949295,621790,604188,17602
2005-04-01,Idaho,1049612,726623,696833,29790
2005-04-01,Illinois,9595765,6397182,6019020,378162
2005-04-01,Indiana,4742556,3187599,3014773,172826
2005-04-01,Iowa,2271492,1623189,1551978,71211
2005-04-01,Kansas,2063305,1458396,1382409,75987
2005-04-01,Kentucky,3198405,1983363,1869854,113509
2005-04-01,Louisiana,3352612,2052828,1939964,112864
2005-04-01,Maine,1041236,692602,658492,34110
2005-04-01,Maryland,4243365,2919397,2783419,135978
2005-04-01,Massachusetts,5056753,3381335,3218651,162684
2005-04-01,Michigan,7728136,5069995,4719678,350317
2005-04-01,Minnesota,3919150,2879816,2760555,119261
2005-04-01,Mississippi,2147354,1324117,1231424,92693
2005-04-01,Missouri,4422729,3009723,2838010,171713
2005-04-01,Montana,725667,482966,462673,20293
2005-04-01,Nebraska,1321677,973129,934935,38194
2005-04-01,Nevada,1805236,1215779,1165081,50698
2005-04-01,Ohio,8808940,5868991,5511573,357418
2005-04-01,Oklahoma,2651053,1705764,1630999,74765
2005-04-01,Oregon,2812208,1845150,1729019,116131
2005-04-01,Pennsylvania,9685990,6252160,5934802,317358
2005-04-01,Tennessee,4592237,2880139,2716883,163256
2005-04-01,Texas,16546090,11134783,10525682,609101
2005-04-01,Utah,1766020,1269262,1214708,54554
2005-04-01,Vermont,494509,347780,335872,11908
2005-04-01,Virginia,5686120,3887264,3734204,153060
2005-04-01,Washington,4796941,3244311,3058875,185436
2005-04-01,Wisconsin,4275662,3017984,2876475,141509
2005-04-01,Wyoming,388789,277618,267780,9838
2005-05-01,Alabama,3470456,2135881,2040891,94990
2005-05-01,Alaska,478798,343476,320167,23309
2005-05-01,Arizona,4442405,2850925,2717283,133642
2005-05-01,Arkansas,2107819,1331576,1262763,68813
2005-05-01,California,26718033,17522524,16574980,947544
2005-05-01,Colorado,3537599,2565371,2432503,132868
2005-05-01,Connecticut,2674080,1789854,1703125,86729
2005-05-01,Delaware,643156,431083,411764,19319
2005-05-01,Florida,13853110,8613694,8359329,254365
2005-05-01,Georgia,6724569,4586838,4322968,263870
2005-05-01,Hawaii,949852,623721,606410,17311
2005-05-01,Idaho,1052070,729260,699591,29669
2005-05-01,Illinois,9599964,6403350,6028017,375333
2005-05-01,Indiana,4745870,3193454,3022717,170737
2005-05-01,Iowa,2272565,1626381,1556181,70200
2005-05-01,Kansas,2064686,1458126,1383469,74657
2005-05-01,Kentucky,3201197,1987665,1873238,114427
2005-05-01,Louisiana,3353983,2055560,1943455,112105
2005-05-01,Maine,1041902,694480,660287,34193
2005-05-01,Maryland,4247232,2926886,2792868,134018
2005-05-01,Massachusetts,5058419,3384497,3222946,161551
2005-05-01,Michigan,7730645,5071335,4726752,344583
2005-05-01,Minnesota,3922141,2882721,2765257,117464
2005-05-01,Mississippi,2148711,1326831,1233270,93561
2005-05-01,Missouri,4426897,3009592,2842877,166715
2005-05-01,Montana,726519,483804,463742,20062
2005-05-01,Nebraska,1322532,972854,935419,37435
2005-05-01,Nevada,1810303,1221363,1170797,50566
2005-05-01,Ohio,8812021,5874671,5524226,350445
2005-05-01,Oklahoma,2652663,1707881,1633746,74135
2005-05-01,Oregon,2815829,1847512,1732227,115285
2005-05-01,Pennsylvania,9690477,6256609,5943384,313225
2005-05-01,Tennessee,4598137,2885126,2724760,160366
2005-05-01,Texas,16570063,11147039,10548719,598320
2005-05-01,Utah,1769922,1274652,1221155,53497
2005-05-01,Vermont,494820,348442,336553,11889
2005-05-01,Virginia,5693461,3901019,3748057,152962
2005-05-01,Washington,4803272,3252288,3068571,183717
2005-05-01,Wisconsin,4278932,3021665,2880445,141220
2005-05-01,Wyoming,389093,278399,268517,9882
2005-06-01,Alabama,3473470,2138558,2045463,93095
2005-06-01,Alaska,479556,344040,320787,23253
2005-06-01,Arizona,4456434,2861177,2727304,133873
2005-06-01,Arkansas,2110026,1334725,1265578,69147
2005-06-01,California,26739187,17548901,16613194,935707
2005-06-01,Colorado,3542670,2568581,2437884,130697
2005-06-01,Connecticut,2675160,1793985,1707802,86183
2005-06-01,Delaware,644233,433225,413740,19485
2005-06-01,Florida,13882354,8648158,8402146,246012
2005-06-01,Georgia,6738611,4600177,4337087,263090
2005-06-01,Hawaii,950463,625770,608578,17192
2005-06-01,Idaho,1054536,731642,702030,29612
2005-06-01,Illinois,9604737,6409402,6038327,371075
2005-06-01,Indiana,4749491,3199884,3030220,169664
2005-06-01,Iowa,2273770,1629285,1560026,69259
2005-06-01,Kansas,2066217,1458034,1384566,73468
2005-06-01,Kentucky,3204189,1991854,1876503,115351
2005-06-01,Louisiana,3355571,2056231,1944466,111765
2005-06-01,Maine,1042612,696234,661982,34252
2005-06-01,Maryland,4251294,2933604,2801630,131974
2005-06-01,Massachusetts,5060407,3387355,3226660,160695
2005-06-01,Michigan,7733585,5072040,4732938,339102
2005-06-01,Minnesota,3925387,2884875,2768925,115950
2005-06-01,Mississippi,2150204,1329527,1234991,94536
2005-06-01,Missouri,4431358,3009473,2847827,161646
2005-06-01,Montana,727426,484873,465024,19849
2005-06-01,Nebraska,1323452,972611,935960,36651
2005-06-01,Nevada,1815436,1227044,1176365,50679
2005-06-01,Ohio,8815566,5880174,5536130,344044
2005-06-01,Oklahoma,2654453,1710037,1636192,73845
2005-06-01,Oregon,2819622,1849614,1735012,114602
2005-06-01,Pennsylvania,9695414,6260739,5951255,309484
2005-06-01,Tennessee,4604267,2891389,2733867,157522
2005-06-01,Texas,16595241,11163389,10569961,593428
2005-06-01,Utah,1774015,1279876,1227458,52418
2005-06-01,Vermont,495183,349161,337233,11928
2005-06-01,Virginia,5701112,3913106,3760577,152529
2005-06-01,Washington,4809877,3260163,3077493,182670
2005-06-01,Wisconsin,4282435,3026367,2884933,141434
2005-06-01,Wyoming,389407,279173,269233,9940
2005-07-01,Alabama,3476528,2141446,2049425,92021
2005-07-01,Alaska,480302,344616,321214,23402
2005-07-01,Arizona,4470636,2870449,2736262,134187
2005-07-01,Arkansas,2112310,1337609,1267612,69997
2005-07-01,California,26761285,17571326,16642343,928983
2005-07-01,Colorado,3547868,2571894,2443117,128777
2005-07-01,Connecticut,2676356,1797541,1711644,85897
2005-07-01,Delaware,645335,435162,415453,19709
2005-07-01,Florida,13912144,8679055,8440004,239051
2005-07-01,Georgia,6752872,4611806,4348844,262962
2005-07-01,Hawaii,951120,627667,610383,17284
2005-07-01,Idaho,1057079,733547,704126,29421
2005-07-01,Illinois,9609780,6415103,6048748,366355
2005-07-01,Indiana,4753203,3206552,3036250,170302
2005-07-01,Iowa,2275021,1631666,1562922,68744
2005-07-01,Kansas,2067785,1458268,1385522,72746
2005-07-01,Kentucky,3207234,1995787,1878884,116903
2005-07-01,Louisiana,3357249,2053798,1941390,112408
2005-07-01,Maine,1043312,697669,663284,34385
2005-07-01,Maryland,4255488,2938910,2808520,130390
2005-07-01,Massachusetts,5062501,3389380,3228732,160648
2005-07-01,Michigan,7736738,5071751,4736805,334946
2005-07-01,Minnesota,3928695,2885243,2769965,115278
2005-07-01,Mississippi,2151754,1331761,1236213,95548
2005-07-01,Missouri,4435880,3009855,2852209,157646
2005-07-01,Montana,728315,486068,466344,19724
2005-07-01,Nebraska,1324378,972543,936425,36118
2005-07-01,Nevada,1820663,1232503,1181486,51017
2005-07-01,Ohio,8819325,5885049,5544880,340169
2005-07-01,Oklahoma,2656290,1712048,1638056,73992
2005-07-01,Oregon,2823483,1851120,1737093,114027
2005-07-01,Pennsylvania,9700613,6263784,5956351,307433
2005-07-01,Tennessee,4610566,2897898,2742168,155730
2005-07-01,Texas,16621056,11181941,10586526,595415
2005-07-01,Utah,1778097,1284707,1233299,51408
2005-07-01,Vermont,495527,349868,337831,12037
2005-07-01,Virginia,5708868,3922403,3770468,151935
2005-07-01,Washington,4816608,3267255,3084845,182410
2005-07-01,Wisconsin,4286049,3031393,2888786,142607
2005-07-01,Wyoming,389729,279863,269845,10018
2005-08-01,Alabama,3480482,2144070,2052511,91559
2005-08-01,Alaska,481163,345128,321428,23700
2005-08-01,Arizona,4484551,2878393,2743723,134670
2005-08-01,Arkansas,2114958,1339765,1268919,70846
2005-08-01,California,26779322,17586567,16660840,925727
2005-08-01,Colorado,3554004,2575669,2448234,127435
2005-08-01,Connecticut,2677768,1800444,1714626,85818
2005-08-01,Delaware,646369,436916,416994,19922
2005-08-01,Florida,13934021,8704254,8470906,233348
2005-08-01,Georgia,6766443,4621335,4358286,263049
2005-08-01,Hawaii,951794,629176,611695,17481
2005-08-01,Idaho,1059593,734841,705881,28960
2005-08-01,Illinois,9614723,6419959,6057981,361978
2005-08-01,Indiana,4756761,3212832,3040900,171932
2005-08-01,Iowa,2276379,1633524,1564894,68630
2005-08-01,Kansas,2068690,1458670,1386265,72405
2005-08-01,Kentucky,3210624,1999069,1880045,119024
2005-08-01,Louisiana,3361183,2048166,1934284,113882
2005-08-01,Maine,1043947,698645,664096,34549
2005-08-01,Maryland,4258621,2942753,2813495,129258
2005-08-01,Massachusetts,5064723,3390341,3229086,161255
2005-08-01,Michigan,7738967,5070878,4738218,332660
2005-08-01,Minnesota,3932287,2884095,2768586,115509
2005-08-01,Mississippi,2155428,1332744,1236730,96014
2005-08-01,Missouri,4440311,3010684,2855649,155035
2005-08-01,Montana,729287,487195,467581,19614
2005-08-01,Nebraska,1325114,972541,936709,35832
2005-08-01,Nevada,1826077,1237385,1186098,51287
2005-08-01,Ohio,8822454,5889390,5550220,339170
2005-08-01,Oklahoma,2659280,1713560,1639307,74253
2005-08-01,Oregon,2828040,1852083,1738689,113394
2005-08-01,Pennsylvania,9706213,6265158,5957806,307352
2005-08-01,Tennessee,4617670,2904849,2749511,155338
2005-08-01,Texas,16656333,11198913,10597585,601328
2005-08-01,Utah,1782993,1288990,1238581,50409
2005-08-01,Vermont,495840,350538,338360,12178
2005-08-01,Virginia,5715542,3928582,3777612,150970
2005-08-01,Washington,4825124,3272992,3090829,182163
2005-08-01,Wisconsin,4289172,3036040,2891742,144298
2005-08-01,Wyoming,390245,280397,270322,10075
2005-09-01,Alabama,3484482,2146009,2054667,91342
2005-09-01,Alaska,482067,345532,321504,24028
2005-09-01,Arizona,4498643,2885335,2750192,135143
2005-09-01,Arkansas,2122332,1341047,1269841,71206
2005-09-01,California,26798546,17593070,16670184,922886
2005-09-01,Colorado,3560313,2580186,2453632,126554
2005-09-01,Connecticut,2679281,1803280,1717539,85741
2005-09-01,Delaware,647424,438472,418445,20027
2005-09-01,Florida,13956379,8723602,8495124,228478
2005-09-01,Georgia,6780106,4628993,4366401,262592
2005-09-01,Hawaii,952539,630132,612523,17609
2005-09-01,Idaho,1062135,735658,707285,28373
2005-09-01,Illinois,9619947,6424089,6066490,357599
2005-09-01,Indiana,4760357,3218431,3045291,173140
2005-09-01,Iowa,2277783,1635007,1566429,68578
2005-09-01,Kansas,2069677,1458875,1386742,72133
2005-09-01,Kentucky,3214075,2001269,1880085,121184
2005-09-01,Louisiana,3162488,2173136,1924844,248292
2005-09-01,Maine,1044621,699076,664456,34620
2005-09-01,Maryland,4261842,2945531,2817311,128220
2005-09-01,Massachusetts,5067045,3390494,3228461,162033
2005-09-01,Michigan,7741284,5070043,4737551,332492
2005-09-01,Minnesota,3935944,2882897,2766312,116585
2005-09-01,Mississippi,2159130,1316504,1187304,129200
2005-09-01,Missouri,4444835,3011492,2857909,153583
2005-09-01,Montana,730293,488098,468695,19403
2005-09-01,Nebraska,1325871,972334,936752,35582
2005-09-01,Nevada,1831478,1241575,1190337,51238
2005-09-01,Ohio,8825781,5893220,5553817,339403
2005-09-01,Oklahoma,2667366,1714235,1640181,74054
2005-09-01,Oregon,2832682,1852864,1740376,112488
2005-09-01,Pennsylvania,9711995,6264639,5956334,308305
2005-09-01,Tennessee,4624873,2912507,2756425,156082
2005-09-01,Texas,16739709,11211963,10604917,607046
2005-09-01,Utah,1787954,1292779,1243398,49381
2005-09-01,Vermont,496157,351183,338880,12303
2005-09-01,Virginia,5722306,3932245,3782825,149420
2005-09-01,Washington,4833784,3277523,3096373,181150
2005-09-01,Wisconsin,4292397,3039521,2893934,145587
2005-09-01,Wyoming,390750,280752,270691,10061
2005-10-01,Alabama,3491829,2147374,2056388,90986
2005-10-01,Alaska,483268,345831,321576,24255
2005-10-01,Arizona,4518189,2892105,2757019,135086
2005-10-01,Arkansas,2122332,1341579,1270710,70869
2005-10-01,California,26862414,17592258,16675256,917002
2005-10-01,Colorado,3570629,2585429,2460026,125403
2005-10-01,Connecticut,2683889,1806325,1720905,85420
2005-10-01,Delaware,649203,439827,419873,19954
2005-10-01,Florida,13997572,8739398,8515544,223854
2005-10-01,Georgia,6801551,4635374,4374745,260629
2005-10-01,Hawaii,954631,630555,612996,17559
2005-10-01,Idaho,1065643,736264,708439,27825
2005-10-01,Illinois,9636489,6428364,6076025,352339
2005-10-01,Indiana,4768332,3223149,3050395,172754
2005-10-01,Iowa,2281089,1636188,1568012,68176
2005-10-01,Kansas,2072575,1458597,1386985,71612
2005-10-01,Kentucky,3219936,2002716,1879980,122736
2005-10-01,Louisiana,3162488,2163281,1915795,247486
2005-10-01,Maine,1046097,699035,664565,34470
2005-10-01,Maryland,4270149,2947984,2821340,126644
2005-10-01,Massachusetts,5074742,3390374,3227977,162397
2005-10-01,Michigan,7751012,5069227,4735206,334021
2005-10-01,Minnesota,3943026,2882961,2764955,118006
2005-10-01,Mississippi,2123380,1303895,1186924,116971
2005-10-01,Missouri,4453081,3012033,2859392,152641
2005-10-01,Montana,731782,488697,469654,19043
2005-10-01,Nebraska,1327891,971736,936622,35114
2005-10-01,Nevada,1839147,1245346,1194538,50808
2005-10-01,Ohio,8836887,5896020,5557780,338240
2005-10-01,Oklahoma,2667366,1714020,1640951,73069
2005-10-01,Oregon,2839870,1853654,1742628,111026
2005-10-01,Pennsylvania,9727342,6262659,5954723,307936
2005-10-01,Tennessee,4636094,2920508,2763210,157298
2005-10-01,Texas,16739709,11221201,10612285,608916
2005-10-01,Utah,1794442,1296320,1248068,48252
2005-10-01,Vermont,496958,351830,339450,12380
2005-10-01,Virginia,5735305,3934813,3787789,147024
2005-10-01,Washington,4846818,3281368,3102575,178793
2005-10-01,Wisconsin,4299451,3041767,2895781,145986
2005-10-01,Wyoming,391594,280982,271027,9955
2005-11-01,Alabama,3495703,2148494,2058020,90474
2005-11-01,Alaska,484146,346027,321695,24332
2005-11-01,Arizona,4532715,2899289,2765037,134252
2005-11-01,Arkansas,2124968,1341840,1271732,70108
2005-11-01,California,26886799,17588199,16680410,907789
2005-11-01,Colorado,3577167,2591508,2467857,123651
2005-11-01,Connecticut,2685408,1809526,1724701,84825
2005-11-01,Delaware,650249,440907,421211,19696
2005-11-01,Florida,14020653,8754532,8534968,219564
2005-11-01,Georgia,6815405,4641476,4384358,257118
2005-11-01,Hawaii,955583,630663,613292,17371
2005-11-01,Idaho,1068173,736969,709484,27485
2005-11-01,Illinois,9642026,6433630,6087174,346456
2005-11-01,Indiana,4771850,3226653,3056076,170577
2005-11-01,Iowa,2282350,1637386,1570143,67243
2005-11-01,Kansas,2073513,1457882,1387093,70789
2005-11-01,Kentucky,3223221,2003954,1880622,123332
2005-11-01,Louisiana,3163098,2153374,1909121,244253
2005-11-01,Maine,1046684,698711,664644,34067
2005-11-01,Maryland,4273424,2950992,2826553,124439
2005-11-01,Massachusetts,5077035,3390390,3228125,162265
2005-11-01,Michigan,7753142,5068822,4731389,337433
2005-11-01,Minnesota,3946572,2884450,2765204,119246
2005-11-01,Mississippi,2123831,1297935,1186645,111290
2005-11-01,Missouri,4457379,3012555,2860770,151785
2005-11-01,Montana,732721,489065,470489,18576
2005-11-01,Nebraska,1328595,970846,936489,34357
2005-11-01,Nevada,1844820,1249182,1198920,50262
2005-11-01,Ohio,8839733,5897939,5562941,334998
2005-11-01,Oklahoma,2670374,1713063,1641639,71424
2005-11-01,Oregon,2844462,1854667,1745572,109095
2005-11-01,Pennsylvania,9732648,6260944,5955415,305529
2005-11-01,Tennessee,4643173,2928930,2770270,158660
2005-11-01,Texas,16746390,11227907,10621632,606275
2005-11-01,Utah,1799404,1299869,1252829,47040
2005-11-01,Vermont,497275,352432,340020,12412
2005-11-01,Virginia,5742125,3937586,3793610,143976
2005-11-01,Washington,4855511,3285007,3109758,175249
2005-11-01,Wisconsin,4302495,3043147,2897652,145495
2005-11-01,Wyoming,392128,281156,271399,9757
2005-12-01,Alabama,3499904,2149633,2059843,89790
2005-12-01,Alaska,485094,346169,321902,24267
2005-12-01,Arizona,4547225,2907204,2774501,132703
2005-12-01,Arkansas,2127798,1342120,1272820,69300
2005-12-01,California,26910607,17583772,16687569,896203
2005-12-01,Colorado,3583738,2598074,2476752,121322
2005-12-01,Connecticut,2687028,1812780,1728795,83985
2005-12-01,Delaware,651324,441628,422333,19295
2005-12-01,Florida,14044122,8770521,8554725,215796
2005-12-01,Georgia,6829755,4647812,4395233,252579
2005-12-01,Hawaii,956608,630664,613526,17138
2005-12-01,Idaho,1070764,737865,710506,27359
2005-12-01,Illinois,9648009,6439468,6099998,339470
2005-12-01,Indiana,4775674,3228693,3061470,167223
2005-12-01,Iowa,2283791,1639110,1573366,65744
2005-12-01,Kansas,2074556,1456928,1387302,69626
2005-12-01,Kentucky,3226778,2005232,1882447,122785
2005-12-01,Louisiana,3164830,2035834,1905605,130229
2005-12-01,Maine,1047375,698259,664823,33436
2005-12-01,Maryland,4277029,2954859,2832771,122088
2005-12-01,Massachusetts,5079565,3390351,3228651,161700
2005-12-01,Michigan,7755832,5068366,4726467,341899
2005-12-01,Minnesota,3950331,2885850,2766158,119692
2005-12-01,Mississippi,2125280,1283148,1186761,96387
2005-12-01,Missouri,4462051,3013355,2862756,150599
2005-12-01,Montana,733738,489365,471289,18076
2005-12-01,Nebraska,1329407,969870,936544,33326
2005-12-01,Nevada,1850497,1253457,1203581,49876
2005-12-01,Ohio,8843248,5898850,5568986,329864
2005-12-01,Oklahoma,2673539,1711566,1642007,69559
2005-12-01,Oregon,2849175,1856074,1749282,106792
2005-12-01,Pennsylvania,9738584,6260644,5958684,301960
2005-12-01,Tennessee,4650602,2937905,2778144,159761
2005-12-01,Texas,16761096,11233098,10633045,600053
2005-12-01,Utah,1804466,1303593,1257816,45777
2005-12-01,Vermont,497626,352929,340528,12401
2005-12-01,Virginia,5749362,3940662,3800223,140439
2005-12-01,Washington,4864388,3288548,3117441,171107
2005-12-01,Wisconsin,4305860,3043904,2899804,144100
2005-12-01,Wyoming,392682,281322,271850,9472
2006-01-01,Alabama,3503666,2151174,2062219,88955
2006-01-01,Alaska,485968,346388,322315,24073
2006-01-01,Arizona,4561185,2916314,2785456,130858
2006-01-01,Arkansas,2130322,1342700,1273915,68785
2006-01-01,California,26930839,17582550,16698861,883689
2006-01-01,Colorado,3589857,2605057,2486296,118761
2006-01-01,Connecticut,2688340,1816063,1733100,82963
2006-01-01,Delaware,652379,442004,423215,18789
2006-01-01,Florida,14065590,8789465,8576664,212801
2006-01-01,Georgia,6843197,4654813,4406965,247848
2006-01-01,Hawaii,957451,630827,613850,16977
2006-01-01,Idaho,1073261,738902,711591,27311
2006-01-01,Illinois,9652716,6446086,6115270,330816
2006-01-01,Indiana,4778850,3230070,3066477,163593
2006-01-01,Iowa,2284916,1641849,1578060,63789
2006-01-01,Kansas,2075320,1455936,1387766,68170
2006-01-01,Kentucky,3229869,2006831,1885679,121152
2006-01-01,Louisiana,3166964,2003932,1905404,98528
2006-01-01,Maine,1047909,697917,665201,32716
2006-01-01,Maryland,4280040,2959519,2839370,120149
2006-01-01,Massachusetts,5081434,3390788,3229944,160844
2006-01-01,Michigan,7757479,5067923,4722032,345891
2006-01-01,Minnesota,3953580,2886377,2767467,118910
2006-01-01,Mississippi,2127247,1275110,1187661,87449
2006-01-01,Missouri,4466089,3014631,2865710,148921
2006-01-01,Montana,734619,489832,472225,17607
2006-01-01,Nebraska,1330057,969001,936904,32097
2006-01-01,Nevada,1855912,1258441,1208656,49785
2006-01-01,Ohio,8845558,5900385,5577335,323050
2006-01-01,Oklahoma,2676326,1710025,1642205,67820
2006-01-01,Oregon,2853540,1858333,1753954,104379
2006-01-01,Pennsylvania,9743262,6262494,5964453,298041
2006-01-01,Tennessee,4657345,2948616,2788197,160419
2006-01-01,Texas,16781676,11240453,10647444,593009
2006-01-01,Utah,1809287,1307644,1263185,44459
2006-01-01,Vermont,497880,353344,340982,12362
2006-01-01,Virginia,5755845,3944531,3807796,136735
2006-01-01,Washington,4872643,3292718,3125422,167296
2006-01-01,Wisconsin,4308593,3044830,2902831,141999
2006-01-01,Wyoming,393128,281549,272423,9126
2006-02-01,Alabama,3507068,2153411,2065225,88186
2006-02-01,Alaska,486740,346742,322936,23806
2006-02-01,Arizona,4574548,2926379,2796970,129409
2006-02-01,Arkansas,2132647,1343722,1274911,68811
2006-02-01,California,26947217,17587038,16714377,872661
2006-02-01,Colorado,3595664,2612418,2495895,116523
2006-02-01,Connecticut,2689362,1819226,1737275,81951
2006-02-01,Delaware,653305,442164,423908,18256
2006-02-01,Florida,14085252,8812184,8601209,210975
2006-02-01,Georgia,6856084,4662900,4418947,243953
2006-02-01,Hawaii,958135,631267,614296,16971
2006-02-01,Idaho,1075601,739890,712681,27209
2006-02-01,Illinois,9656519,6453903,6133097,320806
2006-02-01,Indiana,4781693,3231598,3070849,160749
2006-02-01,Iowa,2285822,1645442,1583664,61778
2006-02-01,Kansas,2075909,1455091,1388411,66680
2006-02-01,Kentucky,3232798,2008797,1889872,118925
2006-02-01,Louisiana,3169757,1998960,1907657,91303
2006-02-01,Maine,1048355,697805,665670,32135
2006-02-01,Maryland,4282638,2964849,2845544,119305
2006-02-01,Massachusetts,5082903,3392290,3232254,160036
2006-02-01,Michigan,7758526,5067483,4718738,348745
2006-02-01,Minnesota,3956568,2886107,2768846,117261
2006-02-01,Mississippi,2129927,1272806,1189293,83513
2006-02-01,Missouri,4469775,3016412,2869483,146929
2006-02-01,Montana,735491,490715,473484,17231
2006-02-01,Nebraska,1330588,968388,937521,30867
2006-02-01,Nevada,1861136,1264123,1214044,50079
2006-02-01,Ohio,8847270,5904768,5588283,316485
2006-02-01,Oklahoma,2678907,1708921,1642490,66431
2006-02-01,Oregon,2857633,1861625,1759373,102252
2006-02-01,Pennsylvania,9747075,6267038,5972062,294976
2006-02-01,Tennessee,4663797,2961842,2800802,161040
2006-02-01,Texas,16808414,11253367,10664814,588553
2006-02-01,Utah,1814025,1311981,1268854,43127
2006-02-01,Vermont,498164,353706,341368,12338
2006-02-01,Virginia,5761823,3949380,3815798,133582
2006-02-01,Washington,4880489,3297951,3133200,164751
2006-02-01,Wisconsin,4311099,3046724,2906854,139870
2006-02-01,Wyoming,393646,281877,273094,8783
2006-03-01,Alabama,3510348,2156335,2068505,87830
2006-03-01,Alaska,487558,347278,323717,23561
2006-03-01,Arizona,4587109,2937047,2808195,128852
2006-03-01,Arkansas,2134861,1345046,1275609,69437
2006-03-01,California,26956842,17596774,16730993,865781
2006-03-01,Colorado,3601065,2620070,2504897,115173
2006-03-01,Connecticut,2690127,1822224,1741020,81204
2006-03-01,Delaware,654229,442256,424429,17827
2006-03-01,Florida,14102496,8837309,8626543,210766
2006-03-01,Georgia,6868440,4672236,4430502,241734
2006-03-01,Hawaii,958572,631983,614874,17109
2006-03-01,Idaho,1077916,740751,713742,27009
2006-03-01,Illinois,9659302,6463382,6152425,310957
2006-03-01,Indiana,4784419,3233382,3073794,159588
2006-03-01,Iowa,2286724,1649127,1588911,60216
2006-03-01,Kansas,2076427,1454601,1389076,65525
2006-03-01,Kentucky,3235660,2011065,1894196,116869
2006-03-01,Louisiana,3174981,1995431,1910602,84829
2006-03-01,Maine,1048785,697986,666098,31888
2006-03-01,Maryland,4284856,2970542,2850446,120096
2006-03-01,Massachusetts,5084043,3394962,3235249,159713
2006-03-01,Michigan,7759212,5066385,4715647,350738
2006-03-01,Minnesota,3959476,2885094,2769722,115372
2006-03-01,Mississippi,2134966,1271087,1191197,79890
2006-03-01,Missouri,4473367,3019077,2873689,145388
2006-03-01,Montana,736318,492075,475078,16997
2006-03-01,Nebraska,1331045,968167,938255,29912
2006-03-01,Nevada,1866056,1270318,1219558,50760
2006-03-01,Ohio,8848684,5912662,5599950,312712
2006-03-01,Oklahoma,2681324,1708593,1642958,65635
2006-03-01,Oregon,2861501,1865808,1765028,100780
2006-03-01,Pennsylvania,9750419,6273630,5979608,294022
2006-03-01,Tennessee,4670063,2976996,2814715,162281
2006-03-01,Texas,16856023,11272128,10683983,588145
2006-03-01,Utah,1818717,1316509,1274637,41872
2006-03-01,Vermont,498398,354035,341639,12396
2006-03-01,Virginia,5767386,3954870,3823250,131620
2006-03-01,Washington,4888004,3304104,3140073,164031
2006-03-01,Wisconsin,4313453,3049844,2911405,138439
2006-03-01,Wyoming,394067,282331,273809,8522
2006-04-01,Alabama,3513803,2159713,2071802,87911
2006-04-01,Alaska,488418,347940,324533,23407
2006-04-01,Arizona,4599748,2947857,2818660,129197
2006-04-01,Arkansas,2137212,1346255,1275834,70421
2006-04-01,California,26966975,17609415,16745349,864066
2006-04-01,Colorado,3606595,2627673,2512768,114905
2006-04-01,Connecticut,2690984,1824847,1743960,80887
2006-04-01,Delaware,655160,442353,424748,17605
2006-04-01,Florida,14120197,8863169,8650938,212231
2006-04-01,Georgia,6881073,4682594,4441462,241132
2006-04-01,Hawaii,959152,632898,615623,17275
2006-04-01,Idaho,1080272,741494,714784,26710
2006-04-01,Illinois,9662467,6474739,6171881,302858
2006-04-01,Indiana,4787349,3234908,3074689,160219
2006-04-01,Iowa,2287744,1652328,1592837,59491
2006-04-01,Kansas,2076998,1457490,1392614,64876
2006-04-01,Kentucky,3238700,2013756,1898114,115642
2006-04-01,Louisiana,3180290,1992841,1912614,80227
2006-04-01,Maine,1049273,698519,666474,32045
2006-04-01,Maryland,4287265,2976119,2853647,122472
2006-04-01,Massachusetts,5085460,3398710,3238568,160142
2006-04-01,Michigan,7760312,5064429,4711722,352707
2006-04-01,Minnesota,3962617,2883712,2769949,113763
2006-04-01,Mississippi,2140074,1272591,1193090,79501
2006-04-01,Missouri,4477206,3022984,2877879,145105
2006-04-01,Montana,737179,493679,476780,16899
2006-04-01,Nebraska,1331622,968417,939016,29401
2006-04-01,Nevada,1871057,1276714,1225043,51671
2006-04-01,Ohio,8850579,5923616,5610899,312717
2006-04-01,Oklahoma,2683861,1709125,1643647,65478
2006-04-01,Oregon,2865540,1870498,1770303,100195
2006-04-01,Pennsylvania,9754252,6281330,5985668,295662
2006-04-01,Tennessee,4676556,2993120,2828835,164285
2006-04-01,Texas,16903616,11294298,10704340,589958
2006-04-01,Utah,1823477,1321063,1280361,40702
2006-04-01,Vermont,498663,354370,341788,12582
2006-04-01,Virginia,5773199,3960510,3829433,131077
2006-04-01,Washington,4895740,3311209,3146142,165067
2006-04-01,Wisconsin,4316003,3054068,2915742,138326
2006-04-01,Wyoming,394526,282905,274513,8392
2006-05-01,Alabama,3517270,2163359,2075386,87973
2006-05-01,Alaska,489223,348562,325248,23314
2006-05-01,Arizona,4612292,2958210,2828396,129814
2006-05-01,Arkansas,2139601,1346847,1275583,71264
2006-05-01,California,26975501,17622725,16757871,864854
2006-05-01,Colorado,3612117,2634815,2519556,115259
2006-05-01,Connecticut,2691896,1826938,1746106,80832
2006-05-01,Delaware,656124,442483,424936,17547
2006-05-01,Florida,14138018,8888754,8674278,214476
2006-05-01,Georgia,6893679,4693623,4452478,241145
2006-05-01,Hawaii,959626,633852,616564,17288
2006-05-01,Idaho,1082700,742127,715861,26266
2006-05-01,Illinois,9665568,6488248,6191538,296710
2006-05-01,Indiana,4790472,3235765,3073913,161852
2006-05-01,Iowa,2288903,1654729,1595166,59563
2006-05-01,Kansas,2077663,1460742,1396157,64585
2006-05-01,Kentucky,3241908,2017039,1901829,115210
2006-05-01,Louisiana,3185670,1991641,1913803,77838
2006-05-01,Maine,1049820,699299,666812,32487
2006-05-01,Maryland,4289562,2981172,2855605,125567
2006-05-01,Massachusetts,5086934,3403308,3242339,160969
2006-05-01,Michigan,7761618,5061963,4706902,355061
2006-05-01,Minnesota,3965924,2882539,2769759,112780
2006-05-01,Mississippi,2145215,1274797,1195081,79716
2006-05-01,Missouri,4481216,3028016,2882003,146013
2006-05-01,Montana,738094,495157,478285,16872
2006-05-01,Nebraska,1332250,969109,939813,29296
2006-05-01,Nevada,1875961,1282975,1230505,52470
2006-05-01,Ohio,8852737,5936851,5621439,315412
2006-05-01,Oklahoma,2686494,1710449,1644742,65707
2006-05-01,Oregon,2869684,1875141,1774854,100287
2006-05-01,Pennsylvania,9758456,6288804,5990267,298537
2006-05-01,Tennessee,4683186,3008468,2842377,166091
2006-05-01,Texas,16950545,11316310,10726117,590193
2006-05-01,Utah,1828395,1325529,1286032,39497
2006-05-01,Vermont,498974,354749,341898,12851
2006-05-01,Virginia,5779056,3965991,3834431,131560
2006-05-01,Washington,4903582,3318875,3152061,166814
2006-05-01,Wisconsin,4318785,3059089,2919686,139403
2006-05-01,Wyoming,395045,283567,275179,8388
2006-06-01,Alabama,3520846,2167159,2079399,87760
2006-06-01,Alaska,490098,349037,325825,23212
2006-06-01,Arizona,4625438,2967768,2837632,130136
2006-06-01,Arkansas,2142069,1346705,1274991,71714
2006-06-01,California,26988015,17635569,16770248,865321
2006-06-01,Colorado,3617894,2641282,2525693,115589
2006-06-01,Connecticut,2692943,1828775,1747945,80830
2006-06-01,Delaware,657087,442683,425140,17543
2006-06-01,Florida,14157040,8913367,8696519,216848
2006-06-01,Georgia,6906479,4705063,4464013,241050
2006-06-01,Hawaii,960179,634758,617722,17036
2006-06-01,Idaho,1085185,742774,717041,25733
2006-06-01,Illinois,9669194,6503286,6210984,292302
2006-06-01,Indiana,4793709,3235953,3072514,163439
2006-06-01,Iowa,2290118,1656339,1596192,60147
2006-06-01,Kansas,2078448,1464180,1399759,64421
2006-06-01,Kentucky,3245138,2020968,1905580,115388
2006-06-01,Louisiana,3190999,1992413,1915199,77214
2006-06-01,Maine,1050414,700153,667096,33057
2006-06-01,Maryland,4292028,2985290,2857042,128248
2006-06-01,Massachusetts,5088681,3408276,3246530,161746
2006-06-01,Michigan,7763097,5058880,4701332,357548
2006-06-01,Minnesota,3969353,2882243,2769472,112771
2006-06-01,Mississippi,2150308,1277358,1197221,80137
2006-06-01,Missouri,4485298,3033601,2886066,147535
2006-06-01,Montana,739054,496176,479335,16841
2006-06-01,Nebraska,1332910,970087,940667,29420
2006-06-01,Nevada,1881059,1288880,1235957,52923
2006-06-01,Ohio,8855024,5950887,5631674,319213
2006-06-01,Oklahoma,2689206,1711998,1645917,66081
2006-06-01,Oregon,2873984,1879552,1778796,100756
2006-06-01,Pennsylvania,9762883,6295098,5994139,300959
2006-06-01,Tennessee,4689861,3021272,2854682,166590
2006-06-01,Texas,16999573,11335374,10749064,586310
2006-06-01,Utah,1833309,1329902,1291669,38233
2006-06-01,Vermont,499285,355183,342044,13139
2006-06-01,Virginia,5785117,3971300,3838785,132515
2006-06-01,Washington,4911633,3326358,3158117,168241
2006-06-01,Wisconsin,4321688,3064326,2923138,141188
2006-06-01,Wyoming,395531,284276,275795,8481
2006-07-01,Alabama,3524489,2171367,2084065,87302
2006-07-01,Alaska,490950,349357,326290,23067
2006-07-01,Arizona,4638684,2977028,2847274,129754
2006-07-01,Arkansas,2144577,1346289,1274581,71708
2006-07-01,California,27001429,17650474,16786840,863634
2006-07-01,Colorado,3623832,2647155,2532065,115090
2006-07-01,Connecticut,2694086,1830942,1750241,80701
2006-07-01,Delaware,658065,442992,425528,17464
2006-07-01,Florida,14176539,8938216,8719152,219064
2006-07-01,Georgia,6919458,4717188,4476911,240277
2006-07-01,Hawaii,960755,635731,619244,16487
2006-07-01,Idaho,1087671,743753,718495,25258
2006-07-01,Illinois,9673133,6519819,6230966,288853
2006-07-01,Indiana,4797047,3236278,3072207,164071
2006-07-01,Iowa,2291405,1657590,1596824,60766
2006-07-01,Kansas,2079254,1467807,1403581,64226
2006-07-01,Kentucky,3248465,2025779,1910088,115691
2006-07-01,Louisiana,3196377,1994902,1917341,77561
2006-07-01,Maine,1051012,701038,667451,33587
2006-07-01,Maryland,4294599,2988845,2859174,129671
2006-07-01,Massachusetts,5090541,3413405,3251310,162095
2006-07-01,Michigan,7764767,5055515,4696148,359367
2006-07-01,Minnesota,3972847,2883675,2769850,113825
2006-07-01,Mississippi,2155425,1280178,1199699,80479
2006-07-01,Missouri,4489492,3039402,2890439,148963
2006-07-01,Montana,739999,496676,479942,16734
2006-07-01,Nebraska,1333638,971231,941724,29507
2006-07-01,Nevada,1886237,1294646,1241605,53041
2006-07-01,Ohio,8857512,5964470,5641744,322726
2006-07-01,Oklahoma,2692022,1713704,1647247,66457
2006-07-01,Oregon,2878329,1883930,1782598,101332
2006-07-01,Pennsylvania,9767552,6300948,5999284,301664
2006-07-01,Tennessee,4696684,3031107,2865935,165172
2006-07-01,Texas,17049031,11351838,10775124,576714
2006-07-01,Utah,1838305,1334478,1297521,36957
2006-07-01,Vermont,499602,355703,342294,13409
2006-07-01,Virginia,5791297,3976954,3843635,133319
2006-07-01,Washington,4919842,3333760,3165012,168748
2006-07-01,Wisconsin,4324694,3069428,2926323,143105
2006-07-01,Wyoming,396049,285048,276434,8614
2006-08-01,Alabama,3527515,2176026,2089301,86725
2006-08-01,Alaska,491379,349634,326706,22928
2006-08-01,Arizona,4649714,2986508,2857798,128710
2006-08-01,Arkansas,2146566,1346217,1274701,71516
2006-08-01,California,27025634,17671419,16810113,861306
2006-08-01,Colorado,3629927,2652385,2538867,113518
2006-08-01,Connecticut,2695372,1833746,1753195,80551
2006-08-01,Delaware,658964,443425,426171,17254
2006-08-01,Florida,14191932,8964208,8742603,221605
2006-08-01,Georgia,6933287,4730491,4491354,239137
2006-08-01,Hawaii,961394,636833,621045,15788
2006-08-01,Idaho,1089894,745184,720255,24929
2006-08-01,Illinois,9679632,6537794,6251061,286733
2006-08-01,Indiana,4800663,3237482,3073727,163755
2006-08-01,Iowa,2292788,1659099,1597910,61189
2006-08-01,Kansas,2080872,1471727,1407676,64051
2006-08-01,Kentucky,3250741,2031652,1915782,115870
2006-08-01,Louisiana,3204857,1998749,1920481,78268
2006-08-01,Maine,1051575,702011,668042,33969
2006-08-01,Maryland,4297454,2992402,2862631,129771
2006-08-01,Massachusetts,5094563,3418840,3256631,162209
2006-08-01,Michigan,7766182,5052872,4691989,360883
2006-08-01,Minnesota,3976524,2887166,2771111,116055
2006-08-01,Mississippi,2156898,1283338,1202508,80830
2006-08-01,Missouri,4493471,3045228,2895141,150087
2006-08-01,Montana,740941,496874,480340,16534
2006-08-01,Nebraska,1334445,972530,943039,29491
2006-08-01,Nevada,1890994,1300611,1247515,53096
2006-08-01,Ohio,8861768,5978031,5652208,325823
2006-08-01,Oklahoma,2694318,1715726,1648772,66954
2006-08-01,Oregon,2882700,1888427,1786546,101881
2006-08-01,Pennsylvania,9773593,6307766,6007146,300620
2006-08-01,Tennessee,4702407,3038347,2876327,162020
2006-08-01,Texas,17079249,11367207,10804130,563077
2006-08-01,Utah,1842871,1339519,1303704,35815
2006-08-01,Vermont,499853,356239,342595,13644
2006-08-01,Virginia,5797279,3983653,3849897,133756
2006-08-01,Washington,4927599,3341319,3172753,168566
2006-08-01,Wisconsin,4327819,3074307,2929287,145020
2006-08-01,Wyoming,396711,285874,277156,8718
2006-09-01,Alabama,3530831,2180689,2094591,86098
2006-09-01,Alaska,491865,349874,327071,22803
2006-09-01,Arizona,4661126,2995813,2868713,127100
2006-09-01,Arkansas,2148699,1346678,1275263,71415
2006-09-01,California,27052081,17699166,16838653,860513
2006-09-01,Colorado,3636313,2656964,2545785,111179
2006-09-01,Connecticut,2696847,1836913,1756417,80496
2006-09-01,Delaware,659891,443955,427015,16940
2006-09-01,Florida,14208495,8990679,8765814,224865
2006-09-01,Georgia,6947670,4744336,4506631,237705
2006-09-01,Hawaii,962139,637954,622790,15164
2006-09-01,Idaho,1092208,746840,722205,24635
2006-09-01,Illinois,9686923,6555585,6268521,287064
2006-09-01,Indiana,4804585,3238710,3075872,162838
2006-09-01,Iowa,2294361,1661018,1599582,61436
2006-09-01,Kansas,2082641,1475958,1411988,63970
2006-09-01,Kentucky,3253218,2038086,1922152,115934
2006-09-01,Louisiana,3213610,2003637,1924375,79262
2006-09-01,Maine,1052220,703009,668866,34143
2006-09-01,Maryland,4300680,2995782,2866926,128856
2006-09-01,Massachusetts,5098896,3424172,3261883,162289
2006-09-01,Michigan,7768125,5050900,4688983,361917
2006-09-01,Minnesota,3980510,2892049,2772961,119088
2006-09-01,Mississippi,2158536,1286478,1205340,81138
2006-09-01,Missouri,4497734,3050585,2899808,150777
2006-09-01,Montana,741949,497008,480753,16255
2006-09-01,Nebraska,1335339,973920,944455,29465
2006-09-01,Nevada,1895903,1306774,1253515,53259
2006-09-01,Ohio,8866608,5990760,5662364,328396
2006-09-01,Oklahoma,2696751,1718058,1650292,67766
2006-09-01,Oregon,2887241,1892988,1790709,102279
2006-09-01,Pennsylvania,9780250,6315598,6017276,298322
2006-09-01,Tennessee,4708406,3043505,2885641,157864
2006-09-01,Texas,17110941,11381736,10832912,548824
2006-09-01,Utah,1847529,1344922,1310071,34851
2006-09-01,Vermont,500114,356647,342812,13835
2006-09-01,Virginia,5803659,3991266,3857489,133777
2006-09-01,Washington,4935665,3348767,3180801,167966
2006-09-01,Wisconsin,4331183,3078965,2932001,146964
2006-09-01,Wyoming,397410,286704,277957,8747
2006-10-01,Alabama,3534233,2184587,2099223,85364
2006-10-01,Alaska,492363,350052,327406,22646
2006-10-01,Arizona,4672561,3004252,2879213,125039
2006-10-01,Arkansas,2150924,1347720,1276360,71360
2006-10-01,California,27078759,17731148,16870354,860794
2006-10-01,Colorado,3642735,2660820,2552545,108275
2006-10-01,Connecticut,2698356,1840211,1759811,80400
2006-10-01,Delaware,660866,444511,427949,16562
2006-10-01,Florida,14225236,9016846,8788180,228666
2006-10-01,Georgia,6962267,4757415,4521848,235567
2006-10-01,Hawaii,962862,638975,624209,14766
2006-10-01,Idaho,1094511,748469,724217,24252
2006-10-01,Illinois,9694364,6570891,6281776,289115
2006-10-01,Indiana,4808630,3239074,3078111,160963
2006-10-01,Iowa,2295947,1662986,1601611,61375
2006-10-01,Kansas,2084444,1478938,1415081,63857
2006-10-01,Kentucky,3255793,2043869,1928275,115594
2006-10-01,Louisiana,3222460,2009343,1928865,80478
2006-10-01,Maine,1052853,703851,669845,34006
2006-10-01,Maryland,4304017,2998354,2871256,127098
2006-10-01,Massachusetts,5103347,3428730,3266745,161985
2006-10-01,Michigan,7770240,5048765,4687689,361076
2006-10-01,Minnesota,3984539,2897203,2775300,121903
2006-10-01,Mississippi,2160264,1289198,1207813,81385
2006-10-01,Missouri,4502085,3054914,2904208,150706
2006-10-01,Montana,742968,497327,481487,15840
2006-10-01,Nebraska,1336273,975160,945823,29337
2006-10-01,Nevada,1900824,1312862,1259390,53472
2006-10-01,Ohio,8871588,6001365,5672001,329364
2006-10-01,Oklahoma,2699281,1720521,1651829,68692
2006-10-01,Oregon,2891842,1897606,1795512,102094
2006-10-01,Pennsylvania,9787133,6323451,6028619,294832
2006-10-01,Tennessee,4714580,3047672,2894538,153134
2006-10-01,Texas,17142922,11394861,10859232,535629
2006-10-01,Utah,1852277,1350404,1316400,34004
2006-10-01,Vermont,500437,356823,342892,13931
2006-10-01,Virginia,5810214,3999235,3866151,133084
2006-10-01,Washington,4943864,3355850,3189139,166711
2006-10-01,Wisconsin,4334726,3083012,2934814,148198
2006-10-01,Wyoming,398110,287463,278828,8635
2006-11-01,Alabama,3537230,2187215,2102582,84633
2006-11-01,Alaska,492811,350202,327755,22447
2006-11-01,Arizona,4683513,3011163,2888274,122889
2006-11-01,Arkansas,2152890,1349135,1277814,71321
2006-11-01,California,27103225,17763499,16900814,862685
2006-11-01,Colorado,3648895,2663422,2558561,104861
2006-11-01,Connecticut,2699575,1843373,1763165,80208
2006-11-01,Delaware,661769,444980,428750,16230
2006-11-01,Florida,14240024,9041667,8808471,233196
2006-11-01,Georgia,6976303,4768552,4535543,233009
2006-11-01,Hawaii,963638,639733,625059,14674
2006-11-01,Idaho,1096757,749884,726133,23751
2006-11-01,Illinois,9700854,6581859,6289937,291922
2006-11-01,Indiana,4812269,3238109,3079821,158288
2006-11-01,Iowa,2297319,1664385,1603265,61120
2006-11-01,Kansas,2086023,1484594,1420985,63609
2006-11-01,Kentucky,3258054,2047981,1933255,114726
2006-11-01,Louisiana,3230986,2015113,1933463,81650
2006-11-01,Maine,1053411,704327,670736,33591
2006-11-01,Maryland,4306848,2999434,2874673,124761
2006-11-01,Massachusetts,5107225,3432017,3270894,161123
2006-11-01,Michigan,7771568,5045048,4686860,358188
2006-11-01,Minnesota,3988221,2901587,2777537,124050
2006-11-01,Mississippi,2161794,1291444,1209651,81793
2006-11-01,Missouri,4506029,3057697,2907850,149847
2006-11-01,Montana,743938,498025,482717,15308
2006-11-01,Nebraska,1337076,975966,947007,28959
2006-11-01,Nevada,1905607,1318570,1264827,53743
2006-11-01,Ohio,8875607,6008981,5680298,328683
2006-11-01,Oklahoma,2701509,1722979,1653494,69485
2006-11-01,Oregon,2896151,1901918,1800823,101095
2006-11-01,Pennsylvania,9792714,6329667,6039226,290441
2006-11-01,Tennessee,4720259,3050954,2902791,148163
2006-11-01,Texas,17173555,11405690,10881093,524597
2006-11-01,Utah,1856935,1355691,1322348,33343
2006-11-01,Vermont,500707,356762,342822,13940
2006-11-01,Virginia,5816239,4006703,3874981,131722
2006-11-01,Washington,4951564,3362320,3197583,164737
2006-11-01,Wisconsin,4337810,3085923,2937397,148526
2006-11-01,Wyoming,398800,288093,279707,8386
2006-12-01,Alabama,3539975,2188157,2104100,84057
2006-12-01,Alaska,493209,350246,328038,22208
2006-12-01,Arizona,4694090,3015741,2894953,120788
2006-12-01,Arkansas,2154700,1350471,1279168,71303
2006-12-01,California,27125539,17791249,16924622,866627
2006-12-01,Colorado,3654689,2664298,2563203,101095
2006-12-01,Connecticut,2700572,1845968,1766016,79952
2006-12-01,Delaware,662605,445217,429217,16000
2006-12-01,Florida,14253857,9063204,8824665,238539
2006-12-01,Georgia,6989645,4776763,4546384,230379
2006-12-01,Hawaii,964323,640049,625186,14863
2006-12-01,Idaho,1098875,750946,727798,23148
2006-12-01,Illinois,9706507,6587537,6292132,295405
2006-12-01,Indiana,4815412,3234565,3079521,155044
2006-12-01,Iowa,2298473,1664469,1603613,60856
2006-12-01,Kansas,2087411,1485269,1421997,63272
2006-12-01,Kentucky,3260036,2049777,1936376,113401
2006-12-01,Louisiana,3239209,2019911,1937175,82736
2006-12-01,Maine,1053865,704222,671172,33050
2006-12-01,Maryland,4309390,2998285,2876346,121939
2006-12-01,Massachusetts,5110695,3433704,3273958,159746
2006-12-01,Michigan,7772247,5038631,4684597,354034
2006-12-01,Minnesota,3991537,2904402,2778889,125513
2006-12-01,Mississippi,2163100,1292752,1210528,82224
2006-12-01,Missouri,4509532,3058416,2909972,148444
2006-12-01,Montana,744795,499089,484328,14761
2006-12-01,Nebraska,1337751,976178,947798,28380
2006-12-01,Nevada,1910243,1323560,1269442,54118
2006-12-01,Ohio,8878875,6013359,5686100,327259
2006-12-01,Oklahoma,2703508,1725014,1654984,70030
2006-12-01,Oregon,2900173,1905040,1805631,99409
2006-12-01,Pennsylvania,9797592,6332288,6046688,285600
2006-12-01,Tennessee,4725564,3052604,2909137,143467
2006-12-01,Texas,17202612,11412317,10896648,515669
2006-12-01,Utah,1861354,1360400,1327488,32912
2006-12-01,Vermont,500907,356469,342563,13906
2006-12-01,Virginia,5821739,4012705,3882705,130000
2006-12-01,Washington,4958849,3367727,3205651,162076
2006-12-01,Wisconsin,4340530,3087289,2939043,148246
2006-12-01,Wyoming,399410,288545,280486,8059
2007-01-01,Alabama,3542815,2187339,2103550,83789
2007-01-01,Alaska,493664,350083,328102,21981
2007-01-01,Arizona,4704694,3017695,2899008,118687
2007-01-01,Arkansas,2156533,1351331,1279989,71342
2007-01-01,California,27148345,17811829,16938382,873447
2007-01-01,Colorado,3660570,2663897,2566479,97418
2007-01-01,Connecticut,2701606,1848030,1768257,79773
2007-01-01,Delaware,663461,445183,429285,15898
2007-01-01,Florida,14267753,9079865,8835015,244850
2007-01-01,Georgia,7003265,4781979,4553801,228178
2007-01-01,Hawaii,965074,639907,624680,15227
2007-01-01,Idaho,1101043,751704,729172,22532
2007-01-01,Illinois,9712343,6589487,6289431,300056
2007-01-01,Indiana,4818643,3227858,3076193,151665
2007-01-01,Iowa,2299627,1663289,1602493,60796
2007-01-01,Kansas,2088878,1485282,1422275,63007
2007-01-01,Kentucky,3262037,2049214,1937338,111876
2007-01-01,Louisiana,3247530,2022840,1939101,83739
2007-01-01,Maine,1054293,703506,670974,32532
2007-01-01,Maryland,4312014,2994895,2875951,118944
2007-01-01,Massachusetts,5114213,3434072,3275858,158214
2007-01-01,Michigan,7773003,5029796,4679591,350205
2007-01-01,Minnesota,3994866,2905237,2778670,126567
2007-01-01,Mississippi,2164477,1292826,1210328,82498
2007-01-01,Missouri,4513113,3057457,2910257,147200
2007-01-01,Montana,745694,500327,485966,14361
2007-01-01,Nebraska,1338456,976001,948140,27861
2007-01-01,Nevada,1914899,1327708,1273015,54693
2007-01-01,Ohio,8882233,6015798,5688698,327100
2007-01-01,Oklahoma,2705529,1726172,1655845,70327
2007-01-01,Oregon,2904260,1906671,1809169,97502
2007-01-01,Pennsylvania,9802460,6331494,6050069,281425
2007-01-01,Tennessee,4730893,3051958,2912489,139469
2007-01-01,Texas,17232072,11413662,10905100,508562
2007-01-01,Utah,1865807,1364352,1331564,32788
2007-01-01,Vermont,501089,355976,342115,13861
2007-01-01,Virginia,5827381,4016723,3888251,128472
2007-01-01,Washington,4966166,3371978,3213005,158973
2007-01-01,Wisconsin,4343261,3087107,2939387,147720
2007-01-01,Wyoming,400067,288825,281087,7738
2007-02-01,Alabama,3545167,2185202,2101371,83831
2007-02-01,Alaska,494007,349811,327999,21812
2007-02-01,Arizona,4714781,3017647,2901286,116361
2007-02-01,Arkansas,2158081,1351478,1279970,71508
2007-02-01,California,27168086,17826788,16943822,882966
2007-02-01,Colorado,3666058,2663475,2569153,94322
2007-02-01,Connecticut,2702303,1849724,1769948,79776
2007-02-01,Delaware,664226,444987,429060,15927
2007-02-01,Florida,14279851,9091891,8839714,252177
2007-02-01,Georgia,7016065,4785242,4558332,226910
2007-02-01,Hawaii,965632,639382,623747,15635
2007-02-01,Idaho,1103046,752358,730389,21969
2007-02-01,Illinois,9717097,6591137,6285513,305624
2007-02-01,Indiana,4821332,3218753,3070366,148387
2007-02-01,Iowa,2300517,1661602,1600672,60930
2007-02-01,Kansas,2090053,1484899,1422087,62812
2007-02-01,Kentucky,3263696,2046911,1936545,110366
2007-02-01,Louisiana,3255510,2023956,1939168,84788
2007-02-01,Maine,1054627,702423,670267,32156
2007-02-01,Maryland,4314108,2990228,2874136,116092
2007-02-01,Massachusetts,5117238,3433865,3277054,156811
2007-02-01,Michigan,7772855,5019800,4672378,347422
2007-02-01,Minnesota,3997795,2904324,2776911,127413
2007-02-01,Mississippi,2165618,1291912,1209476,82436
2007-02-01,Missouri,4516134,3055861,2909172,146689
2007-02-01,Montana,746466,501476,487228,14248
2007-02-01,Nebraska,1338983,975808,948238,27570
2007-02-01,Nevada,1919343,1331183,1275701,55482
2007-02-01,Ohio,8884607,6017630,5689064,328566
2007-02-01,Oklahoma,2707226,1726322,1655815,70507
2007-02-01,Oregon,2907965,1906967,1811075,95892
2007-02-01,Pennsylvania,9806222,6328908,6050384,278524
2007-02-01,Tennessee,4735729,3049020,2912944,136076
2007-02-01,Texas,17259736,11411958,10908743,503215
2007-02-01,Utah,1870120,1367666,1334719,32947
2007-02-01,Vermont,501269,355401,341580,13821
2007-02-01,Virginia,5832389,4019179,3891877,127302
2007-02-01,Washington,4972954,3375862,3219836,156026
2007-02-01,Wisconsin,4345498,3086120,2938906,147214
2007-02-01,Wyoming,400707,289039,281520,7519
2007-03-01,Alabama,3547626,2182257,2098155,84102
2007-03-01,Alaska,494382,349471,327774,21697
2007-03-01,Arizona,4724746,3015955,2902281,113674
2007-03-01,Arkansas,2159672,1350887,1279107,71780
2007-03-01,California,27186717,17837732,16944145,893587
2007-03-01,Colorado,3671548,2664085,2572031,92054
2007-03-01,Connecticut,2703036,1850803,1770914,79889
2007-03-01,Delaware,665035,444654,428670,15984
2007-03-01,Florida,14291739,9099437,8839277,260160
2007-03-01,Georgia,7028941,4787416,4560839,226577
2007-03-01,Hawaii,966129,638441,622449,15992
2007-03-01,Idaho,1105085,752994,731466,21528
2007-03-01,Illinois,9721893,6594491,6283126,311365
2007-03-01,Indiana,4824188,3208405,3063073,145332
2007-03-01,Iowa,2301493,1659975,1598932,61043
2007-03-01,Kansas,2091299,1484163,1421613,62550
2007-03-01,Kentucky,3265475,2043296,1934313,108983
2007-03-01,Louisiana,3263490,2023695,1937949,85746
2007-03-01,Maine,1054996,701102,669145,31957
2007-03-01,Maryland,4316235,2985200,2871826,113374
2007-03-01,Massachusetts,5120326,3433170,3277638,155532
2007-03-01,Michigan,7772871,5009740,4664185,345555
2007-03-01,Minnesota,4000855,2902138,2774014,128124
2007-03-01,Mississippi,2166767,1290406,1208538,81868
2007-03-01,Missouri,4519323,3054108,2907025,147083
2007-03-01,Montana,747297,502396,487908,14488
2007-03-01,Nebraska,1339583,975800,948254,27546
2007-03-01,Nevada,1923771,1334075,1277645,56430
2007-03-01,Ohio,8887255,6018863,5688428,330435
2007-03-01,Oklahoma,2708997,1725376,1654906,70470
2007-03-01,Oregon,2911736,1906174,1811295,94879
2007-03-01,Pennsylvania,9810236,6325867,6049127,276740
2007-03-01,Tennessee,4740652,3044434,2911363,133071
2007-03-01,Texas,17286779,11408395,10909724,498671
2007-03-01,Utah,1874494,1370319,1337078,33241
2007-03-01,Vermont,501453,354803,341022,13781
2007-03-01,Virginia,5837444,4020557,3894124,126433
2007-03-01,Washington,4979787,3379685,3226114,153571
2007-03-01,Wisconsin,4347897,3084887,2938058,146829
2007-03-01,Wyoming,401306,289270,281824,7446
2007-04-01,Alabama,3550367,2179466,2094744,84722
2007-04-01,Alaska,494816,349168,327497,21671
2007-04-01,Arizona,4735194,3013261,2902557,110704
2007-04-01,Arkansas,2161464,1349996,1277800,72196
2007-04-01,California,27208433,17848998,16944007,904991
2007-04-01,Colorado,3677433,2666633,2575603,91030
2007-04-01,Connecticut,2703993,1851481,1771391,80090
2007-04-01,Delaware,665843,444310,428349,15961
2007-04-01,Florida,14305044,9103305,8834580,268725
2007-04-01,Georgia,7042417,4789823,4562579,227244
2007-04-01,Hawaii,966815,637218,620930,16288
2007-04-01,Idaho,1107207,753743,732433,21310
2007-04-01,Illinois,9727632,6601114,6284088,317026
2007-04-01,Indiana,4827419,3198676,3055662,143014
2007-04-01,Iowa,2302638,1658797,1597745,61052
2007-04-01,Kansas,2092707,1483334,1421088,62246
2007-04-01,Kentucky,3267511,2039096,1931178,107918
2007-04-01,Louisiana,3271780,2022494,1936224,86270
2007-04-01,Maine,1055438,699674,667728,31946
2007-04-01,Maryland,4318781,2981141,2870098,111043
2007-04-01,Massachusetts,5123854,3432208,3277798,154410
2007-04-01,Michigan,7773549,5000964,4656111,344853
2007-04-01,Minnesota,4004225,2899693,2770677,129016
2007-04-01,Mississippi,2168121,1288973,1208054,80919
2007-04-01,Missouri,4522851,3052781,2904486,148295
2007-04-01,Montana,748152,503141,488072,15069
2007-04-01,Nebraska,1340253,976138,948372,27766
2007-04-01,Nevada,1928351,1336648,1279106,57542
2007-04-01,Ohio,8890662,6019476,5686963,332513
2007-04-01,Oklahoma,2711001,1723712,1653537,70175
2007-04-01,Oregon,2915785,1905062,1810393,94669
2007-04-01,Pennsylvania,9815062,6324317,6048045,276272
2007-04-01,Tennessee,4745983,3039561,2908711,130850
2007-04-01,Texas,17315600,11405711,10910668,495043
2007-04-01,Utah,1878974,1372517,1338904,33613
2007-04-01,Vermont,501644,354210,340469,13741
2007-04-01,Virginia,5843053,4021773,3895919,125854
2007-04-01,Washington,4987100,3383635,3231633,152002
2007-04-01,Wisconsin,4350635,3084013,2937255,146758
2007-04-01,Wyoming,401915,289584,282060,7524
2007-05-01,Alabama,3553057,2177514,2091810,85704
2007-05-01,Alaska,495225,349067,327322,21745
2007-05-01,Arizona,4745562,3010820,2902959,107861
2007-05-01,Arkansas,2163259,1349262,1276423,72839
2007-05-01,California,27228543,17864179,16945471,918708
2007-05-01,Colorado,3683212,2671638,2580013,91625
2007-05-01,Connecticut,2704965,1852382,1771872,80510
2007-05-01,Delaware,666703,444108,428254,15854
2007-05-01,Florida,14318164,9104735,8826525,278210
2007-05-01,Georgia,7055680,4793806,4564652,229154
2007-05-01,Hawaii,967396,635993,619428,16565
2007-05-01,Idaho,1109395,754736,733266,21470
2007-05-01,Illinois,9733064,6612003,6288680,323323
2007-05-01,Indiana,4830704,3191090,3049045,142045
2007-05-01,Iowa,2303875,1658248,1597178,61070
2007-05-01,Kansas,2094137,1482871,1420764,62107
2007-05-01,Kentucky,3269599,2035221,1927722,107499
2007-05-01,Louisiana,3279938,2020880,1934816,86064
2007-05-01,Maine,1055909,698469,666311,32158
2007-05-01,Maryland,4321081,2979361,2869725,109636
2007-05-01,Massachusetts,5127404,3431323,3277616,153707
2007-05-01,Michigan,7774209,4994572,4648398,346174
2007-05-01,Minnesota,4007656,2897960,2767511,130449
2007-05-01,Mississippi,2169389,1288212,1208301,79911
2007-05-01,Missouri,4526429,3052676,2902173,150503
2007-05-01,Montana,749055,503837,487924,15913
2007-05-01,Nebraska,1340978,976883,948707,28176
2007-05-01,Nevada,1932909,1339270,1280394,58876
2007-05-01,Ohio,8893985,6019240,5683902,335338
2007-05-01,Oklahoma,2713002,1721952,1652156,69796
2007-05-01,Oregon,2919845,1904550,1809031,95519
2007-05-01,Pennsylvania,9819965,6326189,6048133,278056
2007-05-01,Tennessee,4751300,3036040,2905735,130305
2007-05-01,Texas,17343816,11406369,10913440,492929
2007-05-01,Utah,1883565,1374601,1340503,34098
2007-05-01,Vermont,501915,353648,339909,13739
2007-05-01,Virginia,5848525,4023984,3898080,125904
2007-05-01,Washington,4994344,3388302,3236416,151886
2007-05-01,Wisconsin,4353467,3084018,2936652,147366
2007-05-01,Wyoming,402568,290015,282297,7718
2007-06-01,Alabama,3555840,2176642,2089809,86833
2007-06-01,Alaska,495672,349218,327344,21874
2007-06-01,Arizona,4756223,3009749,2904001,105748
2007-06-01,Arkansas,2165134,1348840,1275317,73523
2007-06-01,California,27250665,17884308,16949426,934882
2007-06-01,Colorado,3689241,2678950,2585195,93755
2007-06-01,Connecticut,2706011,1853582,1772394,81188
2007-06-01,Delaware,667547,444095,428382,15713
2007-06-01,Florida,14332124,9105560,8817098,288462
2007-06-01,Georgia,7069217,4799738,4567895,231843
2007-06-01,Hawaii,968049,634988,618131,16857
2007-06-01,Idaho,1111626,755825,733862,21963
2007-06-01,Illinois,9738987,6626590,6295927,330663
2007-06-01,Indiana,4834163,3186811,3044087,142724
2007-06-01,Iowa,2305187,1658520,1597354,61166
2007-06-01,Kansas,2095692,1482976,1420851,62125
2007-06-01,Kentucky,3271781,2032318,1924641,107677
2007-06-01,Louisiana,3288245,2019628,1934783,84845
2007-06-01,Maine,1056469,697735,665225,32510
2007-06-01,Maryland,4323615,2980361,2871146,109215
2007-06-01,Massachusetts,5131157,3430837,3277367,153470
2007-06-01,Michigan,7775181,4990740,4641105,349635
2007-06-01,Minnesota,4011308,2897126,2764914,132212
2007-06-01,Mississippi,2170706,1288461,1209455,79006
2007-06-01,Missouri,4530219,3053868,2900452,153416
2007-06-01,Montana,749995,504589,487728,16861
2007-06-01,Nebraska,1341787,978010,949273,28737
2007-06-01,Nevada,1937559,1342122,1281753,60369
2007-06-01,Ohio,8897675,6018239,5679913,338326
2007-06-01,Oklahoma,2715153,1720786,1651389,69397
2007-06-01,Oregon,2924062,1905140,1807945,97195
2007-06-01,Pennsylvania,9825270,6331860,6050019,281841
2007-06-01,Tennessee,4756801,3035028,2903157,131871
2007-06-01,Texas,17373223,11411196,10919419,491777
2007-06-01,Utah,1888192,1376750,1342100,34650
2007-06-01,Vermont,502139,353120,339337,13783
2007-06-01,Virginia,5854226,4028150,3901236,126914
2007-06-01,Washington,5001907,3394186,3241007,153179
2007-06-01,Wisconsin,4356491,3084946,2936311,148635
2007-06-01,Wyoming,403237,290549,282594,7955
2007-07-01,Alabama,3558681,2176801,2088783,88018
2007-07-01,Alaska,496104,349601,327600,22001
2007-07-01,Arizona,4766960,3010496,2905303,105193
2007-07-01,Arkansas,2167028,1348878,1274796,74082
2007-07-01,California,27272732,17909056,16955401,953655
2007-07-01,Colorado,3695257,2687730,2590676,97054
2007-07-01,Connecticut,2707103,1855062,1772917,82145
2007-07-01,Delaware,668413,444306,428680,15626
2007-07-01,Florida,14346248,9107665,8808067,299598
2007-07-01,Georgia,7082742,4807351,4572460,234891
2007-07-01,Hawaii,968654,634347,617083,17264
2007-07-01,Idaho,1113839,756838,734072,22766
2007-07-01,Illinois,9744901,6643166,6304082,339084
2007-07-01,Indiana,4837626,3186509,3041603,144906
2007-07-01,Iowa,2306506,1659537,1598096,61441
2007-07-01,Kansas,2097234,1483761,1421335,62426
2007-07-01,Kentucky,3274004,2030626,1922179,108447
2007-07-01,Louisiana,3296552,2020024,1937021,83003
2007-07-01,Maine,1056994,697547,664650,32897
2007-07-01,Maryland,4326118,2983555,2874060,109495
2007-07-01,Massachusetts,5134949,3430818,3277176,153642
2007-07-01,Michigan,7776164,4988759,4634339,354420
2007-07-01,Minnesota,4014920,2896892,2762772,134120
2007-07-01,Mississippi,2172054,1289829,1211517,78312
2007-07-01,Missouri,4533977,3056144,2899507,156637
2007-07-01,Montana,750920,505402,487649,17753
2007-07-01,Nebraska,1342569,979315,949989,29326
2007-07-01,Nevada,1942229,1345169,1283216,61953
2007-07-01,Ohio,8901395,6016911,5676080,340831
2007-07-01,Oklahoma,2717277,1720470,1651470,69000
2007-07-01,Oregon,2928298,1907026,1807857,99169
2007-07-01,Pennsylvania,9830577,6340420,6053546,286874
2007-07-01,Tennessee,4762302,3036405,2900885,135520
2007-07-01,Texas,17402744,11421250,10928845,492405
2007-07-01,Utah,1892813,1378927,1343693,35234
2007-07-01,Vermont,502403,352634,338784,13850
2007-07-01,Virginia,5859929,4034464,3905389,129075
2007-07-01,Washington,5009419,3401159,3245815,155344
2007-07-01,Wisconsin,4359501,3086615,2936378,150237
2007-07-01,Wyoming,403916,291070,282958,8112
2007-08-01,Alabama,3561917,2177930,2088560,89370
2007-08-01,Alaska,496548,350146,328057,22089
2007-08-01,Arizona,4776490,3013553,2906699,106854
2007-08-01,Arkansas,2168911,1349562,1275104,74458
2007-08-01,California,27303913,17937431,16962173,975258
2007-08-01,Colorado,3701828,2697211,2596232,100979
2007-08-01,Connecticut,2709153,1857126,1773734,83392
2007-08-01,Delaware,669353,444788,429083,15705
2007-08-01,Florida,14359617,9113142,8801072,312070
2007-08-01,Georgia,7093411,4816462,4578064,238398
2007-08-01,Hawaii,969244,634307,616467,17840
2007-08-01,Idaho,1115743,757610,733890,23720
2007-08-01,Illinois,9751568,6659740,6311421,348319
2007-08-01,Indiana,4841311,3189936,3042056,147880
2007-08-01,Iowa,2307852,1661174,1599243,61931
2007-08-01,Kansas,2098568,1485166,1422076,63090
2007-08-01,Kentucky,3277367,2030101,1920430,109671
2007-08-01,Louisiana,3301976,2022752,1941466,81286
2007-08-01,Maine,1057594,697898,664625,33273
2007-08-01,Maryland,4329119,2987929,2877897,110032
2007-08-01,Massachusetts,5139706,3431305,3277143,154162
2007-08-01,Michigan,7776510,4987655,4628409,359246
2007-08-01,Minnesota,4018335,2896949,2760940,136009
2007-08-01,Mississippi,2173543,1292419,1214328,78091
2007-08-01,Missouri,4538164,3059270,2899435,159835
2007-08-01,Montana,751782,506257,487785,18472
2007-08-01,Nebraska,1343491,980593,950869,29724
2007-08-01,Nevada,1945510,1348473,1284830,63643
2007-08-01,Ohio,8904792,6015646,5672744,342902
2007-08-01,Oklahoma,2719731,1721008,1652431,68577
2007-08-01,Oregon,2932301,1910361,1809306,101055
2007-08-01,Pennsylvania,9836784,6351089,6058375,292714
2007-08-01,Tennessee,4768036,3039495,2898731,140764
2007-08-01,Texas,17433249,11437858,10942199,495659
2007-08-01,Utah,1896507,1381216,1345301,35915
2007-08-01,Vermont,502642,352250,338324,13926
2007-08-01,Virginia,5866159,4042707,3910208,132499
2007-08-01,Washington,5016731,3409111,3251381,157730
2007-08-01,Wisconsin,4362443,3088677,2936986,151691
2007-08-01,Wyoming,404543,291531,283401,8130
2007-09-01,Alabama,3565336,2179782,2088878,90904
2007-09-01,Alaska,496997,350731,328614,22117
2007-09-01,Arizona,4786223,3018977,2908422,110555
2007-09-01,Arkansas,2170921,1350759,1276385,74374
2007-09-01,California,27336405,17966927,16969958,996969
2007-09-01,Colorado,3708531,2706470,2601718,104752
2007-09-01,Connecticut,2711285,1859938,1775209,84729
2007-09-01,Delaware,670273,445525,429558,15967
2007-09-01,Florida,14373626,9122980,8797471,325509
2007-09-01,Georgia,7104351,4826570,4584166,242404
2007-09-01,Hawaii,969891,634954,616466,18488
2007-09-01,Idaho,1117698,757879,733406,24473
2007-09-01,Illinois,9758656,6674906,6317812,357094
2007-09-01,Indiana,4845110,3196416,3045872,150544
2007-09-01,Iowa,2309268,1663352,1600949,62403
2007-09-01,Kansas,2100032,1486755,1422954,63801
2007-09-01,Kentucky,3280860,2030322,1919801,110521
2007-09-01,Louisiana,3307526,2027354,1947292,80062
2007-09-01,Maine,1058224,698665,665148,33517
2007-09-01,Maryland,4332260,2992773,2882585,110188
2007-09-01,Massachusetts,5144605,3432460,3277791,154669
2007-09-01,Michigan,7777126,4986270,4623665,362605
2007-09-01,Minnesota,4021916,2897029,2759599,137430
2007-09-01,Mississippi,2175146,1295815,1217572,78243
2007-09-01,Missouri,4542485,3062504,2900171,162333
2007-09-01,Montana,752706,507153,488205,18948
2007-09-01,Nebraska,1344485,981750,951958,29792
2007-09-01,Nevada,1948879,1352002,1286632,65370
2007-09-01,Ohio,8908449,6015396,5671388,344008
2007-09-01,Oklahoma,2722273,1722237,1654437,67800
2007-09-01,Oregon,2936407,1914597,1812240,102357
2007-09-01,Pennsylvania,9843273,6362760,6064488,298272
2007-09-01,Tennessee,4773950,3043398,2896840,146558
2007-09-01,Texas,17464661,11459823,10960290,499533
2007-09-01,Utah,1900303,1383625,1346964,36661
2007-09-01,Vermont,502894,352038,338053,13985
2007-09-01,Virginia,5872564,4052349,3915752,136597
2007-09-01,Washington,5024250,3417771,3258296,159475
2007-09-01,Wisconsin,4365543,3090646,2938383,152263
2007-09-01,Wyoming,405178,291994,283956,8038
2007-10-01,Alabama,3568596,2181628,2088944,92684
2007-10-01,Alaska,497450,351277,329175,22102
2007-10-01,Arizona,4795667,3026157,2910471,115686
2007-10-01,Arkansas,2172797,1352032,1278323,73709
2007-10-01,California,27367418,17993950,16976329,1017621
2007-10-01,Colorado,3715036,2714544,2606543,108001
2007-10-01,Connecticut,2713317,1862997,1776872,86125
2007-10-01,Delaware,671234,446439,430080,16359
2007-10-01,Florida,14386906,9135500,8795668,339832
2007-10-01,Georgia,7115031,4836836,4589565,247271
2007-10-01,Hawaii,970511,636095,617035,19060
2007-10-01,Idaho,1119585,757432,732664,24768
2007-10-01,Illinois,9765252,6687735,6322851,364884
2007-10-01,Indiana,4848744,3204215,3051752,152463
2007-10-01,Iowa,2310605,1665743,1603116,62627
2007-10-01,Kansas,2101341,1487983,1423641,64342
2007-10-01,Kentucky,3284212,2030463,1919867,110596
2007-10-01,Louisiana,3312952,2032731,1952978,79753
2007-10-01,Maine,1058844,699588,666019,33569
2007-10-01,Maryland,4335243,2997232,2887521,109711
2007-10-01,Massachusetts,5149281,3434433,3279271,155162
2007-10-01,Michigan,7777378,4983547,4619463,364084
2007-10-01,Minnesota,4025298,2897040,2758855,138185
2007-10-01,Mississippi,2176634,1299111,1220565,78546
2007-10-01,Missouri,4546601,3064788,2900818,163970
2007-10-01,Montana,753561,508080,488870,19210
2007-10-01,Nebraska,1345387,982695,953057,29638
2007-10-01,Nevada,1952165,1355515,1288393,67122
2007-10-01,Ohio,8911693,6016279,5671830,344449
2007-10-01,Oklahoma,2724649,1723543,1657137,66406
2007-10-01,Oregon,2940386,1918769,1815958,102811
2007-10-01,Pennsylvania,9849346,6373535,6070703,302832
2007-10-01,Tennessee,4779666,3046663,2894542,152121
2007-10-01,Texas,17495067,11484031,10981282,502749
2007-10-01,Utah,1904011,1385953,1348475,37478
2007-10-01,Vermont,503126,351966,337926,14040
2007-10-01,Virginia,5878751,4062269,3921492,140777
2007-10-01,Washington,5031493,3426353,3266024,160329
2007-10-01,Wisconsin,4368458,3091929,2940541,151388
2007-10-01,Wyoming,405800,292498,284587,7911
2007-11-01,Alabama,3571609,2182775,2088237,94538
2007-11-01,Alaska,497891,351710,329677,22033
2007-11-01,Arizona,4804966,3033968,2912955,121013
2007-11-01,Arkansas,2174594,1352941,1280515,72426
2007-11-01,California,27397478,18015561,16980264,1035297
2007-11-01,Colorado,3721443,2721095,2610602,110493
2007-11-01,Connecticut,2715153,1865712,1778299,87413
2007-11-01,Delaware,672135,447478,430714,16764
2007-11-01,Florida,14399166,9148193,8793740,354453
2007-11-01,Georgia,7125436,4846765,4594075,252690
2007-11-01,Hawaii,971191,637526,618088,19438
2007-11-01,Idaho,1121480,756280,731723,24557
2007-11-01,Illinois,9771394,6697912,6327482,370430
2007-11-01,Indiana,4852139,3211460,3058115,153345
2007-11-01,Iowa,2311802,1667996,1605547,62449
2007-11-01,Kansas,2102572,1488571,1424075,64496
2007-11-01,Kentucky,3287457,2029895,1919969,109926
2007-11-01,Louisiana,3318199,2038038,1957597,80441
2007-11-01,Maine,1059364,700420,667037,33383
2007-11-01,Maryland,4337998,3000787,2892173,108614
2007-11-01,Massachusetts,5153707,3437265,3281811,155454
2007-11-01,Michigan,7777233,4978443,4615704,362739
2007-11-01,Minnesota,4028498,2896893,2758896,137997
2007-11-01,Mississippi,2178005,1301574,1222882,78692
2007-11-01,Missouri,4550492,3065589,2900868,164721
2007-11-01,Montana,754430,508950,489629,19321
2007-11-01,Nebraska,1346253,983488,954064,29424
2007-11-01,Nevada,1955382,1358745,1289934,68811
2007-11-01,Ohio,8914436,6016931,5673416,343515
2007-11-01,Oklahoma,2726950,1724548,1660213,64335
2007-11-01,Oregon,2944204,1922205,1819994,102211
2007-11-01,Pennsylvania,9854658,6382502,6076768,305734
2007-11-01,Tennessee,4785177,3048534,2891923,156611
2007-11-01,Texas,17525088,11508120,11004022,504098
2007-11-01,Utah,1907684,1387937,1349690,38247
2007-11-01,Vermont,503341,351983,337899,14084
2007-11-01,Virginia,5884697,4071799,3927530,144269
2007-11-01,Washington,5038548,3434198,3274082,160116
2007-11-01,Wisconsin,4371156,3092492,2943825,148667
2007-11-01,Wyoming,406411,293057,285260,7797
2007-12-01,Alabama,3574475,2183086,2086564,96522
2007-12-01,Alaska,498284,352134,330190,21944
2007-12-01,Arizona,4813893,3041613,2915755,125858
2007-12-01,Arkansas,2176232,1353447,1282727,70720
2007-12-01,California,27425922,18032573,16982149,1050424
2007-12-01,Colorado,3727619,2726104,2613895,112209
2007-12-01,Connecticut,2716819,1867928,1779384,88544
2007-12-01,Delaware,672993,448554,431428,17126
2007-12-01,Florida,14410520,9159259,8789788,369471
2007-12-01,Georgia,7135470,4856726,4598040,258686
2007-12-01,Hawaii,971788,639094,619435,19659
2007-12-01,Idaho,1123263,754691,730659,24032
2007-12-01,Illinois,9776966,6705536,6332204,373332
2007-12-01,Indiana,4855240,3217636,3064296,153340
2007-12-01,Iowa,2312834,1670033,1608126,61907
2007-12-01,Kansas,2103675,1488603,1424446,64157
2007-12-01,Kentucky,3290467,2028679,1919790,108889
2007-12-01,Louisiana,3323283,2042821,1961120,81701
2007-12-01,Maine,1059861,701031,668042,32989
2007-12-01,Maryland,4340521,3003897,2896480,107417
2007-12-01,Massachusetts,5157761,3440566,3284993,155573
2007-12-01,Michigan,7776660,4970964,4611446,359518
2007-12-01,Minnesota,4031466,2896769,2759616,137153
2007-12-01,Mississippi,2179312,1303016,1224337,78679
2007-12-01,Missouri,4554148,3065251,2900324,164927
2007-12-01,Montana,755224,509732,490367,19365
2007-12-01,Nebraska,1347008,984217,955010,29207
2007-12-01,Nevada,1958465,1361625,1291127,70498
2007-12-01,Ohio,8916628,6016753,5675653,341100
2007-12-01,Oklahoma,2729061,1725382,1663681,61701
2007-12-01,Oregon,2947849,1924688,1824021,100667
2007-12-01,Pennsylvania,9859441,6390393,6083501,306892
2007-12-01,Tennessee,4790396,3049619,2889792,159827
2007-12-01,Texas,17553909,11531148,11027674,503474
2007-12-01,Utah,1911237,1389416,1350526,38890
2007-12-01,Vermont,503532,352068,337945,14123
2007-12-01,Virginia,5890286,4081055,3934313,146742
2007-12-01,Washington,5045286,3441083,3281863,159220
2007-12-01,Wisconsin,4373577,3092618,2948303,144315
2007-12-01,Wyoming,406998,293644,285941,7703
2008-01-01,Alabama,3577198,2182712,2083744,98968
2008-01-01,Alaska,498693,352640,330728,21912
2008-01-01,Arizona,4822624,3048650,2918156,130494
2008-01-01,Arkansas,2177814,1353678,1284620,69058
2008-01-01,California,27453421,18047064,16979728,1067336
2008-01-01,Colorado,3733587,2729192,2615692,113500
2008-01-01,Connecticut,2718370,1869605,1779846,89759
2008-01-01,Delaware,673835,449481,432002,17479
2008-01-01,Florida,14421176,9166494,8780743,385751
2008-01-01,Georgia,7145219,4866898,4601237,265661
2008-01-01,Hawaii,972401,640525,620658,19867
2008-01-01,Idaho,1125010,753003,729462,23541
2008-01-01,Illinois,9782110,6709673,6334043,375630
2008-01-01,Indiana,4858075,3222317,3068926,153391
2008-01-01,Iowa,2313758,1671514,1610160,61354
2008-01-01,Kansas,2104656,1488330,1424783,63547
2008-01-01,Kentucky,3293294,2027269,1919001,108268
2008-01-01,Louisiana,3328228,2046613,1963488,83125
2008-01-01,Maine,1060238,701344,668746,32598
2008-01-01,Maryland,4342905,3006981,2899910,107071
2008-01-01,Massachusetts,5161571,3443336,3287272,156064
2008-01-01,Michigan,7775722,4962050,4604930,357120
2008-01-01,Minnesota,4034155,2896805,2760194,136611
2008-01-01,Mississippi,2180462,1303465,1224659,78806
2008-01-01,Missouri,4557530,3064242,2899013,165229
2008-01-01,Montana,755967,510364,490873,19491
2008-01-01,Nebraska,1347708,984852,955811,29041
2008-01-01,Nevada,1961491,1364101,1291670,72431
2008-01-01,Ohio,8918397,6014754,5675960,338794
2008-01-01,Oklahoma,2731019,1726265,1667262,59003
2008-01-01,Oregon,2951299,1925863,1827073,98790
2008-01-01,Pennsylvania,9863659,6397499,6090155,307344
2008-01-01,Tennessee,4795355,3050278,2887750,162528
2008-01-01,Texas,17582139,11551722,11049469,502253
2008-01-01,Utah,1914712,1390196,1350736,39460
2008-01-01,Vermont,503680,352192,337980,14212
2008-01-01,Virginia,5895643,4089713,3941102,148611
2008-01-01,Washington,5051757,3446781,3288083,158698
2008-01-01,Wisconsin,4375769,3092444,2952857,139587
2008-01-01,Wyoming,407544,294176,286531,7645
2008-02-01,Alabama,3579499,2182002,2079970,102032
2008-02-01,Alaska,499046,353200,331231,21969
2008-02-01,Arizona,4830910,3055250,2919912,135338
2008-02-01,Arkansas,2179102,1353823,1286093,67730
2008-02-01,California,27479147,18061461,16972015,1089446
2008-02-01,Colorado,3739334,2730710,2615827,114883
2008-02-01,Connecticut,2719672,1871046,1779792,91254
2008-02-01,Delaware,674570,450124,432276,17848
2008-02-01,Florida,14430272,9169252,8765562,403690
2008-02-01,Georgia,7154305,4877596,4604149,273447
2008-02-01,Hawaii,972875,641682,621470,20212
2008-02-01,Idaho,1126616,751556,728191,23365
2008-02-01,Illinois,9786404,6708900,6329578,379322
2008-02-01,Indiana,4860492,3225717,3071079,154638
2008-02-01,Iowa,2314422,1672496,1611271,61225
2008-02-01,Kansas,2105468,1488077,1425145,62932
2008-02-01,Kentucky,3295867,2026297,1917658,108639
2008-02-01,Louisiana,3332810,2049281,1964932,84349
2008-02-01,Maine,1060512,701507,669081,32426
2008-02-01,Maryland,4344772,3010368,2902178,108190
2008-02-01,Massachusetts,5164974,3445463,3288107,157356
2008-02-01,Michigan,7773898,4952602,4595514,357088
2008-02-01,Minnesota,4036544,2897217,2760058,137159
2008-02-01,Mississippi,2181475,1302924,1223753,79171
2008-02-01,Missouri,4560490,3063107,2897024,166083
2008-02-01,Montana,756618,510816,491021,19795
2008-02-01,Nebraska,1348302,985443,956411,29032
2008-02-01,Nevada,1964358,1366231,1291488,74743
2008-02-01,Ohio,8919307,6011252,5672357,338895
2008-02-01,Oklahoma,2732742,1727384,1670591,56793
2008-02-01,Oregon,2954500,1926271,1828799,97472
2008-02-01,Pennsylvania,9866910,6403801,6095607,308194
2008-02-01,Tennessee,4799873,3050932,2884998,165934
2008-02-01,Texas,17609205,11569544,11068110,501434
2008-02-01,Utah,1918073,1390331,1350305,40026
2008-02-01,Vermont,503793,352351,337975,14376
2008-02-01,Virginia,5900482,4097974,3947359,150615
2008-02-01,Washington,5057807,3451561,3292130,159431
2008-02-01,Wisconsin,4377602,3092050,2956324,135726
2008-02-01,Wyoming,408100,294628,286996,7632
2008-03-01,Alabama,3582052,2181312,2075441,105871
2008-03-01,Alaska,499412,353867,331722,22145
2008-03-01,Arizona,4839400,3062260,2920981,141279
2008-03-01,Arkansas,2180553,1354111,1287098,67013
2008-03-01,California,27505162,18079489,16958869,1120620
2008-03-01,Colorado,3745254,2731524,2614588,116936
2008-03-01,Connecticut,2721142,1872549,1779225,93324
2008-03-01,Delaware,675366,450558,432198,18360
2008-03-01,Florida,14439993,9169367,8745057,424310
2008-03-01,Georgia,7163749,4889427,4607194,282233
2008-03-01,Hawaii,973332,642622,621796,20826
2008-03-01,Idaho,1128349,750634,726940,23694
2008-03-01,Illinois,9791250,6703482,6317160,386322
2008-03-01,Indiana,4863316,3229511,3071330,158181
2008-03-01,Iowa,2315303,1673699,1611773,61926
2008-03-01,Kansas,2106418,1488306,1425587,62719
2008-03-01,Kentucky,3298681,2026753,1916245,110508
2008-03-01,Louisiana,3337626,2051196,1966079,85117
2008-03-01,Maine,1060902,701834,669166,32668
2008-03-01,Maryland,4346938,3014563,2903324,111239
2008-03-01,Massachusetts,5168747,3448080,3288084,159996
2008-03-01,Michigan,7772766,4943787,4583166,360621
2008-03-01,Minnesota,4039257,2898610,2759179,139431
2008-03-01,Mississippi,2182554,1301731,1221681,80050
2008-03-01,Missouri,4563774,3062698,2894477,168221
2008-03-01,Montana,757375,511130,490799,20331
2008-03-01,Nebraska,1348963,986086,956801,29285
2008-03-01,Nevada,1967341,1368224,1290616,77608
2008-03-01,Ohio,8920917,6008457,5664400,344057
2008-03-01,Oklahoma,2734661,1729075,1673464,55611
2008-03-01,Oregon,2957914,1927307,1829599,97708
2008-03-01,Pennsylvania,9870932,6410873,6099944,310929
2008-03-01,Tennessee,4804746,3052029,2881036,170993
2008-03-01,Texas,17636630,11587968,11084171,503797
2008-03-01,Utah,1921544,1390054,1349332,40722
2008-03-01,Vermont,503985,352567,337934,14633
2008-03-01,Virginia,5905631,4106722,3952938,153784
2008-03-01,Washington,5064189,3456754,3294563,162191
2008-03-01,Wisconsin,4379735,3091763,2957863,133900
2008-03-01,Wyoming,408662,295041,287354,7687
2008-04-01,Alabama,3584693,2180544,2070085,110459
2008-04-01,Alaska,499825,354642,332225,22417
2008-04-01,Arizona,4848008,3070618,2921370,149248
2008-04-01,Arkansas,2182082,1354740,1287626,67114
2008-04-01,California,27532092,18102490,16940096,1162394
2008-04-01,Colorado,3751342,2732182,2612373,119809
2008-04-01,Connecticut,2722664,1874146,1778038,96108
2008-04-01,Delaware,676171,450833,431703,19130
2008-04-01,Florida,14449961,9168749,8720582,448167
2008-04-01,Georgia,7173457,4902145,4609997,292148
2008-04-01,Hawaii,973900,643304,621515,21789
2008-04-01,Idaho,1130104,756944,725740,31204
2008-04-01,Illinois,9796390,6694126,6297079,397047
2008-04-01,Indiana,4866256,3234611,3070463,164148
2008-04-01,Iowa,2316272,1675641,1612124,63517
2008-04-01,Kansas,2107403,1489101,1425930,63171
2008-04-01,Kentucky,3301623,2028938,1914843,114095
2008-04-01,Louisiana,3342530,2053498,1967590,85908
2008-04-01,Maine,1061310,702403,669018,33385
2008-04-01,Maryland,4349192,3019372,2903305,116067
2008-04-01,Massachusetts,5172601,3451857,3287651,164206
2008-04-01,Michigan,7771825,4936116,4568466,367650
2008-04-01,Minnesota,4042105,2901263,2757878,143385
2008-04-01,Mississippi,2183705,1300119,1218522,81597
2008-04-01,Missouri,4567221,3063138,2891182,171956
2008-04-01,Montana,758116,511411,490311,21100
2008-04-01,Nebraska,1349702,986716,956899,29817
2008-04-01,Nevada,1970300,1370126,1289063,81063
2008-04-01,Ohio,8922741,6007620,5652710,354910
2008-04-01,Oklahoma,2736623,1731478,1675777,55701
2008-04-01,Oregon,2961357,1930010,1829951,100059
2008-04-01,Pennsylvania,9875143,6419243,6103469,315774
2008-04-01,Tennessee,4809741,3053781,2875899,177882
2008-04-01,Texas,17664569,11609646,11098012,511634
2008-04-01,Utah,1925126,1389475,1347866,41609
2008-04-01,Vermont,504134,352841,337854,14987
2008-04-01,Virginia,5910973,4116032,3957470,158562
2008-04-01,Washington,5070675,3463341,3296358,166983
2008-04-01,Wisconsin,4381983,3091788,2957241,134547
2008-04-01,Wyoming,409212,295452,287625,7827
2008-05-01,Alabama,3587446,2179601,2063894,115707
2008-05-01,Alaska,500225,355376,332635,22741
2008-05-01,Arizona,4856783,3080677,2921270,159407
2008-05-01,Arkansas,2183726,1355970,1287961,68009
2008-05-01,California,27559044,18131133,16917726,1213407
2008-05-01,Colorado,3757482,2733114,2609574,123540
2008-05-01,Connecticut,2724259,1875861,1776383,99478
2008-05-01,Delaware,677046,450971,430805,20166
2008-05-01,Florida,14460689,9169161,8694289,474872
2008-05-01,Georgia,7183238,4915122,4611993,303129
2008-05-01,Hawaii,974398,643618,620551,23067
2008-05-01,Idaho,1131924,760351,724589,35762
2008-05-01,Illinois,9801672,6681135,6270759,410376
2008-05-01,Indiana,4869426,3241131,3069326,171805
2008-05-01,Iowa,2317378,1678567,1612887,65680
2008-05-01,Kansas,2108535,1490277,1425962,64315
2008-05-01,Kentucky,3304688,2032389,1913311,119078
2008-05-01,Louisiana,3347495,2057291,1969706,87585
2008-05-01,Maine,1061827,703056,668592,34464
2008-05-01,Maryland,4351442,3024091,2902061,122030
2008-05-01,Massachusetts,5176718,3457054,3287296,169758
2008-05-01,Michigan,7771115,4929420,4552402,377018
2008-05-01,Minnesota,4045132,2905299,2756987,148312
2008-05-01,Mississippi,2184868,1298265,1214621,83644
2008-05-01,Missouri,4570847,3063984,2886999,176985
2008-05-01,Montana,758910,511776,489740,22036
2008-05-01,Nebraska,1350512,987230,956699,30531
2008-05-01,Nevada,1973333,1371914,1286907,85007
2008-05-01,Ohio,8924889,6009324,5639316,370008
2008-05-01,Oklahoma,2738669,1734689,1677856,56833
2008-05-01,Oregon,2965016,1935049,1830610,104439
2008-05-01,Pennsylvania,9879825,6428978,6106957,322021
2008-05-01,Tennessee,4814888,3056689,2870663,186026
2008-05-01,Texas,17692809,11635536,11109993,525543
2008-05-01,Utah,1928810,1388638,1345995,42643
2008-05-01,Vermont,504303,353179,337781,15398
2008-05-01,Virginia,5916469,4125461,3960901,164560
2008-05-01,Washington,5077412,3470993,3297939,173054
2008-05-01,Wisconsin,4384483,3092342,2955027,137315
2008-05-01,Wyoming,409806,295913,287868,8045
2008-06-01,Alabama,3590424,2178622,2057140,121482
2008-06-01,Alaska,500654,355922,332865,23057
2008-06-01,Arizona,4865847,3092028,2921092,170936
2008-06-01,Arkansas,2185440,1357843,1288251,69592
2008-06-01,California,27587706,18164654,16894388,1270266
2008-06-01,Colorado,3763867,2734443,2606433,128010
2008-06-01,Connecticut,2726025,1877881,1774721,103160
2008-06-01,Delaware,677885,451055,429649,21406
2008-06-01,Florida,14472206,9171233,8667892,503341
2008-06-01,Georgia,7193494,4928114,4612997,315117
2008-06-01,Hawaii,974980,643567,619036,24531
2008-06-01,Idaho,1133789,762381,723505,38876
2008-06-01,Illinois,9807583,6665433,6241078,424355
2008-06-01,Indiana,4872865,3248295,3068270,180025
2008-06-01,Iowa,2318576,1682183,1614205,67978
2008-06-01,Kansas,2109796,1491760,1425746,66014
2008-06-01,Kentucky,3307933,2036392,1911585,124807
2008-06-01,Louisiana,3352675,2062672,1971996,90676
2008-06-01,Maine,1062361,703584,667838,35746
2008-06-01,Maryland,4354007,3028390,2899785,128605
2008-06-01,Massachusetts,5181107,3463575,3287364,176211
2008-06-01,Michigan,7770857,4923379,4535828,387551
2008-06-01,Minnesota,4048438,2910820,2757296,153524
2008-06-01,Mississippi,2186207,1296313,1210483,85830
2008-06-01,Missouri,4574724,3064984,2882201,182783
2008-06-01,Montana,759760,512294,489229,23065
2008-06-01,Nebraska,1351414,987667,956407,31260
2008-06-01,Nevada,1976466,1373585,1284291,89294
2008-06-01,Ohio,8927562,6012507,5625793,386714
2008-06-01,Oklahoma,2740965,1738601,1679997,58604
2008-06-01,Oregon,2968804,1942229,1831696,110533
2008-06-01,Pennsylvania,9885062,6439771,6110512,329259
2008-06-01,Tennessee,4820351,3060667,2866212,194455
2008-06-01,Texas,17722244,11666163,11121171,544992
2008-06-01,Utah,1932599,1387616,1343861,43755
2008-06-01,Vermont,504558,353581,337764,15817
2008-06-01,Virginia,5922288,4134305,3963346,170959
2008-06-01,Washington,5084384,3478758,3299349,179409
2008-06-01,Wisconsin,4387249,3093969,2952277,141692
2008-06-01,Wyoming,410427,296475,288145,8330
2008-07-01,Alabama,3593293,2177334,2049897,127437
2008-07-01,Alaska,501082,356199,332941,23258
2008-07-01,Arizona,4874841,3103708,2920905,182803
2008-07-01,Arkansas,2187167,1359733,1288132,71601
2008-07-01,California,27615732,18198631,16869967,1328664
2008-07-01,Colorado,3770226,2735689,2603060,132629
2008-07-01,Connecticut,2727747,1879919,1773119,106800
2008-07-01,Delaware,678769,451063,428337,22726
2008-07-01,Florida,14483564,9172784,8640817,531967
2008-07-01,Georgia,7203540,4940633,4612633,328000
2008-07-01,Hawaii,975546,643139,617129,26010
2008-07-01,Idaho,1135675,763509,722338,41171
2008-07-01,Illinois,9813237,6647982,6211153,436829
2008-07-01,Indiana,4876173,3254256,3066171,188085
2008-07-01,Iowa,2319771,1685651,1615698,69953
2008-07-01,Kansas,2110980,1493312,1425477,67835
2008-07-01,Kentucky,3311128,2040031,1909387,130644
2008-07-01,Louisiana,3357744,2068708,1973844,94864
2008-07-01,Maine,1062884,703689,666608,37081
2008-07-01,Maryland,4356418,3031959,2896505,135454
2008-07-01,Massachusetts,5185422,3470637,3287628,183009
2008-07-01,Michigan,7770438,4916694,4517863,398831
2008-07-01,Minnesota,4051642,2916961,2758679,158282
2008-07-01,Mississippi,2187453,1293981,1206270,87711
2008-07-01,Missouri,4578539,3065820,2876896,188924
2008-07-01,Montana,760598,512944,488842,24102
2008-07-01,Nebraska,1352261,988067,956138,31929
2008-07-01,Nevada,1979594,1375054,1281173,93881
2008-07-01,Ohio,8930028,6014218,5612464,401754
2008-07-01,Oklahoma,2743144,1742674,1682136,60538
2008-07-01,Oregon,2972578,1950173,1832417,117756
2008-07-01,Pennsylvania,9890101,6450249,6112981,337268
2008-07-01,Tennessee,4825694,3064883,2862683,202200
2008-07-01,Texas,17751353,11698046,11131376,566670
2008-07-01,Utah,1936350,1386267,1341399,44868
2008-07-01,Vermont,504770,353970,337768,16202
2008-07-01,Virginia,5927975,4141385,3964430,176955
2008-07-01,Washington,5091309,3485255,3300237,185018
2008-07-01,Wisconsin,4389936,3096523,2949524,146999
2008-07-01,Wyoming,411048,297099,288449,8650
2008-08-01,Alabama,3596204,2175532,2041980,133552
2008-08-01,Alaska,502170,356256,332935,23321
2008-08-01,Arizona,4882204,3114501,2920241,194260
2008-08-01,Arkansas,2188840,1360944,1287008,73936
2008-08-01,California,27647757,18229614,16841893,1387721
2008-08-01,Colorado,3776709,2736631,2599477,137154
2008-08-01,Connecticut,2729782,1881524,1771270,110254
2008-08-01,Delaware,679481,450915,426883,24032
2008-08-01,Florida,14494359,9170735,8610848,559887
2008-08-01,Georgia,7212743,4952285,4610521,341764
2008-08-01,Hawaii,976125,642316,614884,27432
2008-08-01,Idaho,1137065,763961,720883,43078
2008-08-01,Illinois,9820037,6630290,6183599,446691
2008-08-01,Indiana,4879459,3257956,3061005,196951
2008-08-01,Iowa,2321258,1688328,1616614,71714
2008-08-01,Kansas,2112793,1494865,1425260,69605
2008-08-01,Kentucky,3312948,2042938,1906189,136749
2008-08-01,Louisiana,3360884,2074146,1974665,99481
2008-08-01,Maine,1063209,703231,664756,38475
2008-08-01,Maryland,4360469,3034819,2892074,142745
2008-08-01,Massachusetts,5190727,3477120,3287107,190013
2008-08-01,Michigan,7771436,4908296,4496904,411392
2008-08-01,Minnesota,4054892,2922523,2760026,162497
2008-08-01,Mississippi,2188782,1291079,1201959,89120
2008-08-01,Missouri,4581836,3066259,2870988,195271
2008-08-01,Montana,761268,513563,488397,25166
2008-08-01,Nebraska,1353373,988463,955768,32695
2008-08-01,Nevada,1981608,1376217,1277347,98870
2008-08-01,Ohio,8933289,6011816,5598120,413696
2008-08-01,Oklahoma,2746239,1746499,1683945,62554
2008-08-01,Oregon,2976099,1957311,1831635,125676
2008-08-01,Pennsylvania,9895782,6458730,6112327,346403
2008-08-01,Tennessee,4829913,3068290,2859187,209103
2008-08-01,Texas,17783166,11727305,11139202,588103
2008-08-01,Utah,1939685,1384255,1338357,45898
2008-08-01,Vermont,505023,354246,337699,16547
2008-08-01,Virginia,5934957,4145890,3963418,182472
2008-08-01,Washington,5099238,3489319,3299643,189676
2008-08-01,Wisconsin,4392873,3099708,2946571,153137
2008-08-01,Wyoming,411744,297673,288702,8971
2008-09-01,Alabama,3598993,2173629,2033141,140488
2008-09-01,Alaska,503222,356278,332909,23369
2008-09-01,Arizona,4889372,3123387,2917994,205393
2008-09-01,Arkansas,2190470,1361416,1284515,76901
2008-09-01,California,27679019,18257580,16805122,1452458
2008-09-01,Colorado,3783064,2737389,2595132,142257
2008-09-01,Connecticut,2731705,1882648,1768820,113828
2008-09-01,Delaware,680178,450618,425254,25364
2008-09-01,Florida,14504739,9162508,8574307,588201
2008-09-01,Georgia,7221664,4800201,4442850,357351
2008-09-01,Hawaii,976705,641210,612280,28930
2008-09-01,Idaho,1138405,764150,718961,45189
2008-09-01,Illinois,9826546,6614614,6158416,456198
2008-09-01,Indiana,4882575,3259403,3050821,208582
2008-09-01,Iowa,2322671,1689996,1616033,73963
2008-09-01,Kansas,2114526,1496707,1424974,71733
2008-09-01,Kentucky,3314652,2045566,1901351,144215
2008-09-01,Louisiana,3363894,2078215,1974007,104208
2008-09-01,Maine,1063497,702387,662212,40175
2008-09-01,Maryland,4364380,3037478,2886085,151393
2008-09-01,Massachusetts,5195775,3481923,3284012,197911
2008-09-01,Michigan,7772172,4898438,4471729,426709
2008-09-01,Minnesota,4058030,2926961,2759427,167534
2008-09-01,Mississippi,2190044,1287989,1197500,90489
2008-09-01,Missouri,4584996,3066669,2864204,202465
2008-09-01,Montana,761925,513902,487527,26375
2008-09-01,Nebraska,1354435,988765,955119,33646
2008-09-01,Nevada,1983560,1377125,1272537,104588
2008-09-01,Ohio,8936246,6004979,5579973,425006
2008-09-01,Oklahoma,2749269,1749749,1684673,65076
2008-09-01,Oregon,2979483,1962925,1828177,134748
2008-09-01,Pennsylvania,9901160,6465072,6106294,358778
2008-09-01,Tennessee,4834013,3070328,2854164,216164
2008-09-01,Texas,17814485,11751993,11141801,610192
2008-09-01,Utah,1942966,1381301,1334384,46917
2008-09-01,Vermont,505257,354355,337442,16913
2008-09-01,Virginia,5941756,4147911,3959244,188667
2008-09-01,Washington,5106981,3490731,3296178,194553
2008-09-01,Wisconsin,4395671,3103711,2942506,161205
2008-09-01,Wyoming,412444,298023,288770,9253
2008-10-01,Alabama,3601896,2172322,2023364,148958
2008-10-01,Alaska,504284,356381,332820,23561
2008-10-01,Arizona,4896695,3129730,2912892,216838
2008-10-01,Arkansas,2192094,1361363,1280596,80767
2008-10-01,California,27710666,18283764,16755408,1528356
2008-10-01,Colorado,3789510,2738037,2589291,148746
2008-10-01,Connecticut,2733733,1883668,1765753,117915
2008-10-01,Delaware,680882,450134,423297,26837
2008-10-01,Florida,14515421,9143874,8528323,615551
2008-10-01,Georgia,7230835,4763216,4387423,375793
2008-10-01,Hawaii,977292,639971,609289,30682
2008-10-01,Idaho,1139803,764450,716492,47958
2008-10-01,Illinois,9833265,6602533,6133051,469482
2008-10-01,Indiana,4885822,3259393,3034749,224644
2008-10-01,Iowa,2324167,1690958,1613479,77479
2008-10-01,Kansas,2116326,1498893,1424409,74484
2008-10-01,Kentucky,3316457,2048791,1894862,153929
2008-10-01,Louisiana,3366976,2080286,1971443,108843
2008-10-01,Maine,1063777,701476,659005,42471
2008-10-01,Maryland,4368415,3040575,2878435,162140
2008-10-01,Massachusetts,5200987,3484355,3276874,207481
2008-10-01,Michigan,7773056,4887718,4442055,445663
2008-10-01,Minnesota,4061267,2930202,2755312,174890
2008-10-01,Mississippi,2191391,1285225,1192839,92386
2008-10-01,Missouri,4588232,3067640,2856334,211306
2008-10-01,Montana,762562,513700,485834,27866
2008-10-01,Nebraska,1355531,988947,954101,34846
2008-10-01,Nevada,1985545,1377911,1266591,111320
2008-10-01,Ohio,8939361,5995207,5556150,439057
2008-10-01,Oklahoma,2752323,1752645,1683793,68852
2008-10-01,Oregon,2982987,1966958,1821021,145937
2008-10-01,Pennsylvania,9906713,6469954,6093486,376468
2008-10-01,Tennessee,4838191,3070955,2846010,224945
2008-10-01,Texas,17846170,11771507,11136874,634633
2008-10-01,Utah,1946306,1377244,1329258,47986
2008-10-01,Vermont,505508,355352,337955,17397
2008-10-01,Virginia,5948680,4148057,3951093,196964
2008-10-01,Washington,5114846,3490210,3288871,201339
2008-10-01,Wisconsin,4398555,3108572,2935774,172798
2008-10-01,Wyoming,413128,298085,288534,9551
2008-11-01,Alabama,3604408,2171630,2012593,159037
2008-11-01,Alaska,505353,356617,332618,23999
2008-11-01,Arizona,4903496,3133420,2904315,229105
2008-11-01,Arkansas,2193563,1361045,1275604,85441
2008-11-01,California,27740241,18307599,16691191,1616408
2008-11-01,Colorado,3795646,2738762,2581484,157278
2008-11-01,Connecticut,2735434,1884613,1761893,122720
2008-11-01,Delaware,681538,449376,420891,28485
2008-11-01,Florida,14524347,9117676,8472472,645204
2008-11-01,Georgia,7239404,4761050,4364135,396915
2008-11-01,Hawaii,977913,638587,605845,32742
2008-11-01,Idaho,1141084,764784,713504,51280
2008-11-01,Illinois,9839056,6594077,6104242,489835
2008-11-01,Indiana,4888584,3258489,3013159,245330
2008-11-01,Iowa,2325378,1691223,1608748,82475
2008-11-01,Kansas,2117869,1501360,1423372,77988
2008-11-01,Kentucky,3317952,2052892,1886996,165896
2008-11-01,Louisiana,3369760,2080055,1966607,113448
2008-11-01,Maine,1063982,700719,655292,45427
2008-11-01,Maryland,4372021,3044184,2869411,174773
2008-11-01,Massachusetts,5205636,3484329,3265439,218890
2008-11-01,Michigan,7773150,4876390,4409115,467275
2008-11-01,Minnesota,4064091,2932497,2747372,185125
2008-11-01,Mississippi,2192508,1282861,1187659,95202
2008-11-01,Missouri,4591041,3069076,2847323,221753
2008-11-01,Montana,763186,512832,483179,29653
2008-11-01,Nebraska,1356466,988981,952612,36369
2008-11-01,Nevada,1987408,1378359,1259504,118855
2008-11-01,Ohio,8941524,5983594,5525376,458218
2008-11-01,Oklahoma,2755121,1755374,1680966,74408
2008-11-01,Oregon,2986162,1969619,1809879,159740
2008-11-01,Pennsylvania,9911055,6472379,6072949,399430
2008-11-01,Tennessee,4841978,3069508,2832943,236565
2008-11-01,Texas,17876599,11784834,11123092,661742
2008-11-01,Utah,1949504,1371962,1322915,49047
2008-11-01,Vermont,505734,356228,338176,18052
2008-11-01,Virginia,5955076,4146700,3938595,208105
2008-11-01,Washington,5122196,3488288,3277136,211152
2008-11-01,Wisconsin,4401027,3113762,2924909,188853
2008-11-01,Wyoming,413791,298010,287926,10084
2008-12-01,Alabama,3606592,2171169,2001037,170132
2008-12-01,Alaska,506307,357004,332312,24692
2008-12-01,Arizona,4909739,3135110,2892889,242221
2008-12-01,Arkansas,2194791,1360662,1270115,90547
2008-12-01,California,27766504,18327303,16614367,1712936
2008-12-01,Colorado,3801345,2739993,2572099,167894
2008-12-01,Connecticut,2736850,1885195,1757045,128150
2008-12-01,Delaware,682121,448368,418100,30268
2008-12-01,Florida,14531697,9086029,8409554,676475
2008-12-01,Georgia,7247260,4768790,4349635,419155
2008-12-01,Hawaii,978390,637096,602094,35002
2008-12-01,Idaho,1142231,764905,710176,54729
2008-12-01,Illinois,9843756,6589361,6071369,517992
2008-12-01,Indiana,4890861,3257127,2987719,269408
2008-12-01,Iowa,2326326,1690582,1602026,88556
2008-12-01,Kansas,2119222,1504198,1421825,82373
2008-12-01,Kentucky,3319100,2057610,1878114,179496
2008-12-01,Louisiana,3372245,2078009,1959715,118294
2008-12-01,Maine,1064068,700292,651465,48827
2008-12-01,Maryland,4375176,3047840,2859476,188364
2008-12-01,Massachusetts,5209753,3482788,3251176,231612
2008-12-01,Michigan,7772501,4864371,4375398,488973
2008-12-01,Minnesota,4066483,2934202,2736774,197428
2008-12-01,Mississippi,2193422,1280995,1181857,99138
2008-12-01,Missouri,4593380,3070614,2837411,233203
2008-12-01,Montana,763677,511355,479767,31588
2008-12-01,Nebraska,1357295,988919,950668,38251
2008-12-01,Nevada,1989039,1378215,1251597,126618
2008-12-01,Ohio,8942768,5970422,5487378,483044
2008-12-01,Oklahoma,2757591,1758229,1676316,81913
2008-12-01,Oregon,2988988,1971578,1795993,175585
2008-12-01,Pennsylvania,9914426,6471599,6045617,425982
2008-12-01,Tennessee,4845237,3065036,2814331,250705
2008-12-01,Texas,17904835,11791925,11101977,689948
2008-12-01,Utah,1952476,1388245,1315656,72589
2008-12-01,Vermont,505873,357013,338155,18858
2008-12-01,Virginia,5960915,4144520,3922612,221908
2008-12-01,Washington,5129048,3485137,3261532,223605
2008-12-01,Wisconsin,4402985,3118667,2909875,208792
2008-12-01,Wyoming,414409,298049,287005,11044
2009-01-01,Alabama,3608960,2170615,1989308,181307
2009-01-01,Alaska,507364,357527,331939,25588
2009-01-01,Arizona,4916200,3135245,2879700,255545
2009-01-01,Arkansas,2196134,1360180,1264593,95587
2009-01-01,California,27794667,18341252,16530013,1811239
2009-01-01,Colorado,3807212,2741783,2561844,179939
2009-01-01,Connecticut,2738401,1885168,1751324,133844
2009-01-01,Delaware,682762,447205,415103,32102
2009-01-01,Florida,14539769,9052178,8343928,708250
2009-01-01,Georgia,7255557,4778508,4337640,440868
2009-01-01,Hawaii,978992,635569,598286,37283
2009-01-01,Idaho,1143426,764671,706733,57938
2009-01-01,Illinois,9849030,6588346,6037014,551332
2009-01-01,Indiana,4893292,3256297,2961664,294633
2009-01-01,Iowa,2327391,1689096,1594063,95033
2009-01-01,Kansas,2120640,1507169,1419811,87358
2009-01-01,Kentucky,3320357,2062601,1868875,193726
2009-01-01,Louisiana,3374902,2075125,1951613,123512
2009-01-01,Maine,1064171,700203,647898,52305
2009-01-01,Maryland,4378599,3051111,2849401,201710
2009-01-01,Massachusetts,5214072,3480717,3236069,244648
2009-01-01,Michigan,7772160,4875359,4342294,533065
2009-01-01,Minnesota,4068989,2935506,2725000,210506
2009-01-01,Mississippi,2194462,1279561,1175741,103820
2009-01-01,Missouri,4595874,3072024,2827112,244912
2009-01-01,Montana,764203,509478,476051,33427
2009-01-01,Nebraska,1358167,988763,948435,40328
2009-01-01,Nevada,1990788,1377435,1243320,134115
2009-01-01,Ohio,8944394,5956344,5444780,511564
2009-01-01,Oklahoma,2760215,1761587,1670671,90916
2009-01-01,Oregon,2991928,1973386,1781451,191935
2009-01-01,Pennsylvania,9918169,6467790,6014392,453398
2009-01-01,Tennessee,4848693,3057747,2791562,266185
2009-01-01,Texas,17934287,11794357,11077513,716844
2009-01-01,Utah,1955576,1392634,1307934,84700
2009-01-01,Vermont,506066,357735,337995,19740
2009-01-01,Virginia,5967043,4142432,3905221,237211
2009-01-01,Washington,5136093,3480693,3243615,237078
2009-01-01,Wisconsin,4405116,3122945,2892187,230758
2009-01-01,Wyoming,415020,298360,285891,12469
2009-02-01,Alabama,3611025,2169888,1978083,191805
2009-02-01,Alaska,508336,358159,331565,26594
2009-02-01,Arizona,4922302,3134718,2866239,268479
2009-02-01,Arkansas,2197249,1359814,1259658,100156
2009-02-01,California,27820364,18350557,16445664,1904893
2009-02-01,Colorado,3812882,2743809,2551450,192359
2009-02-01,Connecticut,2739720,1885022,1745553,139469
2009-02-01,Delaware,683309,445924,412069,33855
2009-02-01,Florida,14546500,9020030,8280792,739238
2009-02-01,Georgia,7263209,4787926,4326851,461075
2009-02-01,Hawaii,979422,634151,594807,39344
2009-02-01,Idaho,1144528,764044,703500,60544
2009-02-01,Illinois,9853542,6591950,6005570,586380
2009-02-01,Indiana,4895465,3255885,2937994,317891
2009-02-01,Iowa,2328279,1687015,1585947,101068
2009-02-01,Kansas,2121939,1510355,1417552,92803
2009-02-01,Kentucky,3321451,2067583,1860303,207280
2009-02-01,Louisiana,3377231,2072767,1943568,129199
2009-02-01,Maine,1064193,700270,644828,55442
2009-02-01,Maryland,4381626,3053799,2840168,213631
2009-02-01,Massachusetts,5218090,3478984,3221939,257045
2009-02-01,Michigan,7771192,4885037,4310659,574378
2009-02-01,Minnesota,4071329,2936857,2714157,222700
2009-02-01,Mississippi,2195299,1278354,1169822,108532
2009-02-01,Missouri,4598092,3073323,2817179,256144
2009-02-01,Montana,764676,507574,472644,34930
2009-02-01,Nebraska,1358954,988607,946270,42337
2009-02-01,Nevada,1992370,1376206,1235176,141030
2009-02-01,Ohio,8945406,5942920,5402230,540690
2009-02-01,Oklahoma,2762668,1765678,1665415,100263
2009-02-01,Oregon,2994706,1975379,1768747,206632
2009-02-01,Pennsylvania,9921186,6462229,5983557,478672
2009-02-01,Tennessee,4851827,3049266,2767661,281605
2009-02-01,Texas,17962241,11795821,11055073,740748
2009-02-01,Utah,1958558,1391346,1300274,91072
2009-02-01,Vermont,506207,358464,337853,20611
2009-02-01,Virginia,5972693,4141054,3888770,252284
2009-02-01,Washington,5142825,3474872,3225423,249449
2009-02-01,Wisconsin,4407013,3126622,2874456,252166
2009-02-01,Wyoming,415658,298950,284717,14233
2009-03-01,Alabama,3613034,2168962,1968035,200927
2009-03-01,Alaska,509304,358815,331287,27528
2009-03-01,Arizona,4928269,3134761,2854602,280159
2009-03-01,Arkansas,2198385,1359655,1255912,103743
2009-03-01,California,27845224,18357115,16370975,1986140
2009-03-01,Colorado,3818492,2745639,2541992,203647
2009-03-01,Connecticut,2741025,1885758,1741164,144594
2009-03-01,Delaware,683851,444546,409245,35301
2009-03-01,Florida,14553015,8993087,8226093,766994
2009-03-01,Georgia,7270704,4796410,4318122,478288
2009-03-01,Hawaii,979839,633015,592076,40939
2009-03-01,Idaho,1145653,763045,700851,62194
2009-03-01,Illinois,9857938,6599816,5981260,618556
2009-03-01,Indiana,4897589,3254065,2918351,335714
2009-03-01,Iowa,2329173,1684717,1578852,105865
2009-03-01,Kansas,2123219,1513752,1415542,98210
2009-03-01,Kentucky,3322520,2071976,1853366,218610
2009-03-01,Louisiana,3379507,2072027,1936935,135092
2009-03-01,Maine,1064236,700301,642493,57808
2009-03-01,Maryland,4384547,3055887,2832928,222959
2009-03-01,Massachusetts,5222100,3478298,3210588,267710
2009-03-01,Michigan,7770196,4893566,4282346,611220
2009-03-01,Minnesota,4073662,2938667,2706532,232135
2009-03-01,Mississippi,2196101,1277088,1164570,112518
2009-03-01,Missouri,4600232,3074303,2808736,265567
2009-03-01,Montana,765161,505944,470036,35908
2009-03-01,Nebraska,1359717,988641,944615,44026
2009-03-01,Nevada,1993918,1374816,1227786,147030
2009-03-01,Ohio,8946406,5931002,5364822,566180
2009-03-01,Oklahoma,2765042,1770364,1661702,108662
2009-03-01,Oregon,2997399,1977117,1759644,217473
2009-03-01,Pennsylvania,9924198,6455797,5956881,498916
2009-03-01,Tennessee,4854945,3041270,2746230,295040
2009-03-01,Texas,17989636,11799261,11040416,758845
2009-03-01,Utah,1961510,1387931,1293342,94589
2009-03-01,Vermont,506354,359307,337951,21356
2009-03-01,Virginia,5978215,4140763,3875758,265005
2009-03-01,Washington,5149512,3467544,3209014,258530
2009-03-01,Wisconsin,4408918,3129930,2859606,270324
2009-03-01,Wyoming,416274,299720,283647,16073
2009-04-01,Alabama,3615107,2167672,1959272,208400
2009-04-01,Alaska,510314,359404,331163,28241
2009-04-01,Arizona,4934381,3135697,2845709,289988
2009-04-01,Arkansas,2199548,1359293,1253369,105924
2009-04-01,California,27871138,18360253,16310052,2050201
2009-04-01,Colorado,3824191,2746627,2534133,212494
2009-04-01,Connecticut,2742384,1887457,1738492,148965
2009-04-01,Delaware,684422,443075,406789,36286
2009-04-01,Florida,14559741,8974062,8182726,791336
2009-04-01,Georgia,7278430,4803528,4311940,491588
2009-04-01,Hawaii,980298,632282,590308,41974
2009-04-01,Idaho,1146825,761716,698919,62797
2009-04-01,Illinois,9862551,6609226,5964724,644502
2009-04-01,Indiana,4899811,3249511,2903308,346203
2009-04-01,Iowa,2330117,1682539,1573692,108847
2009-04-01,Kansas,2124509,1517037,1414106,102931
2009-04-01,Kentucky,3323639,2074923,1848460,226463
2009-04-01,Louisiana,3381899,2072391,1932168,140223
2009-04-01,Maine,1064283,700192,640979,59213
2009-04-01,Maryland,4387555,3057218,2828165,229053
2009-04-01,Massachusetts,5226156,3478483,3202508,275975
2009-04-01,Michigan,7769346,4900321,4257967,642354
2009-04-01,Minnesota,4076031,2940298,2702508,237790
2009-04-01,Mississippi,2196932,1275427,1160113,115314
2009-04-01,Missouri,4602491,3074803,2802257,272546
2009-04-01,Montana,765637,504683,468374,36309
2009-04-01,Nebraska,1360520,989011,943699,45312
2009-04-01,Nevada,1995501,1373429,1221385,152044
2009-04-01,Ohio,8947541,5920506,5335602,584904
2009-04-01,Oklahoma,2767495,1774985,1659766,115219
2009-04-01,Oregon,3000182,1977826,1754553,223273
2009-04-01,Pennsylvania,9927312,6448142,5935194,512948
2009-04-01,Tennessee,4858086,3034647,2729517,305130
2009-04-01,Texas,18017597,11805364,11035746,769618
2009-04-01,Utah,1964512,1384192,1287412,96780
2009-04-01,Vermont,506480,359755,337870,21885
2009-04-01,Virginia,5983942,4141347,3867062,274285
2009-04-01,Washington,5156239,3467492,3195574,271918
2009-04-01,Wisconsin,4410843,3132217,2848985,283232
2009-04-01,Wyoming,416861,300461,282792,17669
2009-05-01,Alabama,3617361,2165514,1950906,214608
2009-05-01,Alaska,511330,359892,331161,28731
2009-05-01,Arizona,4940746,3136601,2838286,298315
2009-05-01,Arkansas,2200846,1358162,1251338,106824
2009-05-01,California,27897359,18356368,16257221,2099147
2009-05-01,Colorado,3830099,2745488,2527186,218302
2009-05-01,Connecticut,2743885,1889319,1736551,152768
2009-05-01,Delaware,684993,441440,404596,36844
2009-05-01,Florida,14567324,8990744,8148166,842578
2009-05-01,Georgia,7286426,4807998,4306652,501346
2009-05-01,Hawaii,980763,631952,589386,42566
2009-05-01,Idaho,1148040,765242,697495,67747
2009-05-01,Illinois,9867563,6616824,5952614,664210
2009-05-01,Indiana,4902376,3241440,2891493,349947
2009-05-01,Iowa,2331259,1680503,1570351,110152
2009-05-01,Kansas,2125995,1519576,1412960,106616
2009-05-01,Kentucky,3325013,2075708,1844941,230767
2009-05-01,Louisiana,3384370,2072526,1928778,143748
2009-05-01,Maine,1064444,699741,639964,59777
2009-05-01,Maryland,4390739,3057191,2824833,232358
2009-05-01,Massachusetts,5230561,3478354,3196305,282049
2009-05-01,Michigan,7768973,4904363,4236418,667945
2009-05-01,Minnesota,4078760,2940428,2700525,239903
2009-05-01,Mississippi,2197842,1272969,1155919,117050
2009-05-01,Missouri,4605119,3074117,2796764,277353
2009-05-01,Montana,766208,503645,467389,36256
2009-05-01,Nebraska,1361436,989500,943261,46239
2009-05-01,Nevada,1997181,1371955,1215496,156459
2009-05-01,Ohio,8949202,5910747,5313941,596806
2009-05-01,Oklahoma,2770103,1778265,1658576,119689
2009-05-01,Oregon,3003209,1976717,1752493,224224
2009-05-01,Pennsylvania,9931122,6437627,5916119,521508
2009-05-01,Tennessee,4861579,3029350,2717680,311670
2009-05-01,Texas,18046180,11933809,11037541,896268
2009-05-01,Utah,1967728,1380535,1282005,98530
2009-05-01,Vermont,506662,361124,338923,22201
2009-05-01,Virginia,5989932,4141603,3861057,280546
2009-05-01,Washington,5163366,3466388,3185132,281256
2009-05-01,Wisconsin,4413190,3131940,2841498,290442
2009-05-01,Wyoming,417505,300897,282070,18827
2009-06-01,Alabama,3619629,2162128,1942142,219986
2009-06-01,Alaska,512325,360268,331193,29075
2009-06-01,Arizona,4947208,3136757,2831102,305655
2009-06-01,Arkansas,2202154,1356219,1249384,106835
2009-06-01,California,27924313,18344271,16206712,2137559
2009-06-01,Colorado,3836067,2741685,2520583,221102
2009-06-01,Connecticut,2745421,1890959,1734700,156259
2009-06-01,Delaware,685612,439569,402469,37100
2009-06-01,Florida,14575145,8991320,8119224,872096
2009-06-01,Georgia,7294421,4809047,4300595,508452
2009-06-01,Hawaii,981229,631868,588993,42875
2009-06-01,Idaho,1149304,765973,696379,69594
2009-06-01,Illinois,9872670,6620584,5941437,679147
2009-06-01,Indiana,4904977,3229982,2881080,348902
2009-06-01,Iowa,2332447,1678718,1568344,110374
2009-06-01,Kansas,2127510,1520649,1411631,109018
2009-06-01,Kentucky,3326417,2074132,1841907,232225
2009-06-01,Louisiana,3386911,2071821,1926334,145487
2009-06-01,Maine,1064612,698904,639123,59781
2009-06-01,Maryland,4393922,3055637,2821735,233902
2009-06-01,Massachusetts,5235023,3477099,3190727,286372
2009-06-01,Michigan,7768604,4905950,4216979,688971
2009-06-01,Minnesota,4081532,2938602,2699072,239530
2009-06-01,Mississippi,2198782,1269700,1151486,118214
2009-06-01,Missouri,4607694,3071762,2791064,280698
2009-06-01,Montana,766762,502704,466739,35965
2009-06-01,Nebraska,1362376,989738,942897,46841
2009-06-01,Nevada,1998890,1370321,1209700,160621
2009-06-01,Ohio,8950933,5902027,5297717,604310
2009-06-01,Oklahoma,2772778,1779326,1657117,122209
2009-06-01,Oregon,3006279,1973627,1752128,221499
2009-06-01,Pennsylvania,9935005,6423159,5897683,525476
2009-06-01,Tennessee,4865073,3025629,2710361,315268
2009-06-01,Texas,18075211,11998393,11041350,957043
2009-06-01,Utah,1970908,1376948,1276697,100251
2009-06-01,Vermont,506890,360821,338444,22377
2009-06-01,Virginia,5995931,4140712,3855929,284783
2009-06-01,Washington,5170538,3464827,3176939,287888
2009-06-01,Wisconsin,4415500,3128053,2835423,292630
2009-06-01,Wyoming,418196,300868,281384,19484
2009-07-01,Alabama,3622181,2157556,1932774,224782
2009-07-01,Alaska,513402,360424,331095,29329
2009-07-01,Arizona,4953939,3135266,2823229,312037
2009-07-01,Arkansas,2203656,1353772,1247347,106425
2009-07-01,California,27952375,18323390,16154640,2168750
2009-07-01,Colorado,3842322,2735370,2513522,221848
2009-07-01,Connecticut,2747122,1891930,1732321,159609
2009-07-01,Delaware,686254,437522,400274,37248
2009-07-01,Florida,14583822,8985929,8092905,893024
2009-07-01,Georgia,7302994,4806283,4292715,513568
2009-07-01,Hawaii,981756,631704,588669,43035
2009-07-01,Idaho,1150638,765397,695387,70010
2009-07-01,Illinois,9878410,6618475,5927060,691415
2009-07-01,Indiana,4907917,3216060,2870731,345329
2009-07-01,Iowa,2333773,1676953,1566823,110130
2009-07-01,Kansas,2129150,1519761,1409610,110151
2009-07-01,Kentucky,3328074,2070370,1838771,231599
2009-07-01,Louisiana,3389686,2069984,1924210,145774
2009-07-01,Maine,1064870,697805,638257,59548
2009-07-01,Maryland,4397413,3052760,2818008,234752
2009-07-01,Massachusetts,5239849,3474026,3184659,289367
2009-07-01,Michigan,7768829,4881546,4199503,682043
2009-07-01,Minnesota,4084586,2935063,2697239,237824
2009-07-01,Mississippi,2199851,1266095,1146754,119341
2009-07-01,Missouri,4610651,3067274,2784144,283130
2009-07-01,Montana,767393,501734,466047,35687
2009-07-01,Nebraska,1363415,989444,942248,47196
2009-07-01,Nevada,2000720,1368177,1203710,164467
2009-07-01,Ohio,8953337,5894470,5283917,610553
2009-07-01,Oklahoma,2775621,1777772,1654657,123115
2009-07-01,Oregon,3009552,1969041,1752029,217012
2009-07-01,Pennsylvania,9939596,6403921,5878278,525643
2009-07-01,Tennessee,4868936,3023463,2706513,316950
2009-07-01,Texas,18105139,12027290,11042872,984418
2009-07-01,Utah,1974253,1373141,1271180,101961
2009-07-01,Vermont,507115,360377,337862,22515
2009-07-01,Virginia,6002403,4138354,3850155,288199
2009-07-01,Washington,5178070,3463333,3169356,293977
2009-07-01,Wisconsin,4418188,3120387,2828900,291487
2009-07-01,Wyoming,418865,300467,280658,19809
2009-08-01,Alabama,3624837,2152222,1923196,229026
2009-08-01,Alaska,513656,360299,330803,29496
2009-08-01,Arizona,4961060,3131513,2814158,317355
2009-08-01,Arkansas,2205479,1351081,1245167,105914
2009-08-01,California,27986270,18295071,16100602,2194469
2009-08-01,Colorado,3847562,2727247,2505320,221927
2009-08-01,Connecticut,2749085,1891764,1728836,162928
2009-08-01,Delaware,686972,435435,398014,37421
2009-08-01,Florida,14599431,8978345,8067438,910907
2009-08-01,Georgia,7312496,4799902,4282945,516957
2009-08-01,Hawaii,982384,631317,588153,43164
2009-08-01,Idaho,1151866,764334,694403,69931
2009-08-01,Illinois,9884709,6610820,5907507,703313
2009-08-01,Indiana,4911180,3201118,2860122,340996
2009-08-01,Iowa,2335284,1674750,1565031,109719
2009-08-01,Kansas,2130871,1516989,1406736,110253
2009-08-01,Kentucky,3330802,2064926,1835411,229515
2009-08-01,Louisiana,3392730,2067196,1921831,145365
2009-08-01,Maine,1065143,696562,637239,59323
2009-08-01,Maryland,4401975,3048938,2813403,235535
2009-08-01,Massachusetts,5244207,3469286,3177920,291366
2009-08-01,Michigan,7770891,4856487,4184303,672184
2009-08-01,Minnesota,4087541,2930548,2694937,235611
2009-08-01,Mississippi,2201059,1262789,1141924,120865
2009-08-01,Missouri,4613947,3060731,2775832,284899
2009-08-01,Montana,767959,500707,465128,35579
2009-08-01,Nebraska,1364635,988595,941206,47389
2009-08-01,Nevada,2002267,1365329,1197462,167867
2009-08-01,Ohio,8956374,5888132,5270650,617482
2009-08-01,Oklahoma,2778180,1773942,1650963,122979
2009-08-01,Oregon,3012625,1963985,1751276,212709
2009-08-01,Pennsylvania,9945029,6380840,5857656,523184
2009-08-01,Tennessee,4873515,3022770,2705032,317738
2009-08-01,Texas,18134768,12035941,11040880,995061
2009-08-01,Utah,1977352,1368895,1265371,103524
2009-08-01,Vermont,507430,359802,337117,22685
2009-08-01,Virginia,6009725,4134913,3843174,291739
2009-08-01,Washington,5185004,3462571,3161327,301244
2009-08-01,Wisconsin,4420667,3110072,2820936,289136
2009-08-01,Wyoming,419192,299950,279871,20079
2009-09-01,Alabama,3627477,2146808,1914421,232387
2009-09-01,Alaska,513872,360018,330431,29587
2009-09-01,Arizona,4968072,3126346,2804614,321732
2009-09-01,Arkansas,2207281,1348368,1242864,105504
2009-09-01,California,28019194,18266064,16049842,2216222
2009-09-01,Colorado,3852743,2718739,2496342,222397
2009-09-01,Connecticut,2751032,1890575,1724297,166278
2009-09-01,Delaware,687690,433494,395820,37674
2009-09-01,Florida,14615000,8971805,8044442,927363
2009-09-01,Georgia,7321947,4791624,4272839,518785
2009-09-01,Hawaii,982979,630905,587593,43312
2009-09-01,Idaho,1153087,763191,693446,69745
2009-09-01,Illinois,9890904,6601019,5885181,715838
2009-09-01,Indiana,4914475,3187111,2849830,337281
2009-09-01,Iowa,2336799,1671946,1562768,109178
2009-09-01,Kansas,2132592,1513022,1403365,109657
2009-09-01,Kentucky,3333496,2059145,1832168,226977
2009-09-01,Louisiana,3395772,2064076,1919181,144895
2009-09-01,Maine,1065440,695385,636129,59256
2009-09-01,Maryland,4406548,3044831,2808298,236533
2009-09-01,Massachusetts,5248524,3464412,3171810,292602
2009-09-01,Michigan,7772966,4832672,4171972,660700
2009-09-01,Minnesota,4090504,2926112,2692908,233204
2009-09-01,Mississippi,2202315,1260410,1137403,123007
2009-09-01,Missouri,4617243,3053430,2767093,286337
2009-09-01,Montana,768524,499791,464097,35694
2009-09-01,Nebraska,1365808,987507,939966,47541
2009-09-01,Nevada,2003771,1362186,1191275,170911
2009-09-01,Ohio,8959495,5883486,5257988,625498
2009-09-01,Oklahoma,2780669,1769326,1646669,122657
2009-09-01,Oregon,3015664,1959776,1750074,209702
2009-09-01,Pennsylvania,9950472,6357890,5837681,520209
2009-09-01,Tennessee,4878100,3023659,2705490,318169
2009-09-01,Texas,18163851,12036191,11038831,997360
2009-09-01,Utah,1980374,1364462,1259612,104850
2009-09-01,Vermont,507724,359182,336279,22903
2009-09-01,Virginia,6017014,4131421,3835560,295861
2009-09-01,Washington,5191902,3463071,3152726,310345
2009-09-01,Wisconsin,4423136,3099185,2812227,286958
2009-09-01,Wyoming,419500,299610,279101,20509
2009-10-01,Alabama,3630337,2142208,1907643,234565
2009-10-01,Alaska,514133,359711,330034,29677
2009-10-01,Arizona,4975352,3120895,2795851,325044
2009-10-01,Arkansas,2209199,1345775,1240400,105375
2009-10-01,California,28053709,18243355,16007637,2235718
2009-10-01,Colorado,3858144,2711692,2487400,224292
2009-10-01,Connecticut,2753149,1888815,1719152,169663
2009-10-01,Delaware,688459,431859,393847,38012
2009-10-01,Florida,14631311,8968645,8026138,942507
2009-10-01,Georgia,7331829,4783230,4264115,519115
2009-10-01,Hawaii,983622,630679,587205,43474
2009-10-01,Idaho,1154366,762147,692584,69563
2009-10-01,Illinois,9897655,6593339,5864865,728474
2009-10-01,Indiana,4918039,3175581,2840309,335272
2009-10-01,Iowa,2338466,1668747,1560093,108654
2009-10-01,Kansas,2134462,1508787,1399911,108876
2009-10-01,Kentucky,3336401,2054515,1829565,224950
2009-10-01,Louisiana,3398961,2061211,1916572,144639
2009-10-01,Maine,1065788,694561,635139,59422
2009-10-01,Maryland,4411347,3041386,2803176,238210
2009-10-01,Massachusetts,5253091,3460868,3167575,293293
2009-10-01,Michigan,7775455,4811810,4162184,649626
2009-10-01,Minnesota,4093670,2922698,2691628,231070
2009-10-01,Mississippi,2203668,1259466,1133784,125682
2009-10-01,Missouri,4620808,3046720,2759008,287712
2009-10-01,Montana,769146,499149,463140,36009
2009-10-01,Nebraska,1367090,986531,938727,47804
2009-10-01,Nevada,2005462,1359279,1185525,173754
2009-10-01,Ohio,8963041,5880324,5245920,634404
2009-10-01,Oklahoma,2783333,1765197,1642579,122618
2009-10-01,Oregon,3018895,1957509,1749082,208427
2009-10-01,Pennsylvania,9956445,6339102,5820126,518976
2009-10-01,Tennessee,4882981,3025771,2707285,318486
2009-10-01,Texas,18194118,12036269,11040270,995999
2009-10-01,Utah,1983529,1360205,1254310,105895
2009-10-01,Vermont,508094,358651,335482,23169
2009-10-01,Virginia,6024651,4128934,3828154,300780
2009-10-01,Washington,5199075,3456236,3143906,312330
2009-10-01,Wisconsin,4425882,3089933,2804121,285812
2009-10-01,Wyoming,419851,299628,278438,21190
2009-11-01,Alabama,3632553,2139947,1904011,235936
2009-11-01,Alaska,514325,359647,329798,29849
2009-11-01,Arizona,4981854,3116842,2789383,327459
2009-11-01,Arkansas,2210757,1343857,1238191,105666
2009-11-01,California,28084234,18237262,15981193,2256069
2009-11-01,Colorado,3862938,2708033,2479744,228289
2009-11-01,Connecticut,2754731,1887858,1714686,173172
2009-11-01,Delaware,689092,430762,392346,38416
2009-11-01,Florida,14645036,8973003,8016095,956908
2009-11-01,Georgia,7340523,4777540,4258854,518686
2009-11-01,Hawaii,984262,631046,587373,43673
2009-11-01,Idaho,1155469,761632,692099,69533
2009-11-01,Illinois,9902704,6592973,5852392,740581
2009-11-01,Indiana,4920671,3168554,2833101,335453
2009-11-01,Iowa,2339640,1666336,1558033,108303
2009-11-01,Kansas,2135884,1505314,1396912,108402
2009-11-01,Kentucky,3338735,2052571,1828591,223980
2009-11-01,Louisiana,3401585,2059990,1915071,144919
2009-11-01,Maine,1065945,694427,634580,59847
2009-11-01,Maryland,4415406,3040505,2799603,240902
2009-11-01,Massachusetts,5256717,3460102,3166227,293875
2009-11-01,Michigan,7776472,4796531,4155159,641372
2009-11-01,Minnesota,4096104,2921699,2692020,229679
2009-11-01,Mississippi,2204638,1260322,1131805,128517
2009-11-01,Missouri,4623522,3042320,2752712,289608
2009-11-01,Montana,769618,498984,462518,36466
2009-11-01,Nebraska,1368134,986060,937863,48197
2009-11-01,Nevada,2006744,1357494,1180770,176724
2009-11-01,Ohio,8964826,5880807,5236980,643827
2009-11-01,Oklahoma,2785467,1762634,1639789,122845
2009-11-01,Oregon,3021588,1958343,1749369,208974
2009-11-01,Pennsylvania,9960433,6328965,5807933,521032
2009-11-01,Tennessee,4886991,3030297,2711254,319043
2009-11-01,Texas,18221759,12045372,11050184,995188
2009-11-01,Utah,1986362,1356818,1250061,106757
2009-11-01,Vermont,508329,358407,334938,23469
2009-11-01,Virginia,6031267,4129176,3822838,306338
2009-11-01,Washington,5205382,3451994,3136631,315363
2009-11-01,Wisconsin,4427819,3084461,2798737,285724
2009-11-01,Wyoming,420108,300001,278031,21970
2009-12-01,Alabama,3634419,2140674,1903811,236863
2009-12-01,Alaska,514467,359932,329829,30103
2009-12-01,Arizona,4987853,3115241,2785895,329346
2009-12-01,Arkansas,2212101,1343147,1236853,106294
2009-12-01,California,28111925,18254035,15975922,2278113
2009-12-01,Colorado,3867378,2708249,2474419,233830
2009-12-01,Connecticut,2756043,1889075,1712315,176760
2009-12-01,Delaware,689720,430322,391519,38803
2009-12-01,Florida,14657213,8987807,8017476,970331
2009-12-01,Georgia,7348529,4776286,4258241,518045
2009-12-01,Hawaii,984741,632327,588446,43881
2009-12-01,Idaho,1156479,761927,692251,69676
2009-12-01,Illinois,9906794,6601820,5851687,750133
2009-12-01,Indiana,4922905,3167003,2829818,337185
2009-12-01,Iowa,2340638,1666046,1557898,108148
2009-12-01,Kansas,2137157,1503151,1394859,108292
2009-12-01,Kentucky,3340801,2053885,1829926,223959
2009-12-01,Louisiana,3403890,2061538,1915554,145984
2009-12-01,Maine,1066053,695077,634656,60421
2009-12-01,Maryland,4419022,3043485,2799405,244080
2009-12-01,Massachusetts,5259886,3462787,3168295,294492
2009-12-01,Michigan,7776809,4788182,4151879,636303
2009-12-01,Minnesota,4098214,2923951,2694944,229007
2009-12-01,Mississippi,2205398,1262711,1131753,130958
2009-12-01,Missouri,4625852,3041155,2749112,292043
2009-12-01,Montana,770036,499358,462376,36982
2009-12-01,Nebraska,1369023,986333,937752,48581
2009-12-01,Nevada,2007872,1357344,1177391,179953
2009-12-01,Ohio,8965878,5886389,5234320,652069
2009-12-01,Oklahoma,2787381,1762250,1639144,123106
2009-12-01,Oregon,3023994,1962640,1751681,210959
2009-12-01,Pennsylvania,9963526,6329739,5803095,526644
2009-12-01,Tennessee,4890561,3038713,2718884,319829
2009-12-01,Texas,18247563,12070223,11072620,997603
2009-12-01,Utah,1989021,1354784,1247251,107533
2009-12-01,Vermont,508622,358555,334803,23752
2009-12-01,Virginia,6037319,4132983,3821237,311746
2009-12-01,Washington,5211219,3451532,3132862,318670
2009-12-01,Wisconsin,4429332,3083749,2797682,286067
2009-12-01,Wyoming,420366,300619,277989,22630
2010-01-01,Alabama,3636380,2143297,1906185,237112
2010-01-01,Alaska,514628,360431,330113,30318
2010-01-01,Arizona,4994110,3115797,2785351,330446
2010-01-01,Arkansas,2213503,1343957,1237151,106806
2010-01-01,California,28141513,18288466,15991766,2296700
2010-01-01,Colorado,3871967,2711291,2471793,239498
2010-01-01,Connecticut,2757497,1892594,1712632,179962
2010-01-01,Delaware,690331,430527,391523,39004
2010-01-01,Florida,14670087,9011633,8031055,980578
2010-01-01,Georgia,7356794,4778162,4261834,516328
2010-01-01,Hawaii,985330,634566,590573,43993
2010-01-01,Idaho,1157503,762726,693074,69652
2010-01-01,Illinois,9911282,6616172,5862132,754040
2010-01-01,Indiana,4925217,3169128,2830634,338494
2010-01-01,Iowa,2341680,1668161,1560395,107766
2010-01-01,Kansas,2138455,1502302,1394052,108250
2010-01-01,Kentucky,3342861,2057265,1833428,223837
2010-01-01,Louisiana,3406282,2065893,1918232,147661
2010-01-01,Maine,1066138,696250,635414,60836
2010-01-01,Maryland,4422798,3049772,2803421,246351
2010-01-01,Massachusetts,5263246,3468119,3173610,294509
2010-01-01,Michigan,7777357,4785142,4153410,631732
2010-01-01,Minnesota,4100422,2928681,2700412,228269
2010-01-01,Mississippi,2206254,1265805,1133350,132455
2010-01-01,Missouri,4628246,3042296,2748478,293818
2010-01-01,Montana,770491,500111,462743,37368
2010-01-01,Nebraska,1370014,987372,938545,48827
2010-01-01,Nevada,2009168,1358406,1175465,182941
2010-01-01,Ohio,8967104,5895027,5238928,656099
2010-01-01,Oklahoma,2789349,1763483,1640540,122943
2010-01-01,Oregon,3026512,1969690,1756262,213428
2010-01-01,Pennsylvania,9966890,6338833,5805453,533380
2010-01-01,Tennessee,4894242,3050578,2730789,319789
2010-01-01,Texas,18274485,12108919,11106882,1002037
2010-01-01,Utah,1991747,1354098,1245935,108163
2010-01-01,Vermont,508821,359006,335086,23920
2010-01-01,Virginia,6043575,4139523,3823909,315614
2010-01-01,Washington,5217186,3454420,3133335,321085
2010-01-01,Wisconsin,4430954,3086454,2800945,285509
2010-01-01,Wyoming,420608,301350,278343,23007
2010-02-01,Alabama,3637985,2145780,1909481,236299
2010-02-01,Alaska,514760,360957,330579,30378
2010-02-01,Arizona,4999841,3116749,2786396,330353
2010-02-01,Arkansas,2214703,1345947,1239114,106833
2010-02-01,California,28168472,18327194,16020128,2307066
2010-02-01,Colorado,3876247,2714852,2471124,243728
2010-02-01,Connecticut,2758668,1897276,1714982,182294
2010-02-01,Delaware,690834,431248,392300,38948
2010-02-01,Florida,14681071,9039135,8052755,986380
2010-02-01,Georgia,7364379,4725950,4213413,512537
2010-02-01,Hawaii,985714,637461,593468,43993
2010-02-01,Idaho,1158417,763525,694203,69322
2010-02-01,Illinois,9914870,6628765,5878039,750726
2010-02-01,Indiana,4927158,3172852,2834812,338040
2010-02-01,Iowa,2342488,1671781,1564951,106830
2010-02-01,Kansas,2139596,1502043,1394188,107855
2010-02-01,Kentucky,3344688,2060696,1838044,222652
2010-02-01,Louisiana,3408339,2071784,1922452,149332
2010-02-01,Maine,1066067,697409,636533,60876
2010-02-01,Maryland,4426148,3057423,2810540,246883
2010-02-01,Massachusetts,5266159,3473982,3180656,293326
2010-02-01,Michigan,7777182,4784327,4158820,625507
2010-02-01,Minnesota,4102269,2933933,2707327,226606
2010-02-01,Mississippi,2206814,1268874,1135839,133035
2010-02-01,Missouri,4630244,3043869,2749657,294212
2010-02-01,Montana,770816,500923,463419,37504
2010-02-01,Nebraska,1370817,988776,939919,48857
2010-02-01,Nevada,2010225,1359771,1174541,185230
2010-02-01,Ohio,8967563,5902220,5248612,653608
2010-02-01,Oklahoma,2791092,1765258,1643105,122153
2010-02-01,Oregon,3028729,1977638,1762239,215399
2010-02-01,Pennsylvania,9969289,6350528,5812330,538198
2010-02-01,Tennessee,4897491,3063620,2745903,317717
2010-02-01,Texas,18299762,12151988,11146453,1005535
2010-02-01,Utah,1994390,1354151,1245598,108553
2010-02-01,Vermont,509023,359539,335633,23906
2010-02-01,Virginia,6049306,4146809,3829743,317066
2010-02-01,Washington,5222744,3458632,3136999,321633
2010-02-01,Wisconsin,4432255,3089495,2806625,282870
2010-02-01,Wyoming,420826,301933,278975,22958
2010-03-01,Alabama,3639724,2146904,1912541,234363
2010-03-01,Alaska,514896,361357,331099,30258
2010-03-01,Arizona,5005603,3116147,2787165,328982
2010-03-01,Arkansas,2215934,1348707,1242264,106443
2010-03-01,California,28195088,18359589,16050996,2308593
2010-03-01,Colorado,3880636,2717321,2471367,245954
2010-03-01,Connecticut,2759910,1902002,1718400,183602
2010-03-01,Delaware,691403,432340,393640,38700
2010-03-01,Florida,14692208,9065533,8076970,988563
2010-03-01,Georgia,7372287,4708859,4201580,507279
2010-03-01,Hawaii,986160,640630,596671,43959
2010-03-01,Idaho,1159426,763983,695240,68743
2010-03-01,Illinois,9918785,6634842,5894031,740811
2010-03-01,Indiana,4929346,3177346,2841624,335722
2010-03-01,Iowa,2343400,1675368,1570007,105361
2010-03-01,Kansas,2140798,1501694,1394805,106889
2010-03-01,Kentucky,3346711,2062897,1842725,220172
2010-03-01,Louisiana,3410594,2077866,1927051,150815
2010-03-01,Maine,1066137,698109,637570,60539
2010-03-01,Maryland,4429620,3064844,2818977,245867
2010-03-01,Massachusetts,5269256,3478448,3187591,290857
2010-03-01,Michigan,7777301,4783504,4165926,617578
2010-03-01,Minnesota,4104281,2938371,2714349,224022
2010-03-01,Mississippi,2207537,1271407,1138614,132793
2010-03-01,Missouri,4632421,3044587,2751280,293307
2010-03-01,Montana,771187,501546,464199,37347
2010-03-01,Nebraska,1371688,990060,941517,48543
2010-03-01,Nevada,2011335,1360604,1173988,186616
2010-03-01,Ohio,8968417,5904597,5259913,644684
2010-03-01,Oklahoma,2792911,1766675,1645979,120696
2010-03-01,Oregon,3031074,1984778,1768457,216321
2010-03-01,Pennsylvania,9972037,6359683,5820638,539045
2010-03-01,Tennessee,4900953,3076129,2762469,313660
2010-03-01,Texas,18325113,12191275,11184615,1006660
2010-03-01,Utah,1997075,1354198,1245524,108674
2010-03-01,Vermont,509216,359952,336236,23716
2010-03-01,Virginia,6055213,4153490,3837310,316180
2010-03-01,Washington,5228475,3462164,3141865,320299
2010-03-01,Wisconsin,4433668,3090610,2812648,277962
2010-03-01,Wyoming,421067,302202,279686,22516
2010-04-01,Alabama,3696845,2197720,1966202,231518
2010-04-01,Alaska,515851,361538,331564,29974
2010-04-01,Arizona,4838466,3113354,2786810,326544
2010-04-01,Arkansas,2231366,1351964,1246062,105902
2010-04-01,California,28538466,18381603,16078778,2302825
2010-04-01,Colorado,3848295,2718188,2471781,246407
2010-04-01,Connecticut,2802329,1906595,1722636,183959
2010-04-01,Delaware,701527,433690,395333,38357
2010-04-01,Florida,14959822,9099777,8111208,988569
2010-04-01,Georgia,7276848,4701086,4199284,501802
2010-04-01,Hawaii,1039195,643754,599835,43919
2010-04-01,Idaho,1163327,764012,696013,67999
2010-04-01,Illinois,9881090,6634091,5907874,726217
2010-04-01,Indiana,4962744,3181319,2849394,331925
2010-04-01,Iowa,2358250,1677557,1573836,103721
2010-04-01,Kansas,2147765,1501224,1395682,105542
2010-04-01,Kentucky,3340225,2063774,1847055,216719
2010-04-01,Louisiana,3434434,2083571,1931260,152311
2010-04-01,Maine,1074471,698248,638356,59892
2010-04-01,Maryland,4490945,3071526,2827499,244027
2010-04-01,Massachusetts,5224455,3480846,3193516,287330
2010-04-01,Michigan,7718784,4781950,4173309,608641
2010-04-01,Minnesota,4108452,2941579,2720784,220795
2010-04-01,Mississippi,2228901,1273382,1141411,131971
2010-04-01,Missouri,4618728,3044286,2752890,291396
2010-04-01,Montana,777438,501897,464966,36931
2010-04-01,Nebraska,1388012,991039,943174,47865
2010-04-01,Nevada,2073299,1360595,1173507,187088
2010-04-01,Ohio,8958283,5901230,5269891,631339
2010-04-01,Oklahoma,2836218,1767216,1648598,118618
2010-04-01,Oregon,3024399,1990068,1773965,216103
2010-04-01,Pennsylvania,10056682,6364141,5829048,535093
2010-04-01,Tennessee,4916740,3087199,2778857,308342
2010-04-01,Texas,18541655,12222661,11218075,1004586
2010-04-01,Utah,1952084,1353881,1245364,108517
2010-04-01,Vermont,506421,360198,336797,23401
2010-04-01,Virginia,6149198,4159068,3845699,313369
2010-04-01,Washington,5233189,3463843,3146041,317802
2010-04-01,Wisconsin,4428585,3089354,2817875,271479
2010-04-01,Wyoming,433003,302183,280341,21842
2010-05-01,Alabama,3700013,2211777,1983756,228021
2010-05-01,Alaska,516810,361511,331982,29529
2010-05-01,Arizona,4843931,3108504,2785501,323003
2010-05-01,Arkansas,2233214,1355055,1249752,105303
2010-05-01,California,28564851,18391244,16101040,2290204
2010-05-01,Colorado,3852091,2717428,2471774,245654
2010-05-01,Connecticut,2804758,1910818,1727354,183464
2010-05-01,Delaware,702130,435187,397214,37973
2010-05-01,Florida,14974268,9128507,8141742,986765
2010-05-01,Georgia,7285144,4695916,4199284,496632
2010-05-01,Hawaii,1040697,646474,602624,43850
2010-05-01,Idaho,1164326,763624,696473,67151
2010-05-01,Illinois,9885775,6627042,5918616,708426
2010-05-01,Indiana,4965541,3183430,2856480,326950
2010-05-01,Iowa,2359389,1677764,1575622,102142
2010-05-01,Kansas,2148511,1500581,1396641,103940
2010-05-01,Kentucky,3343644,2063716,1851019,212697
2010-05-01,Louisiana,3437625,2088368,1934470,153898
2010-05-01,Maine,1074480,697946,638921,59025
2010-05-01,Maryland,4495161,3077202,2835458,241744
2010-05-01,Massachusetts,5230789,3481152,3198192,282960
2010-05-01,Michigan,7719607,4779667,4179998,599669
2010-05-01,Minnesota,4111034,2943440,2726065,217375
2010-05-01,Mississippi,2230751,1274962,1144100,130862
2010-05-01,Missouri,4621534,3043234,2754497,288737
2010-05-01,Montana,777863,501975,465645,36330
2010-05-01,Nebraska,1388844,991699,944751,46948
2010-05-01,Nevada,2074378,1359713,1173032,186681
2010-05-01,Ohio,8961281,5892307,5276565,615742
2010-05-01,Oklahoma,2838991,1766844,1650772,116072
2010-05-01,Oregon,3027045,1992953,1778073,214880
2010-05-01,Pennsylvania,10060817,6363851,5836971,526880
2010-05-01,Tennessee,4921391,3096008,2793510,302498
2010-05-01,Texas,18567698,12244873,11246029,998844
2010-05-01,Utah,1954737,1353095,1245042,108053
2010-05-01,Vermont,506599,360279,337283,22996
2010-05-01,Virginia,6155076,4163253,3854150,309103
2010-05-01,Washington,5237362,3463335,3148394,314941
2010-05-01,Wisconsin,4430315,3086350,2821846,264504
2010-05-01,Wyoming,433341,301985,280897,21088
2010-06-01,Alabama,3703287,2214822,1990063,224759
2010-06-01,Alaska,517816,361350,332315,29035
2010-06-01,Arizona,4849422,3102036,2782917,319119
2010-06-01,Arkansas,2235014,1357180,1252284,104896
2010-06-01,California,28591878,18389824,16113195,2276629
2010-06-01,Colorado,3855998,2715479,2470389,245090
2010-06-01,Connecticut,2807133,1914097,1731412,182685
2010-06-01,Delaware,702750,436637,398992,37645
2010-06-01,Florida,14988894,9150806,8165455,985351
2010-06-01,Georgia,7293730,4692273,4199144,493129
2010-06-01,Hawaii,1042459,648687,604821,43866
2010-06-01,Idaho,1165402,762884,696497,66387
2010-06-01,Illinois,9890376,6615981,5925185,690796
2010-06-01,Indiana,4968191,3183185,2861326,321859
2010-06-01,Iowa,2360458,1676132,1575290,100842
2010-06-01,Kansas,2149335,1499954,1397316,102638
2010-06-01,Kentucky,3347186,2063356,1854264,209092
2010-06-01,Louisiana,3440859,2091461,1935671,155790
2010-06-01,Maine,1074478,697428,639223,58205
2010-06-01,Maryland,4499403,3081487,2841759,239728
2010-06-01,Massachusetts,5237003,3479736,3201063,278673
2010-06-01,Michigan,7720262,4776679,4184137,592542
2010-06-01,Minnesota,4113576,2943802,2729228,214574
2010-06-01,Mississippi,2232572,1309109,1179145,129964
2010-06-01,Missouri,4624402,3041931,2755633,286298
2010-06-01,Montana,778260,501750,466046,35704
2010-06-01,Nebraska,1389679,992091,945979,46112
2010-06-01,Nevada,2075511,1358272,1172324,185948
2010-06-01,Ohio,8964153,5879456,5278705,600751
2010-06-01,Oklahoma,2841937,1765862,1652192,113670
2010-06-01,Oregon,3029692,1994048,1780620,213428
2010-06-01,Pennsylvania,10064783,6360595,5842888,517707
2010-06-01,Tennessee,4926066,3101945,2804364,297581
2010-06-01,Texas,18594205,12259778,11267141,992637
2010-06-01,Utah,1957360,1351732,1244308,107424
2010-06-01,Vermont,506795,360157,337576,22581
2010-06-01,Virginia,6161486,4165768,3861060,304708
2010-06-01,Washington,5241659,3461303,3148334,312969
2010-06-01,Wisconsin,4432000,3082609,2824115,258494
2010-06-01,Wyoming,433698,301753,281308,20445
2010-07-01,Alabama,3706618,2215237,1992482,222755
2010-07-01,Alaska,518874,361237,332532,28705
2010-07-01,Arizona,4855271,3094880,2779038,315842
2010-07-01,Arkansas,2237003,1358003,1253026,104977
2010-07-01,California,28619823,18384037,16113653,2270384
2010-07-01,Colorado,3860150,2713677,2467557,246120
2010-07-01,Connecticut,2809705,1916460,1734133,182327
2010-07-01,Delaware,703370,437815,400363,37452
2010-07-01,Florida,15004298,9169009,8181978,987031
2010-07-01,Georgia,7301868,4691252,4198521,492731
2010-07-01,Hawaii,1044210,650583,606535,44048
2010-07-01,Idaho,1166472,761967,696118,65849
2010-07-01,Illinois,9895347,6605960,5929180,676780
2010-07-01,Indiana,4971237,3180859,2863150,317709
2010-07-01,Iowa,2361712,1673866,1573698,100168
2010-07-01,Kansas,2150262,1499521,1397499,102022
2010-07-01,Kentucky,3350635,2063585,1856614,206971
2010-07-01,Louisiana,3444273,2092507,1934492,158015
2010-07-01,Maine,1074529,697027,639323,57704
2010-07-01,Maryland,4504017,3084531,2845807,238724
2010-07-01,Massachusetts,5243644,3478152,3202585,275567
2010-07-01,Michigan,7721434,4773819,4184857,588962
2010-07-01,Minnesota,4116358,2943204,2729891,213313
2010-07-01,Mississippi,2234489,1326873,1196962,129911
2010-07-01,Missouri,4627241,3041121,2756025,285096
2010-07-01,Montana,778719,501304,466066,35238
2010-07-01,Nebraska,1390608,992335,946748,45587
2010-07-01,Nevada,2076775,1357070,1171332,185738
2010-07-01,Ohio,8967602,5866162,5277025,589137
2010-07-01,Oklahoma,2844698,1764974,1652848,112126
2010-07-01,Oregon,3032496,1994552,1781970,212582
2010-07-01,Pennsylvania,10069471,6357444,5846188,511256
2010-07-01,Tennessee,4931020,3105034,2810185,294849
2010-07-01,Texas,18621263,12272590,11282344,990246
2010-07-01,Utah,1960150,1350000,1243121,106879
2010-07-01,Vermont,506980,359881,337624,22257
2010-07-01,Virginia,6168295,4167097,3865710,301387
2010-07-01,Washington,5246398,3458973,3146426,312547
2010-07-01,Wisconsin,4433927,3079417,2824935,254482
2010-07-01,Wyoming,434045,301585,281564,20021
2010-08-01,Alabama,3708665,2215825,1993456,222369
2010-08-01,Alaska,519938,361349,332690,28659
2010-08-01,Arizona,4862034,3088178,2774664,313514
2010-08-01,Arkansas,2238891,1357870,1252260,105610
2010-08-01,California,28651165,18380281,16106916,2273365
2010-08-01,Colorado,3866394,2713080,2464356,248724
2010-08-01,Connecticut,2811743,1918237,1735650,182587
2010-08-01,Delaware,704160,438620,401248,37372
2010-08-01,Florida,15024207,9186214,8194731,991483
2010-08-01,Georgia,7309203,4693766,4198504,495262
2010-08-01,Hawaii,1045500,652315,607978,44337
2010-08-01,Idaho,1167725,761137,695586,65551
2010-08-01,Illinois,9901550,6600053,5933099,666954
2010-08-01,Indiana,4974530,3177460,2862980,314480
2010-08-01,Iowa,2363261,1672341,1572218,100123
2010-08-01,Kansas,2151610,1499329,1397291,102038
2010-08-01,Kentucky,3352851,2064904,1858381,206523
2010-08-01,Louisiana,3447819,2091887,1931705,160182
2010-08-01,Maine,1075061,697050,639483,57567
2010-08-01,Maryland,4508940,3087064,2848274,238790
2010-08-01,Massachusetts,5248732,3477864,3203993,273871
2010-08-01,Michigan,7725162,4754004,4183007,570997
2010-08-01,Minnesota,4119761,2942522,2728897,213625
2010-08-01,Mississippi,2235801,1336480,1205884,130596
2010-08-01,Missouri,4629639,3041423,2755882,285541
2010-08-01,Montana,779335,500825,465795,35030
2010-08-01,Nebraska,1391584,992637,947230,45407
2010-08-01,Nevada,2078269,1356662,1170347,186315
2010-08-01,Ohio,8971266,5855186,5273622,581564
2010-08-01,Oklahoma,2847076,1764631,1653189,111442
2010-08-01,Oregon,3035865,1995295,1782838,212457
2010-08-01,Pennsylvania,10075228,6356859,5848142,508717
2010-08-01,Tennessee,4935322,3105998,2811416,294582
2010-08-01,Texas,18653451,12287949,11294712,993237
2010-08-01,Utah,1963071,1348321,1241798,106523
2010-08-01,Vermont,507341,359635,337553,22082
2010-08-01,Virginia,6175954,4168162,3868904,299258
2010-08-01,Washington,5252718,3457191,3143795,313396
2010-08-01,Wisconsin,4436495,3077502,2825260,252242
2010-08-01,Wyoming,434340,301540,281736,19804
2010-09-01,Alabama,3710620,2216902,1993580,223322
2010-09-01,Alaska,520706,361682,332846,28836
2010-09-01,Arizona,4868640,3082127,2770279,311848
2010-09-01,Arkansas,2240717,1357262,1250630,106632
2010-09-01,California,28682473,18378828,16097746,2281082
2010-09-01,Colorado,3872252,2713611,2461710,251901
2010-09-01,Connecticut,2813819,1919267,1736057,183210
2010-09-01,Delaware,704947,439101,401788,37313
2010-09-01,Florida,15043725,9203325,8206908,996417
2010-09-01,Georgia,7316156,4698525,4199495,499030
2010-09-01,Hawaii,1046297,653928,609279,44649
2010-09-01,Idaho,1168906,760571,695155,65416
2010-09-01,Illinois,9907377,6596284,5936658,659626
2010-09-01,Indiana,4977966,3173755,2862333,311422
2010-09-01,Iowa,2364850,1672191,1571768,100423
2010-09-01,Kansas,2152775,1499286,1396809,102477
2010-09-01,Kentucky,3354938,2066702,1859754,206948
2010-09-01,Louisiana,3451131,2090381,1928355,162026
2010-09-01,Maine,1075651,697492,639857,57635
2010-09-01,Maryland,4513628,3089416,2850163,239253
2010-09-01,Massachusetts,5253897,3478753,3205662,273091
2010-09-01,Michigan,7729079,4735269,4179731,555538
2010-09-01,Minnesota,4123243,2942201,2727753,214448
2010-09-01,Mississippi,2236920,1341711,1210162,131549
2010-09-01,Missouri,4632006,3042363,2755310,287053
2010-09-01,Montana,779928,500372,465321,35051
2010-09-01,Nebraska,1392543,993061,947558,45503
2010-09-01,Nevada,2079628,1356846,1169573,187273
2010-09-01,Ohio,8975063,5846806,5270258,576548
2010-09-01,Oklahoma,2849245,1764391,1653363,111028
2010-09-01,Oregon,3039325,1996450,1783866,212584
2010-09-01,Pennsylvania,10081106,6358506,5850062,508444
2010-09-01,Tennessee,4939470,3105987,2809706,296281
2010-09-01,Texas,18684832,12306687,11306167,1000520
2010-09-01,Utah,1965965,1346821,1240547,106274
2010-09-01,Vermont,507719,359493,337459,22034
2010-09-01,Virginia,6182352,4169589,3871974,297615
2010-09-01,Washington,5258655,3456058,3141316,314742
2010-09-01,Wisconsin,4439156,3076543,2825612,250931
2010-09-01,Wyoming,434583,301652,281862,19790
2010-10-01,Alabama,3712775,2217869,1993177,224692
2010-10-01,Alaska,521665,362226,333152,29074
2010-10-01,Arizona,4875453,3076852,2766599,310253
2010-10-01,Arkansas,2242644,1356803,1249134,107669
2010-10-01,California,28715259,18378713,16092500,2286213
2010-10-01,Colorado,3878447,2714795,2460636,254159
2010-10-01,Connecticut,2815960,1919649,1735952,183697
2010-10-01,Delaware,705737,439480,402336,37144
2010-10-01,Florida,15063974,9215892,8216792,999100
2010-10-01,Georgia,7323865,4703944,4202054,501890
2010-10-01,Hawaii,1047433,655653,610770,44883
2010-10-01,Idaho,1170177,760364,695058,65306
2010-10-01,Illinois,9913651,6592116,5939556,652560
2010-10-01,Indiana,4981455,3170742,2863424,307318
2010-10-01,Iowa,2366432,1673392,1572819,100573
2010-10-01,Kansas,2154068,1499560,1396563,102997
2010-10-01,Kentucky,3357264,2068269,1861137,207132
2010-10-01,Louisiana,3454715,2089083,1925719,163364
2010-10-01,Maine,1076239,698162,640515,57647
2010-10-01,Maryland,4518646,3091736,2852813,238923
2010-10-01,Massachusetts,5259094,3480429,3208079,272350
2010-10-01,Michigan,7733095,4717673,4177199,540474
2010-10-01,Minnesota,4126763,2942469,2728215,214254
2010-10-01,Mississippi,2238228,1344467,1212089,132378
2010-10-01,Missouri,4634573,3043450,2755173,288277
2010-10-01,Montana,780526,500038,464869,35169
2010-10-01,Nebraska,1393532,993816,948117,45699
2010-10-01,Nevada,2081102,1357352,1169345,188007
2010-10-01,Ohio,8978933,5840618,5269337,571281
2010-10-01,Oklahoma,2851655,1764070,1653719,110351
2010-10-01,Oregon,3042809,1998014,1786006,212008
2010-10-01,Pennsylvania,10087177,6362019,5854037,507982
2010-10-01,Tennessee,4943817,3106786,2808210,298576
2010-10-01,Texas,18717463,12329159,11320132,1009027
2010-10-01,Utah,1968852,1345724,1239726,105998
2010-10-01,Vermont,508111,359468,337452,22016
2010-10-01,Virginia,6190036,4172079,3876726,295353
2010-10-01,Washington,5264988,3455291,3139893,315398
2010-10-01,Wisconsin,4441858,3076209,2826902,249307
2010-10-01,Wyoming,434866,301921,282034,19887
2010-11-01,Alabama,3714308,2217791,1992440,225351
2010-11-01,Alaska,522685,362765,333546,29219
2010-11-01,Arizona,4881581,3072209,2763909,308300
2010-11-01,Arkansas,2244183,1356630,1248235,108395
2010-11-01,California,28745035,18376501,16093722,2282779
2010-11-01,Colorado,3884216,2715531,2461626,253905
2010-11-01,Connecticut,2817651,1919392,1735829,183563
2010-11-01,Delaware,706439,439945,403158,36787
2010-11-01,Florida,15081696,9239476,8241889,997587
2010-11-01,Georgia,7330672,4708019,4205813,502206
2010-11-01,Hawaii,1048818,657494,612571,44923
2010-11-01,Idaho,1171219,760441,695300,65141
2010-11-01,Illinois,9918371,6584845,5940621,644224
2010-11-01,Indiana,4984018,3168580,2867137,301443
2010-11-01,Iowa,2367571,1675189,1574964,100225
2010-11-01,Kansas,2155106,1499951,1396803,103148
2010-11-01,Kentucky,3359139,2069007,1862657,206350
2010-11-01,Louisiana,3457717,2088150,1924248,163902
2010-11-01,Maine,1076699,698775,641355,57420
2010-11-01,Maryland,4522968,3093338,2856158,237180
2010-11-01,Massachusetts,5263454,3482203,3211354,270849
2010-11-01,Michigan,7735723,4700743,4176364,524379
2010-11-01,Minnesota,4129555,2942990,2730889,212101
2010-11-01,Mississippi,2239207,1345720,1212871,132849
2010-11-01,Missouri,4636373,3043917,2755917,288000
2010-11-01,Montana,781026,499828,464588,35240
2010-11-01,Nebraska,1394320,994951,949114,45837
2010-11-01,Nevada,2082333,1357786,1169711,188075
2010-11-01,Ohio,8981177,5834361,5271037,563324
2010-11-01,Oklahoma,2853727,1763618,1654525,109093
2010-11-01,Oregon,3045757,1999456,1789598,209858
2010-11-01,Pennsylvania,10091215,6365866,5860034,505832
2010-11-01,Tennessee,4947403,3109113,2809060,300053
2010-11-01,Texas,18748043,12352386,11337423,1014963
2010-11-01,Utah,1971498,1345016,1239409,105607
2010-11-01,Vermont,508419,359473,337528,21945
2010-11-01,Virginia,6197094,4175447,3883599,291848
2010-11-01,Washington,5270758,3453762,3139343,314419
2010-11-01,Wisconsin,4443782,3075716,2829157,246559
2010-11-01,Wyoming,435098,302247,282256,19991
2010-12-01,Alabama,3715741,2216409,1991718,224691
2010-12-01,Alaska,523689,363140,333936,29204
2010-12-01,Arizona,4887492,3067605,2762374,305231
2010-12-01,Arkansas,2245614,1356570,1247898,108672
2010-12-01,California,28773773,18370136,16100812,2269324
2010-12-01,Colorado,3889801,2715890,2464572,251318
2010-12-01,Connecticut,2819242,1918366,1735774,182592
2010-12-01,Delaware,707142,440553,404310,36243
2010-12-01,Florida,15098874,9245364,8253492,991872
2010-12-01,Georgia,7337313,4709976,4210339,499637
2010-12-01,Hawaii,1050130,659209,614428,44781
2010-12-01,Idaho,1172254,760670,695790,64880
2010-12-01,Illinois,9922695,6573920,5938573,635347
2010-12-01,Indiana,4986382,3167428,2873191,294237
2010-12-01,Iowa,2368633,1676546,1577238,99308
2010-12-01,Kansas,2156053,1500190,1397503,102687
2010-12-01,Kentucky,3360884,2068709,1864297,204412
2010-12-01,Louisiana,3460659,2087244,1923828,163416
2010-12-01,Maine,1077041,699099,642145,56954
2010-12-01,Maryland,4527177,3093874,2859411,234463
2010-12-01,Massachusetts,5267534,3483339,3215075,268264
2010-12-01,Michigan,7738064,4684248,4176837,507411
2010-12-01,Minnesota,4132148,2943772,2735520,208252
2010-12-01,Mississippi,2240112,1346211,1213311,132900
2010-12-01,Missouri,4637996,3043280,2757397,285883
2010-12-01,Montana,781473,499719,464553,35166
2010-12-01,Nebraska,1395040,996345,950496,45849
2010-12-01,Nevada,2083488,1357880,1170535,187345
2010-12-01,Ohio,8983084,5826065,5273672,552393
2010-12-01,Oklahoma,2855615,1762867,1655823,107044
2010-12-01,Oregon,3048548,2000082,1794045,206037
2010-12-01,Pennsylvania,10094881,6367685,5866464,501221
2010-12-01,Tennessee,4950759,3112714,2812682,300032
2010-12-01,Texas,18777822,12372836,11356570,1016266
2010-12-01,Utah,1974065,1344606,1239497,105109
2010-12-01,Vermont,508692,359459,337650,21809
2010-12-01,Virginia,6203808,4179321,3892116,287205
2010-12-01,Washington,5276239,3450811,3139125,311686
2010-12-01,Wisconsin,4445481,3074471,2831638,242833
2010-12-01,Wyoming,435291,302487,282475,20012
2011-01-01,Alabama,3717148,2214624,1991574,223050
2011-01-01,Alaska,524423,363404,334356,29048
2011-01-01,Arizona,4893368,3063471,2761928,301543
2011-01-01,Arkansas,2247108,1356376,1247709,108667
2011-01-01,California,28802283,18363805,16113386,2250419
2011-01-01,Colorado,3895089,2716453,2469040,247413
2011-01-01,Connecticut,2820871,1917092,1736022,181070
2011-01-01,Delaware,707838,441299,405681,35618
2011-01-01,Florida,15115903,9251721,8267299,984422
2011-01-01,Georgia,7343837,4711595,4216168,495427
2011-01-01,Hawaii,1050960,660636,616041,44595
2011-01-01,Idaho,1173278,761044,696460,64584
2011-01-01,Illinois,9927281,6562937,5934625,628312
2011-01-01,Indiana,4988952,3168166,2881081,287085
2011-01-01,Iowa,2369761,1676887,1578751,98136
2011-01-01,Kansas,2156803,1500267,1398503,101764
2011-01-01,Kentucky,3362512,2067917,1866158,201759
2011-01-01,Louisiana,3463488,2086142,1924090,162052
2011-01-01,Maine,1077430,699101,642726,56375
2011-01-01,Maryland,4531264,3094091,2862372,231719
2011-01-01,Massachusetts,5271792,3483533,3218531,265002
2011-01-01,Michigan,7740726,4669483,4178511,490972
2011-01-01,Minnesota,4134872,2945255,2741797,203458
2011-01-01,Mississippi,2240917,1346725,1213959,132766
2011-01-01,Missouri,4639686,3042146,2759423,282723
2011-01-01,Montana,781908,499721,464781,34940
2011-01-01,Nebraska,1395701,997896,952121,45775
2011-01-01,Nevada,2084614,1357776,1171682,186094
2011-01-01,Ohio,8985195,5816035,5275424,540611
2011-01-01,Oklahoma,2857438,1761984,1657557,104427
2011-01-01,Oregon,3051463,1999833,1798493,201340
2011-01-01,Pennsylvania,10098875,6367786,5872521,495265
2011-01-01,Tennessee,4954125,3117268,2818458,298810
2011-01-01,Texas,18807299,12391831,11377422,1014409
2011-01-01,Utah,1976608,1344519,1239913,104606
2011-01-01,Vermont,509005,359441,337829,21612
2011-01-01,Virginia,6209446,4183595,3901342,282253
2011-01-01,Washington,5281394,3447125,3139152,307973
2011-01-01,Wisconsin,4447290,3072930,2834013,238917
2011-01-01,Wyoming,435435,302548,282676,19872
2011-02-01,Alabama,3718178,2212917,1991849,221068
2011-02-01,Alaska,525057,363514,334711,28803
2011-02-01,Arizona,4898622,3060176,2761805,298371
2011-02-01,Arkansas,2248324,1355709,1247149,108560
2011-02-01,California,28826883,18359121,16127796,2231325
2011-02-01,Colorado,3900018,2717045,2474007,243038
2011-02-01,Connecticut,2822128,1915799,1736443,179356
2011-02-01,Delaware,708429,442047,407022,35025
2011-02-01,Florida,15130726,9252149,8280635,971514
2011-02-01,Georgia,7349349,4713939,4222918,491021
2011-02-01,Hawaii,1051535,661609,617144,44465
2011-02-01,Idaho,1174126,761435,697172,64263
2011-02-01,Illinois,9930629,6554409,5929766,624643
2011-02-01,Indiana,4991071,3170670,2889335,281335
2011-02-01,Iowa,2370604,1676002,1579056,96946
2011-02-01,Kansas,2157303,1499954,1399506,100448
2011-02-01,Kentucky,3363785,2066889,1867770,199119
2011-02-01,Louisiana,3465991,2084405,1924223,160182
2011-02-01,Maine,1077709,698816,643048,55768
2011-02-01,Maryland,4534863,3094149,2864621,229528
2011-02-01,Massachusetts,5275498,3482261,3220677,261584
2011-02-01,Michigan,7742608,4665113,4180564,484549
2011-02-01,Minnesota,4137246,2947224,2747825,199399
2011-02-01,Mississippi,2241481,1347354,1214734,132620
2011-02-01,Missouri,4640819,3040520,2761650,278870
2011-02-01,Montana,782278,499700,465116,34584
2011-02-01,Nebraska,1396240,999312,953729,45583
2011-02-01,Nevada,2085509,1357524,1172858,184666
2011-02-01,Ohio,8986497,5804853,5274342,530511
2011-02-01,Oklahoma,2858912,1760853,1659149,101704
2011-02-01,Oregon,3054102,1998756,1801913,196843
2011-02-01,Pennsylvania,10101882,6366806,5876807,489999
2011-02-01,Tennessee,4956991,3121614,2824825,296789
2011-02-01,Texas,18834479,12409993,11398153,1011840
2011-02-01,Utah,1979059,1344597,1240415,104182
2011-02-01,Vermont,509200,359320,337959,21361
2011-02-01,Virginia,6214418,4187549,3909662,277887
2011-02-01,Washington,5286052,3443437,3139149,304288
2011-02-01,Wisconsin,4448743,3071357,2835627,235730
2011-02-01,Wyoming,435625,302436,282854,19582
2011-03-01,Alabama,3719329,2210958,1991840,219118
2011-03-01,Alaska,525998,363451,334935,28516
2011-03-01,Arizona,4903936,3057262,2761339,295923
2011-03-01,Arkansas,2249580,1354508,1246167,108341
2011-03-01,California,28851906,18354669,16139805,2214864
2011-03-01,Colorado,3905335,2717265,2478257,239008
2011-03-01,Connecticut,2823420,1914283,1736677,177606
2011-03-01,Delaware,709022,442611,408089,34522
2011-03-01,Florida,15145898,9250847,8290918,959929
2011-03-01,Georgia,7355534,4716845,4229650,487195
2011-03-01,Hawaii,1052652,662006,617560,44446
2011-03-01,Idaho,1175062,761692,697768,63924
2011-03-01,Illinois,9934177,6548847,5923813,625034
2011-03-01,Indiana,4993128,3173805,2895813,277992
2011-03-01,Iowa,2371487,1674053,1578220,95833
2011-03-01,Kansas,2158094,1499072,1400245,98827
2011-03-01,Kentucky,3365375,2065391,1868492,196899
2011-03-01,Louisiana,3468626,2081558,1923559,157999
2011-03-01,Maine,1077980,698343,643153,55190
2011-03-01,Maryland,4538624,3093519,2865617,227902
2011-03-01,Massachusetts,5279236,3479416,3221128,258288
2011-03-01,Michigan,7744339,4643729,4182090,461639
2011-03-01,Minnesota,4139617,2948872,2751699,197173
2011-03-01,Mississippi,2242215,1347717,1215162,132555
2011-03-01,Missouri,4642214,3038234,2763601,274633
2011-03-01,Montana,782660,499536,465377,34159
2011-03-01,Nebraska,1396850,1000380,955070,45310
2011-03-01,Nevada,2086463,1357202,1173836,183366
2011-03-01,Ohio,8987798,5793724,5270128,523596
2011-03-01,Oklahoma,2860602,1759425,1660147,99278
2011-03-01,Oregon,3056622,1997052,1803636,193416
2011-03-01,Pennsylvania,10104727,6364495,5877895,486600
2011-03-01,Tennessee,4960063,3124286,2830057,294229
2011-03-01,Texas,18862126,12426745,11416366,1010379
2011-03-01,Utah,1981579,1344706,1240829,103877
2011-03-01,Vermont,509462,358981,337921,21060
2011-03-01,Virginia,6220972,4189997,3915249,274748
2011-03-01,Washington,5291169,3440138,3139014,301124
2011-03-01,Wisconsin,4450178,3069439,2835861,233578
2011-03-01,Wyoming,435792,302188,283016,19172
2011-04-01,Alabama,3720594,2208488,1990933,217555
2011-04-01,Alaska,526677,363367,335095,28272
2011-04-01,Arizona,4909573,3054212,2760059,294153
2011-04-01,Arkansas,2250956,1353056,1244909,108147
2011-04-01,California,28878193,18352428,16147585,2204843
2011-04-01,Colorado,3910501,2717501,2481268,236233
2011-04-01,Connecticut,2824880,1912529,1736438,176091
2011-04-01,Delaware,709653,442904,408731,34173
2011-04-01,Florida,15161610,9247888,8297312,950576
2011-04-01,Georgia,7361501,4720314,4235488,484826
2011-04-01,Hawaii,1053281,661862,617235,44627
2011-04-01,Idaho,1176067,761780,698168,63612
2011-04-01,Illinois,9938364,6547150,5917025,630125
2011-04-01,Indiana,4995709,3177281,2899609,277672
2011-04-01,Iowa,2372558,1671639,1576628,95011
2011-04-01,Kansas,2158718,1497707,1400475,97232
2011-04-01,Kentucky,3366900,2063457,1867982,195475
2011-04-01,Louisiana,3471308,2077821,1922007,155814
2011-04-01,Maine,1078360,697858,643097,54761
2011-04-01,Maryland,4542385,3092166,2865055,227111
2011-04-01,Massachusetts,5283400,3476255,3220663,255592
2011-04-01,Michigan,7746818,4649446,4182815,466631
2011-04-01,Minnesota,4142356,2950303,2753517,196786
2011-04-01,Mississippi,2242874,1347672,1214885,132787
2011-04-01,Missouri,4643748,3035428,2764617,270811
2011-04-01,Montana,783082,499306,465514,33792
2011-04-01,Nebraska,1397510,1000982,955970,45012
2011-04-01,Nevada,2087465,1357102,1174492,182610
2011-04-01,Ohio,8989863,5784616,5264185,520431
2011-04-01,Oklahoma,2862265,1758254,1660641,97613
2011-04-01,Oregon,3059486,1995371,1803756,191615
2011-04-01,Pennsylvania,10108542,6362143,5875646,486497
2011-04-01,Tennessee,4963320,3124721,2832937,291784
2011-04-01,Texas,18890272,12444275,11431447,1012828
2011-04-01,Utah,1984210,1344845,1241064,103781
2011-04-01,Vermont,509732,358434,337692,20742
2011-04-01,Virginia,6226145,4191359,3917774,273585
2011-04-01,Washington,5296088,3437612,3138956,298656
2011-04-01,Wisconsin,4452042,3067488,2834768,232720
2011-04-01,Wyoming,435951,301888,283155,18733
2011-05-01,Alabama,3721955,2205934,1989359,216575
2011-05-01,Alaska,527433,363406,335267,28139
2011-05-01,Arizona,4915290,3051429,2758301,293128
2011-05-01,Arkansas,2252425,1352224,1244047,108177
2011-05-01,California,28904789,18358639,16155067,2203572
2011-05-01,Colorado,3915913,2719021,2483775,235246
2011-05-01,Connecticut,2826494,1911140,1736109,175031
2011-05-01,Delaware,710295,443006,408994,34012
2011-05-01,Florida,15177934,9246195,8302264,943931
2011-05-01,Georgia,7367896,4725451,4240831,484620
2011-05-01,Hawaii,1054070,661495,616453,45042
2011-05-01,Idaho,1177152,761901,698553,63348
2011-05-01,Illinois,9942921,6550817,5911356,639461
2011-05-01,Indiana,4998403,3181683,2901364,280319
2011-05-01,Iowa,2373762,1669479,1574841,94638
2011-05-01,Kansas,2159579,1496444,1400405,96039
2011-05-01,Kentucky,3368682,2061619,1866520,195099
2011-05-01,Louisiana,3474088,2074388,1920250,154138
2011-05-01,Maine,1078807,697593,643030,54563
2011-05-01,Maryland,4546292,3091054,2863648,227406
2011-05-01,Massachusetts,5287766,3474604,3220732,253872
2011-05-01,Michigan,7749462,4655295,4183535,471760
2011-05-01,Minnesota,4145265,2952020,2754433,197587
2011-05-01,Mississippi,2243657,1347406,1214100,133306
2011-05-01,Missouri,4645581,3032973,2764945,268028
2011-05-01,Montana,783539,499226,465635,33591
2011-05-01,Nebraska,1398234,1001373,956621,44752
2011-05-01,Nevada,2088489,1357610,1175043,182567
2011-05-01,Ohio,8992219,5778681,5258057,520624
2011-05-01,Oklahoma,2864136,1758164,1661115,97049
2011-05-01,Oregon,3062462,1994438,1802840,191598
2011-05-01,Pennsylvania,10112630,6362257,5872236,490021
2011-05-01,Tennessee,4966716,3123434,2833384,290050
2011-05-01,Texas,18918815,12467134,11445785,1021349
2011-05-01,Utah,1986941,1345294,1241349,103945
2011-05-01,Vermont,510055,357830,337364,20466
2011-05-01,Virginia,6231923,4193417,3918828,274589
2011-05-01,Washington,5301308,3436211,3139194,297017
2011-05-01,Wisconsin,4454088,3066514,2833324,233190
2011-05-01,Wyoming,436185,301719,283312,18407
2011-06-01,Alabama,3723324,2203524,1987938,215586
2011-06-01,Alaska,528424,363679,335579,28100
2011-06-01,Arizona,4921061,3049264,2757097,292167
2011-06-01,Arkansas,2253923,1352740,1244430,108310
2011-06-01,California,28932601,18375161,16169321,2205840
2011-06-01,Colorado,3921602,2722599,2487089,235510
2011-06-01,Connecticut,2828103,1910692,1736564,174128
2011-06-01,Delaware,710947,443112,409159,33953
2011-06-01,Florida,15194605,9247380,8309731,937649
2011-06-01,Georgia,7374731,4732626,4247308,485318
2011-06-01,Hawaii,1055250,661170,615617,45553
2011-06-01,Idaho,1178222,762271,699223,63048
2011-06-01,Illinois,9947621,6558897,5908670,650227
2011-06-01,Indiana,5000969,3186877,2902198,284679
2011-06-01,Iowa,2374926,1668016,1573438,94578
2011-06-01,Kansas,2160579,1495824,1400534,95290
2011-06-01,Kentucky,3370550,2060245,1865052,195193
2011-06-01,Louisiana,3476941,2072589,1919502,153087
2011-06-01,Maine,1079234,697688,643236,54452
2011-06-01,Maryland,4550304,3091103,2862954,228149
2011-06-01,Massachusetts,5292032,3475347,3222636,252711
2011-06-01,Michigan,7751914,4661368,4186322,475046
2011-06-01,Minnesota,4148114,2953753,2755639,198114
2011-06-01,Mississippi,2244505,1347132,1213310,133822
2011-06-01,Missouri,4647502,3031540,2765678,265862
2011-06-01,Montana,784030,499502,465976,33526
2011-06-01,Nebraska,1399025,1001954,957429,44525
2011-06-01,Nevada,2089613,1358808,1175945,182863
2011-06-01,Ohio,8994387,5774881,5253336,521545
2011-06-01,Oklahoma,2866167,1759602,1662261,97341
2011-06-01,Oregon,3065386,1994170,1801687,192483
2011-06-01,Pennsylvania,10116545,6366245,5870872,495373
2011-06-01,Tennessee,4970183,3121176,2832604,288572
2011-06-01,Texas,18948373,12497108,11463413,1033695
2011-06-01,Utah,1989686,1346394,1242153,104241
2011-06-01,Vermont,510359,357343,337129,20214
2011-06-01,Virginia,6238757,4197326,3920664,276662
2011-06-01,Washington,5306985,3435558,3139899,295659
2011-06-01,Wisconsin,4456029,3067022,2832807,234215
2011-06-01,Wyoming,436390,301800,283564,18236
2011-07-01,Alabama,3725094,2201393,1987565,213828
2011-07-01,Alaska,529293,364268,336147,28121
2011-07-01,Arizona,4927327,3047928,2757526,290402
2011-07-01,Arkansas,2255622,1354815,1246487,108328
2011-07-01,California,28961854,18400252,16196030,2204222
2011-07-01,Colorado,3927503,2728230,2492162,236068
2011-07-01,Connecticut,2829939,1911543,1738579,172964
2011-07-01,Delaware,711649,443468,409601,33867
2011-07-01,Florida,15212690,9251715,8322847,928868
2011-07-01,Georgia,7381294,4741366,4256369,484997
2011-07-01,Hawaii,1056275,660995,615010,45985
2011-07-01,Idaho,1179418,763074,700436,62638
2011-07-01,Illinois,9952918,6568779,5909893,658886
2011-07-01,Indiana,5004175,3192548,2903557,288991
2011-07-01,Iowa,2376369,1667412,1572853,94559
2011-07-01,Kansas,2161702,1496109,1401222,94887
2011-07-01,Kentucky,3372658,2059549,1864549,195000
2011-07-01,Louisiana,3480139,2073250,1920667,152583
2011-07-01,Maine,1079736,698174,643935,54239
2011-07-01,Maryland,4554788,3092882,2864451,228431
2011-07-01,Massachusetts,5296946,3478517,3227066,251451
2011-07-01,Michigan,7755325,4667917,4192853,475064
2011-07-01,Minnesota,4151463,2955400,2758359,197041
2011-07-01,Mississippi,2245527,1346784,1212959,133825
2011-07-01,Missouri,4649586,3031325,2767805,263520
2011-07-01,Montana,784578,500212,466749,33463
2011-07-01,Nebraska,1399924,1003040,958709,44331
2011-07-01,Nevada,2090907,1360553,1177623,182930
2011-07-01,Ohio,8997660,5771503,5251468,520035
2011-07-01,Oklahoma,2868176,1762735,1664718,98017
2011-07-01,Oregon,3068628,1994525,1801501,193024
2011-07-01,Pennsylvania,10121700,6374425,5874119,500306
2011-07-01,Tennessee,4974165,3118930,2832382,286548
2011-07-01,Texas,18978851,12534220,11487969,1046251
2011-07-01,Utah,1992633,1342776,1243911,98865
2011-07-01,Vermont,510702,357058,337145,19913
2011-07-01,Virginia,6245595,4203699,3925109,278590
2011-07-01,Washington,5312903,3434917,3141096,293821
2011-07-01,Wisconsin,4458463,3069100,2834342,234758
2011-07-01,Wyoming,436630,302182,283980,18202
2011-08-01,Alabama,3727077,2199378,1988543,210835
2011-08-01,Alaska,529932,365018,336857,28161
2011-08-01,Arizona,4934665,3047345,2759876,287469
2011-08-01,Arkansas,2256748,1357919,1249882,108037
2011-08-01,California,28992652,18428801,16234039,2194762
2011-08-01,Colorado,3933549,2735039,2498664,236375
2011-08-01,Connecticut,2831528,1913385,1742023,171362
2011-08-01,Delaware,712334,444138,410471,33667
2011-08-01,Florida,15233573,9261107,8341528,919579
2011-08-01,Georgia,7389941,4750409,4267651,482758
2011-08-01,Hawaii,1057360,660874,614669,46205
2011-08-01,Idaho,1180641,764301,702187,62114
2011-08-01,Illinois,9956696,6577947,5914841,663106
2011-08-01,Indiana,5006739,3197873,2906147,291726
2011-08-01,Iowa,2377594,1667469,1573169,94300
2011-08-01,Kansas,2163057,1497076,1402453,94623
2011-08-01,Kentucky,3374290,2059402,1865360,194042
2011-08-01,Louisiana,3482300,2076019,1923582,152437
2011-08-01,Maine,1080008,698915,645058,53857
2011-08-01,Maryland,4559232,3096098,2868279,227819
2011-08-01,Massachusetts,5301948,3483335,3233573,249762
2011-08-01,Michigan,7758849,4674626,4202912,471714
2011-08-01,Minnesota,4154458,2956624,2762729,193895
2011-08-01,Mississippi,2246385,1346413,1213238,133175
2011-08-01,Missouri,4651535,3031636,2771395,260241
2011-08-01,Montana,785191,501247,467977,33270
2011-08-01,Nebraska,1400978,1004575,960475,44100
2011-08-01,Nevada,2093893,1362462,1180132,182330
2011-08-01,Ohio,9000165,5767102,5252818,514284
2011-08-01,Oklahoma,2870614,1767198,1668501,98697
2011-08-01,Oregon,3071373,1995328,1802792,192536
2011-08-01,Pennsylvania,10125377,6385122,5881816,503306
2011-08-01,Tennessee,4978538,3116910,2833535,283375
2011-08-01,Texas,19010408,12546014,11519770,1026244
2011-08-01,Utah,1995505,1340068,1246666,93402
2011-08-01,Vermont,510779,356927,337389,19538
2011-08-01,Virginia,6252917,4211579,3932076,279503
2011-08-01,Washington,5319387,3434295,3143050,291245
2011-08-01,Wisconsin,4460535,3072085,2838003,234082
2011-08-01,Wyoming,437302,302814,284545,18269
2011-09-01,Alabama,3729221,2197051,1990625,206426
2011-09-01,Alaska,530484,365643,337487,28156
2011-09-01,Arizona,4942294,3047212,2763942,283270
2011-09-01,Arkansas,2258033,1361072,1253820,107252
2011-09-01,California,29024770,18453635,16277760,2175875
2011-09-01,Colorado,3939619,2741753,2505623,236130
2011-09-01,Connecticut,2833192,1915535,1746278,169257
2011-09-01,Delaware,713095,444928,411634,33294
2011-09-01,Florida,15255186,9265057,8363923,901134
2011-09-01,Georgia,7398785,4758203,4279885,478318
2011-09-01,Hawaii,1058144,660501,614430,46071
2011-09-01,Idaho,1181963,765783,704282,61501
2011-09-01,Illinois,9961151,6585180,5924042,661138
2011-09-01,Indiana,5009696,3201966,2910302,291664
2011-09-01,Iowa,2379045,1667811,1574205,93606
2011-09-01,Kansas,2164394,1498090,1403990,94100
2011-09-01,Kentucky,3375991,2059397,1867511,191886
2011-09-01,Louisiana,3484631,2079673,1927408,152265
2011-09-01,Maine,1080363,699670,646382,53288
2011-09-01,Maryland,4563796,3099892,2873749,226143
2011-09-01,Massachusetts,5307262,3488645,3241226,247419
2011-09-01,Michigan,7762898,4680596,4215213,465383
2011-09-01,Minnesota,4157759,2956803,2767696,189107
2011-09-01,Mississippi,2247302,1346047,1214189,131858
2011-09-01,Missouri,4653762,3031257,2775879,255378
2011-09-01,Montana,785840,502388,469513,32875
2011-09-01,Nebraska,1402092,1006289,962554,43735
2011-09-01,Nevada,2096935,1364043,1183282,180761
2011-09-01,Ohio,9003266,5760793,5256975,503818
2011-09-01,Oklahoma,2873141,1772359,1673387,98972
2011-09-01,Oregon,3074353,1995988,1805189,190799
2011-09-01,Pennsylvania,10129765,6395422,5892027,503395
2011-09-01,Tennessee,4983075,3114511,2835806,278705
2011-09-01,Texas,19042812,12559256,11556548,1002708
2011-09-01,Utah,1998526,1338091,1250211,87880
2011-09-01,Vermont,510881,356866,337751,19115
2011-09-01,Virginia,6259719,4219107,3940336,278771
2011-09-01,Washington,5325852,3434445,3146622,287823
2011-09-01,Wisconsin,4462951,3074803,2842921,231882
2011-09-01,Wyoming,438037,303525,285193,18332
2011-10-01,Alabama,3731395,2194108,1992980,201128
2011-10-01,Alaska,531239,365963,337901,28062
2011-10-01,Arizona,4949772,3047502,2769137,278365
2011-10-01,Arkansas,2259197,1363485,1257461,106024
2011-10-01,California,29057308,18470587,16320810,2149777
2011-10-01,Colorado,3945966,2747237,2511976,235261
2011-10-01,Connecticut,2834869,1917084,1750252,166832
2011-10-01,Delaware,713826,445636,412856,32780
2011-10-01,Florida,15276781,9276833,8387525,889308
2011-10-01,Georgia,7408384,4764049,4291750,472299
2011-10-01,Hawaii,1059477,659648,614041,45607
2011-10-01,Idaho,1183280,767335,706484,60851
2011-10-01,Illinois,9965604,6589604,5936827,652777
2011-10-01,Indiana,5012382,3204480,2915887,288593
2011-10-01,Iowa,2380345,1668085,1575631,92454
2011-10-01,Kansas,2165921,1498563,1405412,93151
2011-10-01,Kentucky,3377830,2058960,1870409,188551
2011-10-01,Louisiana,3486935,2083093,1931181,151912
2011-10-01,Maine,1080688,700205,647591,52614
2011-10-01,Maryland,4568504,3103611,2879948,223663
2011-10-01,Massachusetts,5312353,3493484,3248942,244542
2011-10-01,Michigan,7766568,4684885,4227863,457022
2011-10-01,Minnesota,4160868,2955882,2772119,183763
2011-10-01,Mississippi,2248307,1345330,1215492,129838
2011-10-01,Missouri,4656052,3029495,2780269,249226
2011-10-01,Montana,786491,503378,471088,32290
2011-10-01,Nebraska,1403237,1007812,964612,43200
2011-10-01,Nevada,2099973,1364991,1186737,178254
2011-10-01,Ohio,9005983,5753316,5263328,489988
2011-10-01,Oklahoma,2875894,1777478,1678931,98547
2011-10-01,Oregon,3077143,1996000,1807834,188166
2011-10-01,Pennsylvania,10133621,6403565,5903108,500457
2011-10-01,Tennessee,4987636,3111419,2838553,272866
2011-10-01,Texas,19075801,12570673,11594803,975870
2011-10-01,Utah,2001502,1336631,1254196,82435
2011-10-01,Vermont,510996,356776,338090,18686
2011-10-01,Virginia,6268025,4224836,3948490,276346
2011-10-01,Washington,5332729,3436373,3152344,284029
2011-10-01,Wisconsin,4465132,3076325,2847838,228487
2011-10-01,Wyoming,438779,304140,285821,18319
2011-11-01,Alabama,3733018,2190069,1994495,195574
2011-11-01,Alaska,531683,365959,338096,27863
2011-11-01,Arizona,4956614,3047623,2774329,273294
2011-11-01,Arkansas,2260105,1364537,1260075,104462
2011-11-01,California,29086234,18475806,16356584,2119222
2011-11-01,Colorado,3951498,2750166,2516276,233890
2011-11-01,Connecticut,2836156,1917061,1752728,164333
2011-11-01,Delaware,714415,446063,413853,32210
2011-11-01,Florida,15295953,9285382,8409108,876274
2011-11-01,Georgia,7416536,4767256,4301696,465560
2011-11-01,Hawaii,1060261,658261,613338,44923
2011-11-01,Idaho,1184380,768639,708451,60188
2011-11-01,Illinois,9968779,6590025,5950626,639399
2011-11-01,Indiana,5014631,3204528,2921443,283085
2011-11-01,Iowa,2381354,1667807,1576906,90901
2011-11-01,Kansas,2166958,1498063,1406203,91860
2011-11-01,Kentucky,3379079,2057306,1873049,184257
2011-11-01,Louisiana,3488699,2085470,1934241,151229
2011-11-01,Maine,1080869,700345,648450,51895
2011-11-01,Maryland,4572406,3106452,2885725,220727
2011-11-01,Massachusetts,5316976,3496743,3255358,241385
2011-11-01,Michigan,7769497,4686341,4238754,447587
2011-11-01,Minnesota,4163536,2953876,2775177,178699
2011-11-01,Mississippi,2248891,1343817,1216515,127302
2011-11-01,Missouri,4657686,3025832,2783434,242398
2011-11-01,Montana,787015,503969,472384,31585
2011-11-01,Nebraska,1404152,1008729,966232,42497
2011-11-01,Nevada,2102736,1365040,1190017,175023
2011-11-01,Ohio,9007712,5745836,5270678,475158
2011-11-01,Oklahoma,2877986,1781679,1684282,97397
2011-11-01,Oregon,3079645,1994860,1809617,185243
2011-11-01,Pennsylvania,10136404,6408612,5913540,495072
2011-11-01,Tennessee,4991472,3107219,2840913,266306
2011-11-01,Texas,19105904,12576962,11630243,946719
2011-11-01,Utah,2004296,1335333,1258132,77201
2011-11-01,Vermont,511024,356508,338251,18257
2011-11-01,Virginia,6274099,4227390,3954876,272514
2011-11-01,Washington,5338490,3440275,3159925,280350
2011-11-01,Wisconsin,4466891,3075869,2851587,224282
2011-11-01,Wyoming,439418,304504,286325,18179
2011-12-01,Alabama,3734683,2185010,1994618,190392
2011-12-01,Alaska,532076,365671,338095,27576
2011-12-01,Arizona,4963381,3047727,2778825,268902
2011-12-01,Arkansas,2261056,1364056,1261291,102765
2011-12-01,California,29114664,18469241,16381644,2087597
2011-12-01,Colorado,3956931,2749769,2517876,231893
2011-12-01,Connecticut,2837493,1915340,1753314,162026
2011-12-01,Delaware,715053,446201,414510,31691
2011-12-01,Florida,15315092,9289835,8426736,863099
2011-12-01,Georgia,7424650,4767599,4308707,458892
2011-12-01,Hawaii,1060869,656523,612414,44109
2011-12-01,Idaho,1185520,769548,709965,59583
2011-12-01,Illinois,9972047,6586549,5962923,623626
2011-12-01,Indiana,5016897,3201486,2925295,276191
2011-12-01,Iowa,2382411,1666736,1577591,89145
2011-12-01,Kansas,2167913,1496515,1406144,90371
2011-12-01,Kentucky,3380258,2054336,1874902,179434
2011-12-01,Louisiana,3490514,2086631,1936543,150088
2011-12-01,Maine,1081085,700108,648912,51196
2011-12-01,Maryland,4576360,3107880,2890142,217738
2011-12-01,Massachusetts,5321573,3497899,3259580,238319
2011-12-01,Michigan,7772459,4684886,4246482,438404
2011-12-01,Minnesota,4166245,2950830,2776403,174427
2011-12-01,Mississippi,2249476,1341351,1216791,124560
2011-12-01,Missouri,4659337,3020372,2784865,235507
2011-12-01,Montana,787517,504138,473258,30880
2011-12-01,Nebraska,1405024,1008982,967276,41706
2011-12-01,Nevada,2105492,1364376,1192847,171529
2011-12-01,Ohio,9009541,5739218,5277947,461271
2011-12-01,Oklahoma,2880077,1784491,1688775,95716
2011-12-01,Oregon,3082145,1992429,1809926,182503
2011-12-01,Pennsylvania,10139206,6411019,5922406,488613
2011-12-01,Tennessee,4995309,3101996,2842262,259734
2011-12-01,Texas,19135673,12576704,11659891,916813
2011-12-01,Utah,2007032,1333971,1261754,72217
2011-12-01,Vermont,511064,356006,338170,17836
2011-12-01,Virginia,6280095,4226121,3958263,267858
2011-12-01,Washington,5344052,3445721,3168491,277230
2011-12-01,Wisconsin,4468666,3073596,2853852,219744
2011-12-01,Wyoming,440037,304580,286683,17897
2012-01-01,Alabama,3736437,2179750,1993523,186227
2012-01-01,Alaska,532472,365200,337946,27254
2012-01-01,Arizona,4970220,3048161,2782738,265423
2012-01-01,Arkansas,2262001,1362428,1261262,101166
2012-01-01,California,29143906,18456650,16397835,2058815
2012-01-01,Colorado,3962382,2747283,2517729,229554
2012-01-01,Connecticut,2838829,1912351,1752189,160162
2012-01-01,Delaware,715709,446183,414872,31311
2012-01-01,Florida,15334438,9292160,8441097,851063
2012-01-01,Georgia,7433130,4765809,4312847,452962
2012-01-01,Hawaii,1061464,654711,611452,43259
2012-01-01,Idaho,1186669,770197,711077,59120
2012-01-01,Illinois,9975600,6580816,5972028,608788
2012-01-01,Indiana,5019202,3195782,2926439,269343
2012-01-01,Iowa,2383466,1665187,1577773,87414
2012-01-01,Kansas,2168823,1494362,1405492,88870
2012-01-01,Kentucky,3381405,2050998,1876189,174809
2012-01-01,Louisiana,3492387,2087233,1938549,148684
2012-01-01,Maine,1081268,699764,649142,50622
2012-01-01,Maryland,4580372,3108021,2892744,215277
2012-01-01,Massachusetts,5326196,3498166,3262377,235789
2012-01-01,Michigan,7775523,4681300,4250546,430754
2012-01-01,Minnesota,4168954,2947490,2776132,171358
2012-01-01,Mississippi,2250158,1338147,1216211,121936
2012-01-01,Missouri,4661081,3013958,2784819,229139
2012-01-01,Montana,788035,504102,473787,30315
2012-01-01,Nebraska,1405885,1008839,967953,40886
2012-01-01,Nevada,2108162,1363603,1195245,168358
2012-01-01,Ohio,9011434,5734275,5284949,449326
2012-01-01,Oklahoma,2882186,1786242,1692448,93794
2012-01-01,Oregon,3084630,1988854,1808723,180131
2012-01-01,Pennsylvania,10142177,6412680,5929453,483227
2012-01-01,Tennessee,4999080,3097157,2843050,254107
2012-01-01,Texas,19165965,12571937,11683759,888178
2012-01-01,Utah,2009736,1335279,1265082,70197
2012-01-01,Vermont,511126,355362,337888,17474
2012-01-01,Virginia,6285701,4222321,3959095,263226
2012-01-01,Washington,5349660,3452355,3177413,274942
2012-01-01,Wisconsin,4470446,3070628,2854971,215657
2012-01-01,Wyoming,440634,304445,286913,17532
2012-02-01,Alabama,3737775,2175635,1992089,183546
2012-02-01,Alaska,533089,364748,337774,26974
2012-02-01,Arizona,4976397,3048882,2786310,262572
2012-02-01,Arkansas,2262688,1360339,1260404,99935
2012-02-01,California,29169798,18447162,16411184,2035978
2012-02-01,Colorado,3967744,2744941,2517116,227825
2012-02-01,Connecticut,2839834,1908624,1749642,158982
2012-02-01,Delaware,716266,446164,415034,31130
2012-02-01,Florida,15351863,9296328,8454837,841491
2012-02-01,Georgia,7441106,4764273,4315884,448389
2012-02-01,Hawaii,1062469,653076,610580,42496
2012-02-01,Idaho,1187686,770719,711923,58796
2012-02-01,Illinois,9977857,6576290,5978214,598076
2012-02-01,Indiana,5020887,3188573,2924640,263933
2012-02-01,Iowa,2384208,1663580,1577533,86047
2012-02-01,Kansas,2169771,1492333,1404669,87664
2012-02-01,Kentucky,3382463,2048659,1877591,171068
2012-02-01,Louisiana,3494007,2088242,1940786,147456
2012-02-01,Maine,1081314,699615,649301,50314
2012-02-01,Maryland,4584142,3108088,2894197,213891
2012-02-01,Massachusetts,5330155,3498974,3264746,234228
2012-02-01,Michigan,7777560,4677505,4251976,425529
2012-02-01,Minnesota,4171190,2944994,2775710,169284
2012-02-01,Mississippi,2250749,1334895,1215042,119853
2012-02-01,Missouri,4662219,3008235,2784077,224158
2012-02-01,Montana,788463,504157,474178,29979
2012-02-01,Nebraska,1406707,1008717,968546,40171
2012-02-01,Nevada,2110764,1363319,1197373,165946
2012-02-01,Ohio,9012201,5731180,5291278,439902
2012-02-01,Oklahoma,2884156,1787662,1695613,92049
2012-02-01,Oregon,3086730,1984596,1806253,178343
2012-02-01,Pennsylvania,10143682,6416137,5935248,480889
2012-02-01,Tennessee,5002582,3094096,2843731,250365
2012-02-01,Texas,19194543,12581835,11704383,877452
2012-02-01,Utah,2012392,1331198,1268263,62935
2012-02-01,Vermont,511107,354783,337552,17231
2012-02-01,Virginia,6292490,4218049,3958507,259542
2012-02-01,Washington,5355254,3459848,3185999,273849
2012-02-01,Wisconsin,4471727,3068522,2855567,212955
2012-02-01,Wyoming,441268,304220,287031,17189
2012-03-01,Alabama,3739321,2173644,1991104,182540
2012-03-01,Alaska,533381,364426,337625,26801
2012-03-01,Arizona,4982803,3050044,2789251,260793
2012-03-01,Arkansas,2263565,1358109,1258810,99299
2012-03-01,California,29195443,18445792,16424830,2020962
2012-03-01,Colorado,3972960,2743601,2516649,226952
2012-03-01,Connecticut,2841002,1904314,1745620,158694
2012-03-01,Delaware,716829,446185,414992,31193
2012-03-01,Florida,15369634,9303773,8468399,835374
2012-03-01,Georgia,7449017,4764404,4318945,445459
2012-03-01,Hawaii,1062816,651755,609893,41862
2012-03-01,Idaho,1188795,771103,712536,58567
2012-03-01,Illinois,9980816,6574536,5981261,593275
2012-03-01,Indiana,5023170,3180618,2919810,260808
2012-03-01,Iowa,2385211,1662015,1576690,85325
2012-03-01,Kansas,2170593,1490738,1403751,86987
2012-03-01,Kentucky,3383526,2048252,1879434,168818
2012-03-01,Louisiana,3495696,2089768,1943114,146654
2012-03-01,Maine,1081497,699718,649374,50344
2012-03-01,Maryland,4587822,3108973,2895102,213871
2012-03-01,Massachusetts,5334673,3500416,3266409,234007
2012-03-01,Michigan,7780449,4674978,4251685,423293
2012-03-01,Minnesota,4173907,2943537,2775538,167999
2012-03-01,Mississippi,2251220,1332365,1213667,118698
2012-03-01,Missouri,4663809,3004112,2783008,221104
2012-03-01,Montana,788963,504449,474559,29890
2012-03-01,Nebraska,1407566,1008820,969077,39743
2012-03-01,Nevada,2113359,1363757,1199248,164509
2012-03-01,Ohio,9013965,5727867,5294585,433282
2012-03-01,Oklahoma,2886108,1789039,1698086,90953
2012-03-01,Oregon,3089178,1980071,1802745,177326
2012-03-01,Pennsylvania,10146344,6422861,5939931,482930
2012-03-01,Tennessee,5006319,3092834,2843922,248912
2012-03-01,Texas,19222731,12563758,11722322,841436
2012-03-01,Utah,2015192,1335297,1271263,64034
2012-03-01,Vermont,511158,354381,337236,17145
2012-03-01,Virginia,6297993,4214269,3956965,257304
2012-03-01,Washington,5360596,3466956,3192664,274292
2012-03-01,Wisconsin,4473499,3067746,2855416,212330
2012-03-01,Wyoming,441895,303990,287027,16963
2012-04-01,Alabama,3740838,2173494,1991037,182457
2012-04-01,Alaska,533893,364174,337455,26719
2012-04-01,Arizona,4989316,3051345,2791656,259689
2012-04-01,Arkansas,2264414,1355831,1256764,99067
2012-04-01,California,29222479,18449665,16440520,2009145
2012-04-01,Colorado,3978413,2743294,2516847,226447
2012-04-01,Connecticut,2842175,1899200,1740242,158958
2012-04-01,Delaware,717434,446181,414769,31412
2012-04-01,Florida,15387537,9312582,8481558,831024
2012-04-01,Georgia,7457330,4765619,4322617,443002
2012-04-01,Hawaii,1063591,650783,609546,41237
2012-04-01,Idaho,1189917,771346,713010,58336
2012-04-01,Illinois,9983758,6574291,5981264,593027
2012-04-01,Indiana,5025264,3172844,2913076,259768
2012-04-01,Iowa,2386148,1660230,1575227,85003
2012-04-01,Kansas,2171582,1489485,1402934,86551
2012-04-01,Kentucky,3384772,2049721,1881638,168083
2012-04-01,Louisiana,3497367,2090997,1945016,145981
2012-04-01,Maine,1081643,699864,649294,50570
2012-04-01,Maryland,4591610,3110612,2895918,214694
2012-04-01,Massachusetts,5339050,3501752,3267063,234689
2012-04-01,Michigan,7783072,4673683,4250642,423041
2012-04-01,Minnesota,4176493,2942677,2775106,167571
2012-04-01,Mississippi,2251754,1330658,1212323,118335
2012-04-01,Missouri,4665382,3001221,2782139,219082
2012-04-01,Montana,789449,504942,474995,29947
2012-04-01,Nebraska,1408411,1009179,969646,39533
2012-04-01,Nevada,2116001,1364616,1200986,163630
2012-04-01,Ohio,9015464,5721910,5293517,428393
2012-04-01,Oklahoma,2888262,1790363,1699795,90568
2012-04-01,Oregon,3091529,1975219,1798555,176664
2012-04-01,Pennsylvania,10148660,6431482,5943284,488198
2012-04-01,Tennessee,5010012,3092229,2843514,248715
2012-04-01,Texas,19251790,12588954,11737849,851105
2012-04-01,Utah,2017934,1338994,1274152,64842
2012-04-01,Vermont,511169,354130,336947,17183
2012-04-01,Virginia,6304108,4210876,3954894,255982
2012-04-01,Washington,5366242,3472271,3196410,275861
2012-04-01,Wisconsin,4475073,3067471,2854173,213298
2012-04-01,Wyoming,442538,303802,286933,16869
2012-05-01,Alabama,3742396,2174754,1992484,182270
2012-05-01,Alaska,534483,364032,337365,26667
2012-05-01,Arizona,4995794,3052719,2794227,258492
2012-05-01,Arkansas,2265279,1353594,1254657,98937
2012-05-01,California,29249074,18457489,16462781,1994708
2012-05-01,Colorado,3984038,2744233,2518570,225663
2012-05-01,Connecticut,2843391,1893644,1734363,159281
2012-05-01,Delaware,717996,446177,414524,31653
2012-05-01,Florida,15405602,9322199,8496177,826022
2012-05-01,Georgia,7465750,4767757,4327976,439781
2012-05-01,Hawaii,1064477,650165,609679,40486
2012-05-01,Idaho,1191067,771563,713524,58039
2012-05-01,Illinois,9986723,6576078,5981247,594831
2012-05-01,Indiana,5027375,3166824,2906905,259919
2012-05-01,Iowa,2387179,1658427,1573642,84785
2012-05-01,Kansas,2172714,1488736,1402661,86075
2012-05-01,Kentucky,3386098,2052837,1884530,168307
2012-05-01,Louisiana,3499054,2091414,1946434,144980
2012-05-01,Maine,1081842,700078,649263,50815
2012-05-01,Maryland,4595395,3113280,2897677,215603
2012-05-01,Massachusetts,5343485,3503312,3267718,235594
2012-05-01,Michigan,7785658,4674360,4250834,423526
2012-05-01,Minnesota,4179146,2942728,2775088,167640
2012-05-01,Mississippi,2252365,1329787,1211394,118393
2012-05-01,Missouri,4667067,2999746,2782417,217329
2012-05-01,Montana,789993,505634,475624,30010
2012-05-01,Nebraska,1409361,1009977,970546,39431
2012-05-01,Nevada,2118612,1365728,1202977,162751
2012-05-01,Ohio,9016980,5714684,5290887,423797
2012-05-01,Oklahoma,2890509,1791951,1701275,90676
2012-05-01,Oregon,3093887,1970481,1794592,175889
2012-05-01,Pennsylvania,10151079,6440986,5946445,494541
2012-05-01,Tennessee,5013814,3092082,2843398,248684
2012-05-01,Texas,19280899,12611625,11754758,856867
2012-05-01,Utah,2020773,1342475,1277306,65169
2012-05-01,Vermont,511223,354020,336755,17265
2012-05-01,Virginia,6310753,4208645,3953818,254827
2012-05-01,Washington,5372135,3475950,3198232,277718
2012-05-01,Wisconsin,4476792,3067402,2852787,214615
2012-05-01,Wyoming,443188,303711,286848,16863
2012-06-01,Alabama,3744108,2176818,1995546,181272
2012-06-01,Alaska,535035,363960,337406,26554
2012-06-01,Arizona,5002599,3054066,2797416,256650
2012-06-01,Arkansas,2266248,1351226,1252563,98663
2012-06-01,California,29277450,18468110,16494261,1973849
2012-06-01,Colorado,3989781,2746042,2521989,224053
2012-06-01,Connecticut,2844747,1887999,1728720,159279
2012-06-01,Delaware,718652,446176,414378,31798
2012-06-01,Florida,15424547,9332286,8513758,818528
2012-06-01,Georgia,7474404,4770468,4335207,435261
2012-06-01,Hawaii,1065305,649786,610269,39517
2012-06-01,Idaho,1192291,771845,714218,57627
2012-06-01,Illinois,9990366,6579685,5983696,595989
2012-06-01,Indiana,5029844,3163404,2903332,260072
2012-06-01,Iowa,2388331,1657167,1572697,84470
2012-06-01,Kansas,2173881,1488524,1403130,85394
2012-06-01,Kentucky,3387548,2057041,1888219,168822
2012-06-01,Louisiana,3500949,2090759,1947689,143070
2012-06-01,Maine,1082090,700348,649429,50919
2012-06-01,Maryland,4599386,3116975,2900940,216035
2012-06-01,Massachusetts,5348291,3505430,3269278,236152
2012-06-01,Michigan,7788775,4676951,4253239,423712
2012-06-01,Minnesota,4182116,2944302,2776517,167785
2012-06-01,Mississippi,2253035,1329476,1211194,118282
2012-06-01,Missouri,4668979,2999577,2784194,215383
2012-06-01,Montana,790548,506446,476486,29960
2012-06-01,Nebraska,1410340,1011216,971883,39333
2012-06-01,Nevada,2121395,1366798,1205447,161351
2012-06-01,Ohio,9019108,5708474,5289595,418879
2012-06-01,Oklahoma,2892866,1793879,1702959,90920
2012-06-01,Oregon,3096538,1966171,1791433,174738
2012-06-01,Pennsylvania,10154135,6450474,5950829,499645
2012-06-01,Tennessee,5017869,3092371,2844370,248001
2012-06-01,Texas,19311048,12632078,11776105,855973
2012-06-01,Utah,2023694,1345980,1280955,65025
2012-06-01,Vermont,511282,353999,336688,17311
2012-06-01,Virginia,6317350,4208558,3955368,253190
2012-06-01,Washington,5378257,3478835,3199945,278890
2012-06-01,Wisconsin,4478791,3067586,2852421,215165
2012-06-01,Wyoming,443886,303733,286852,16881
2012-07-01,Alabama,3745940,2178985,1999860,179125
2012-07-01,Alaska,535584,363887,337576,26311
2012-07-01,Arizona,5009540,3055366,2801303,254063
2012-07-01,Arkansas,2267294,1348643,1250599,98044
2012-07-01,California,29305807,18479876,16534689,1945187
2012-07-01,Colorado,3995677,2748077,2526809,221268
2012-07-01,Connecticut,2846179,1882615,1723907,158708
2012-07-01,Delaware,719282,446132,414347,31785
2012-07-01,Florida,15443876,9342026,8534305,807721
2012-07-01,Georgia,7482739,4773009,4343500,429509
2012-07-01,Hawaii,1066084,649583,611262,38321
2012-07-01,Idaho,1193509,772210,715144,57066
2012-07-01,Illinois,9993695,6583994,5989315,594679
2012-07-01,Indiana,5032436,3162320,2902854,259466
2012-07-01,Iowa,2389557,1656736,1572880,83856
2012-07-01,Kansas,2175109,1488847,1404335,84512
2012-07-01,Kentucky,3389137,2061588,1892555,169033
2012-07-01,Louisiana,3502948,2089201,1949077,140124
2012-07-01,Maine,1082354,700592,649809,50783
2012-07-01,Maryland,4603555,3121317,2905634,215683
2012-07-01,Massachusetts,5353276,3507770,3271778,235992
2012-07-01,Michigan,7792111,4680759,4257873,422886
2012-07-01,Minnesota,4185165,2947024,2779521,167503
2012-07-01,Mississippi,2253714,1329451,1211838,117613
2012-07-01,Missouri,4670914,3000439,2787304,213135
2012-07-01,Montana,791138,507185,477470,29715
2012-07-01,Nebraska,1411388,1012787,973628,39159
2012-07-01,Nevada,2124233,1367483,1208382,159101
2012-07-01,Ohio,9021458,5703982,5290271,413711
2012-07-01,Oklahoma,2895161,1795981,1705012,90969
2012-07-01,Oregon,3099215,1962128,1789026,173102
2012-07-01,Pennsylvania,10157546,6458986,5957166,501820
2012-07-01,Tennessee,5022071,3093294,2847096,246198
2012-07-01,Texas,19341277,12649825,11802014,847811
2012-07-01,Utah,2026680,1349636,1285107,64529
2012-07-01,Vermont,511355,353993,336722,17271
2012-07-01,Virginia,6324085,4210712,3960179,250533
2012-07-01,Washington,5384419,3475293,3203044,272249
2012-07-01,Wisconsin,4480877,3068026,2853712,214314
2012-07-01,Wyoming,444553,303794,286966,16828
2012-08-01,Alabama,3748082,2180942,2004716,176226
2012-08-01,Alaska,535878,363879,337853,26026
2012-08-01,Arizona,5016602,3056822,2805561,251261
2012-08-01,Arkansas,2268387,1346157,1248907,97250
2012-08-01,California,29335993,18494681,16581684,1912997
2012-08-01,Colorado,4001980,2750560,2532901,217659
2012-08-01,Connecticut,2847427,1878205,1720408,157797
2012-08-01,Delaware,720044,446071,414386,31685
2012-08-01,Florida,15465332,9352027,8556664,795363
2012-08-01,Georgia,7489471,4775669,4351928,423741
2012-08-01,Hawaii,1066807,649534,612513,37021
2012-08-01,Idaho,1194918,772638,716202,56436
2012-08-01,Illinois,9997508,6588983,5997041,591942
2012-08-01,Indiana,5035833,3163313,2904676,258637
2012-08-01,Iowa,2391195,1657235,1574109,83126
2012-08-01,Kansas,2176025,1489743,1405991,83752
2012-08-01,Kentucky,3391439,2065968,1897095,168873
2012-08-01,Louisiana,3505274,2087894,1950819,137075
2012-08-01,Maine,1082712,700906,650411,50495
2012-08-01,Maryland,4607139,3126121,2911289,214832
2012-08-01,Massachusetts,5358546,3510235,3274743,235492
2012-08-01,Michigan,7796014,4685915,4264274,421641
2012-08-01,Minnesota,4188566,2950631,2783832,166799
2012-08-01,Mississippi,2254835,1329468,1212890,116578
2012-08-01,Missouri,4673088,3002370,2791175,211195
2012-08-01,Montana,791933,507764,478438,29326
2012-08-01,Nebraska,1412373,1014558,975571,38987
2012-08-01,Nevada,2127048,1367955,1211574,156381
2012-08-01,Ohio,9025886,5701818,5292044,409774
2012-08-01,Oklahoma,2897653,1798319,1707423,90896
2012-08-01,Oregon,3101836,1958250,1786947,171303
2012-08-01,Pennsylvania,10160869,6466612,5964896,501716
2012-08-01,Tennessee,5026242,3095301,2851322,243979
2012-08-01,Texas,19372177,12666216,11830108,836108
2012-08-01,Utah,2030026,1353555,1289584,63971
2012-08-01,Vermont,511540,353956,336820,17136
2012-08-01,Virginia,6329538,4215085,3967765,247320
2012-08-01,Washington,5389609,3472450,3207615,264835
2012-08-01,Wisconsin,4483459,3068963,2856403,212560
2012-08-01,Wyoming,444980,303836,287159,16677
2012-09-01,Alabama,3750371,2182771,2009352,173419
2012-09-01,Alaska,536044,364057,338216,25841
2012-09-01,Arizona,5023844,3058702,2809750,248952
2012-09-01,Arkansas,2269551,1344172,1247567,96605
2012-09-01,California,29367307,18515366,16631825,1883541
2012-09-01,Colorado,4008367,2753956,2539967,213989
2012-09-01,Connecticut,2848760,1875209,1718236,156973
2012-09-01,Delaware,720904,446070,414465,31605
2012-09-01,Florida,15487278,9363037,8578931,784106
2012-09-01,Georgia,7496368,4778749,4359383,419366
2012-09-01,Hawaii,1067398,649620,613823,35797
2012-09-01,Idaho,1196379,773091,717238,55853
2012-09-01,Illinois,10001763,6594683,6003932,590751
2012-09-01,Indiana,5039417,3166249,2907739,258510
2012-09-01,Iowa,2393002,1658681,1576085,82596
2012-09-01,Kansas,2176962,1491050,1407653,83397
2012-09-01,Kentucky,3393813,2069786,1901222,168564
2012-09-01,Louisiana,3507678,2088122,1953077,135045
2012-09-01,Maine,1083081,701441,651204,50237
2012-09-01,Maryland,4610857,3131152,2917104,214048
2012-09-01,Massachusetts,5364133,3512915,3277612,235303
2012-09-01,Michigan,7800273,4692724,4271479,421245
2012-09-01,Minnesota,4192145,2955118,2789269,165849
2012-09-01,Mississippi,2255957,1329339,1213704,115635
2012-09-01,Missouri,4675357,3005264,2795016,210248
2012-09-01,Montana,792794,508244,479327,28917
2012-09-01,Nebraska,1413365,1016381,977411,38970
2012-09-01,Nevada,2129876,1368573,1214739,153834
2012-09-01,Ohio,9030686,5702365,5293329,409036
2012-09-01,Oklahoma,2900237,1800762,1709795,90967
2012-09-01,Oregon,3104634,1954589,1784773,169816
2012-09-01,Pennsylvania,10164609,6473455,5972618,500837
2012-09-01,Tennessee,5030564,3098402,2855937,242465
2012-09-01,Texas,19403718,12683588,11857386,826202
2012-09-01,Utah,2033498,1357700,1294133,63567
2012-09-01,Vermont,511749,353835,336908,16927
2012-09-01,Virginia,6334899,4221076,3976567,244509
2012-09-01,Washington,5394909,3470187,3212569,257618
2012-09-01,Wisconsin,4486283,3070787,2859838,210949
2012-09-01,Wyoming,445436,303842,287381,16461
2012-10-01,Alabama,3752500,2184006,2012918,171088
2012-10-01,Alaska,536291,364283,338526,25757
2012-10-01,Arizona,5030865,3060209,2812844,247365
2012-10-01,Arkansas,2270630,1342472,1246289,96183
2012-10-01,California,29397331,18536565,16678616,1857949
2012-10-01,Colorado,4014667,2757466,2546891,210575
2012-10-01,Connecticut,2849989,1873204,1716902,156302
2012-10-01,Delaware,721681,446007,414443,31564
2012-10-01,Florida,15508601,9372631,8597972,774659
2012-10-01,Georgia,7503210,4780398,4364003,416395
2012-10-01,Hawaii,1068094,649565,614838,34727
2012-10-01,Idaho,1197771,773385,718040,55345
2012-10-01,Illinois,10005658,6598498,6006076,592422
2012-10-01,Indiana,5042788,3169729,2910539,259190
2012-10-01,Iowa,2394680,1660482,1578228,82254
2012-10-01,Kansas,2177847,1492122,1408760,83362
2012-10-01,Kentucky,3396151,2072317,1904250,168067
2012-10-01,Louisiana,3510000,2089992,1955491,134501
2012-10-01,Maine,1083447,702058,652017,50041
2012-10-01,Maryland,4614496,3135207,2921744,213463
2012-10-01,Massachusetts,5369430,3514788,3279317,235471
2012-10-01,Michigan,7804152,4699999,4278209,421790
2012-10-01,Minnesota,4195557,2959485,2795149,164336
2012-10-01,Mississippi,2257102,1328815,1213839,114976
2012-10-01,Missouri,4677466,3007710,2797738,209972
2012-10-01,Montana,793568,508604,480064,28540
2012-10-01,Nebraska,1414318,1017762,978737,39025
2012-10-01,Nevada,2132662,1369063,1217434,151629
2012-10-01,Ohio,9035065,5703549,5291979,411570
2012-10-01,Oklahoma,2902708,1802490,1711251,91239
2012-10-01,Oregon,3107259,1950570,1782030,168540
2012-10-01,Pennsylvania,10167893,6477053,5977594,499459
2012-10-01,Tennessee,5034781,3101365,2859257,242108
2012-10-01,Texas,19434632,12700534,11879763,820771
2012-10-01,Utah,2036856,1361555,1298314,63241
2012-10-01,Vermont,511935,353543,336872,16671
2012-10-01,Virginia,6340613,4226595,3984368,242227
2012-10-01,Washington,5400070,3467617,3216647,250970
2012-10-01,Wisconsin,4488898,3072854,2862941,209913
2012-10-01,Wyoming,445861,303715,287540,16175
2012-11-01,Alabama,3754422,2184400,2015057,169343
2012-11-01,Alaska,536679,364384,338657,25727
2012-11-01,Arizona,5037642,3060910,2814217,246693
2012-11-01,Arkansas,2271525,1340897,1244873,96024
2012-11-01,California,29427545,18553309,16717341,1835968
2012-11-01,Colorado,4020894,2760368,2552987,207381
2012-11-01,Connecticut,2851060,1871522,1715773,155749
2012-11-01,Delaware,722434,445776,414226,31550
2012-11-01,Florida,15529025,9379264,8612023,767241
2012-11-01,Georgia,7510285,4779443,4365109,414334
2012-11-01,Hawaii,1069163,649173,615327,33846
2012-11-01,Idaho,1199143,773460,718524,54936
2012-11-01,Illinois,10009289,6598094,6001684,596410
2012-11-01,Indiana,5045719,3172886,2912626,260260
2012-11-01,Iowa,2396074,1661913,1579766,82147
2012-11-01,Kansas,2178728,1492672,1409248,83424
2012-11-01,Kentucky,3398358,2073384,1905934,167450
2012-11-01,Louisiana,3512113,2092996,1957453,135543
2012-11-01,Maine,1083716,702606,652681,49925
2012-11-01,Maryland,4617887,3137652,2924538,213114
2012-11-01,Massachusetts,5374322,3515318,3279422,235896
2012-11-01,Michigan,7807358,4706523,4283628,422895
2012-11-01,Minnesota,4198575,2962759,2800283,162476
2012-11-01,Mississippi,2258163,1327884,1213261,114623
2012-11-01,Missouri,4679343,3008994,2799168,209826
2012-11-01,Montana,794361,508875,480628,28247
2012-11-01,Nebraska,1415169,1018499,979433,39066
2012-11-01,Nevada,2135395,1369310,1219490,149820
2012-11-01,Ohio,9038657,5703304,5287084,416220
2012-11-01,Oklahoma,2905208,1802927,1711235,91692
2012-11-01,Oregon,3109580,1945807,1778641,167166
2012-11-01,Pennsylvania,10170070,6475700,5977993,497707
2012-11-01,Tennessee,5038650,3103321,2860286,243035
2012-11-01,Texas,19465766,12716045,11895325,820720
2012-11-01,Utah,2040092,1364818,1301946,62872
2012-11-01,Vermont,512079,353111,336683,16428
2012-11-01,Virginia,6346515,4230245,3989727,240518
2012-11-01,Washington,5405191,3464221,3219140,245081
2012-11-01,Wisconsin,4491084,3074792,2864732,210060
2012-11-01,Wyoming,446255,303456,287578,15878
2012-12-01,Alabama,3756121,2183700,2015725,167975
2012-12-01,Alaska,537018,364287,338581,25706
2012-12-01,Arizona,5044028,3060362,2813704,246658
2012-12-01,Arkansas,2272297,1339452,1243386,96066
2012-12-01,California,29455494,18562700,16747321,1815379
2012-12-01,Colorado,4026842,2762211,2558031,204180
2012-12-01,Connecticut,2851914,1869431,1714212,155219
2012-12-01,Delaware,723135,445343,413820,31523
2012-12-01,Florida,15548277,9382701,8621568,761133
2012-12-01,Georgia,7516903,4776076,4363590,412486
2012-12-01,Hawaii,1070064,648487,615337,33150
2012-12-01,Idaho,1200386,773323,718703,54620
2012-12-01,Illinois,10012126,6592899,5991770,601129
2012-12-01,Indiana,5048319,3175152,2914128,261024
2012-12-01,Iowa,2397326,1662647,1580457,82190
2012-12-01,Kansas,2179407,1492648,1409265,83383
2012-12-01,Kentucky,3400281,2072953,1906182,166771
2012-12-01,Louisiana,3514047,2096245,1958519,137726
2012-12-01,Maine,1083895,703024,653171,49853
2012-12-01,Maryland,4621036,3138497,2925667,212830
2012-12-01,Massachusetts,5378843,3514801,3278423,236378
2012-12-01,Michigan,7810081,4711644,4287975,423669
2012-12-01,Minnesota,4201294,2964526,2803934,160592
2012-12-01,Mississippi,2259083,1326506,1212063,114443
2012-12-01,Missouri,4680944,3009177,2799741,209436
2012-12-01,Montana,795056,509103,481061,28042
2012-12-01,Nebraska,1415931,1018587,979573,39014
2012-12-01,Nevada,2137941,1369233,1220968,148265
2012-12-01,Ohio,9041658,5701489,5279998,421491
2012-12-01,Oklahoma,2907466,1802218,1709988,92230
2012-12-01,Oregon,3111712,1940426,1775016,165410
2012-12-01,Pennsylvania,10171681,6469454,5974427,495027
2012-12-01,Tennessee,5042229,3103871,2859008,244863
2012-12-01,Texas,19495239,12730458,11905455,825003
2012-12-01,Utah,2043202,1367434,1305067,62367
2012-12-01,Vermont,512177,352575,336348,16227
2012-12-01,Virginia,6351838,4231663,3992299,239364
2012-12-01,Washington,5409915,3459702,3219911,239791
2012-12-01,Wisconsin,4493010,3076106,2864807,211299
2012-12-01,Wyoming,446641,303094,287479,15615
2013-01-01,Alabama,3757648,2181651,2015043,166608
2013-01-01,Alaska,537343,364023,338344,25679
2013-01-01,Arizona,5050211,3058620,2811785,246835
2013-01-01,Arkansas,2272945,1338053,1241811,96242
2013-01-01,California,29482749,18564212,16769858,1794354
2013-01-01,Colorado,4032567,2762675,2561687,200988
2013-01-01,Connecticut,2852640,1866718,1712022,154696
2013-01-01,Delaware,723860,444691,413236,31455
2013-01-01,Florida,15566837,9383321,8628007,755314
2013-01-01,Georgia,7523422,4771071,4360605,410466
2013-01-01,Hawaii,1070910,647730,615167,32563
2013-01-01,Idaho,1201563,773064,718684,54380
2013-01-01,Illinois,10014774,6584280,5978819,605461
2013-01-01,Indiana,5050615,3176337,2915330,261007
2013-01-01,Iowa,2398438,1662643,1580382,82261
2013-01-01,Kansas,2179995,1492010,1408859,83151
2013-01-01,Kentucky,3402047,2071047,1904810,166237
2013-01-01,Louisiana,3515759,2098900,1958670,140230
2013-01-01,Maine,1084015,703233,653477,49756
2013-01-01,Maryland,4623925,3138015,2925435,212580
2013-01-01,Massachusetts,5383100,3513585,3276681,236904
2013-01-01,Michigan,7812340,4715747,4292124,423623
2013-01-01,Minnesota,4203761,2964871,2806119,158752
2013-01-01,Mississippi,2259916,1316549,1202216,114333
2013-01-01,Missouri,4682302,3008594,2799781,208813
2013-01-01,Montana,795706,509349,481423,27926
2013-01-01,Nebraska,1416648,1018110,979223,38887
2013-01-01,Nevada,2140368,1368931,1222071,146860
2013-01-01,Ohio,9044122,5699301,5272736,426565
2013-01-01,Oklahoma,2909622,1800908,1708092,92816
2013-01-01,Oregon,3113662,1934879,1771649,163230
2013-01-01,Pennsylvania,10172653,6459448,5968637,490811
2013-01-01,Tennessee,5045479,3102423,2855543,246880
2013-01-01,Texas,19524317,12743658,11912520,831138
2013-01-01,Utah,2046163,1369579,1307839,61740
2013-01-01,Vermont,512268,351969,335874,16095
2013-01-01,Virginia,6356655,4230986,3992211,238775
2013-01-01,Washington,5414242,3457127,3219092,238035
2013-01-01,Wisconsin,4494635,3076445,2863647,212798
2013-01-01,Wyoming,446965,302668,287303,15365
2013-02-01,Alabama,3758678,2178756,2013876,164880
2013-02-01,Alaska,537489,363684,338057,25627
2013-02-01,Arizona,5055713,3056893,2810201,246692
2013-02-01,Arkansas,2273256,1336764,1240366,96398
2013-02-01,California,29506019,18561589,16789624,1771965
2013-02-01,Colorado,4037908,2762415,2564483,197932
2013-02-01,Connecticut,2852925,1864254,1710153,154101
2013-02-01,Delaware,724430,443906,412611,31295
2013-02-01,Florida,15582898,9383328,8634844,748484
2013-02-01,Georgia,7528788,4765817,4357909,407908
2013-02-01,Hawaii,1071588,647257,615252,32005
2013-02-01,Idaho,1202567,773031,718812,54219
2013-02-01,Illinois,10015870,6574749,5966349,608400
2013-02-01,Indiana,5052297,3177057,2917239,259818
2013-02-01,Iowa,2399210,1662690,1580469,82221
2013-02-01,Kansas,2180283,1491109,1408465,82644
2013-02-01,Kentucky,3403390,2068320,1902317,166003
2013-02-01,Louisiana,3517123,2100577,1958498,142079
2013-02-01,Maine,1083932,703337,653775,49562
2013-02-01,Maryland,4626344,3136770,2924605,212165
2013-02-01,Massachusetts,5386735,3512599,3275220,237379
2013-02-01,Michigan,7813604,4719805,4297093,422712
2013-02-01,Minnesota,4205765,2964112,2807168,156944
2013-02-01,Mississippi,2260438,1306538,1192627,113911
2013-02-01,Missouri,4682883,3008137,2800121,208016
2013-02-01,Montana,796277,509687,481801,27886
2013-02-01,Nebraska,1417132,1017500,978771,38729
2013-02-01,Nevada,2142588,1368771,1223325,145446
2013-02-01,Ohio,9045438,5698685,5268265,430420
2013-02-01,Oklahoma,2911344,1799714,1706445,93269
2013-02-01,Oregon,3115248,1929899,1769268,160631
2013-02-01,Pennsylvania,10172294,6448317,5963576,484741
2013-02-01,Tennessee,5048169,3099418,2851148,248270
2013-02-01,Texas,19550750,12757010,11921233,835777
2013-02-01,Utah,2048975,1371797,1310766,61031
2013-02-01,Vermont,512289,351387,335357,16030
2013-02-01,Virginia,6360904,4229626,3991100,238526
2013-02-01,Washington,5418035,3447914,3217874,230040
2013-02-01,Wisconsin,4495713,3076554,2862894,213660
2013-02-01,Wyoming,447276,302300,287193,15107
2013-03-01,Alabama,3759971,2175993,2013323,162670
2013-03-01,Alaska,537668,363411,337876,25535
2013-03-01,Arizona,5061297,3056334,2810619,245715
2013-03-01,Arkansas,2273760,1335682,1239345,96337
2013-03-01,California,29528672,18560032,16812502,1747530
2013-03-01,Colorado,4043296,2762705,2567602,195103
2013-03-01,Connecticut,2853432,1863120,1709824,153296
2013-03-01,Delaware,725014,443158,412171,30987
2013-03-01,Florida,15599379,9385906,8646346,739560
2013-03-01,Georgia,7534514,4761620,4357295,404325
2013-03-01,Hawaii,1071995,647266,615831,31435
2013-03-01,Idaho,1203694,773507,719407,54100
2013-03-01,Illinois,10017644,6567333,5958222,609111
2013-03-01,Indiana,5054512,3178518,2921428,257090
2013-03-01,Iowa,2400220,1664171,1582269,81902
2013-03-01,Kansas,2180605,1490526,1408599,81927
2013-03-01,Kentucky,3404973,2065701,1899808,165893
2013-03-01,Louisiana,3518645,2101504,1958880,142624
2013-03-01,Maine,1084035,703516,654325,49191
2013-03-01,Maryland,4628785,3135411,2924180,211231
2013-03-01,Massachusetts,5390711,3513023,3275474,237549
2013-03-01,Michigan,7815609,4724478,4303586,420892
2013-03-01,Minnesota,4208174,2962646,2807616,155030
2013-03-01,Mississippi,2261049,1296897,1183985,112912
2013-03-01,Missouri,4683981,3008816,2801682,207134
2013-03-01,Montana,796883,510119,482245,27874
2013-03-01,Nebraska,1417718,1017147,978654,38493
2013-03-01,Nevada,2144822,1368999,1225232,143767
2013-03-01,Ohio,9047646,5701127,5269020,432107
2013-03-01,Oklahoma,2913218,1799353,1706007,93346
2013-03-01,Oregon,3117028,1926144,1768464,157680
2013-03-01,Pennsylvania,10172856,6439008,5961886,477122
2013-03-01,Tennessee,5051173,3095898,2847593,248305
2013-03-01,Texas,19577084,12772688,11936855,835833
2013-03-01,Utah,2051950,1374623,1314333,60290
2013-03-01,Vermont,512344,350931,334949,15982
2013-03-01,Virginia,6364931,4229584,3991308,238276
2013-03-01,Washington,5421904,3449293,3218064,231229
2013-03-01,Wisconsin,4497218,3077411,2864201,213210
2013-03-01,Wyoming,447597,302083,287262,14821
2013-04-01,Alabama,3761425,2174613,2014210,160403
2013-04-01,Alaska,537746,363341,337923,25418
2013-04-01,Arizona,5067183,3057784,2813639,244145
2013-04-01,Arkansas,2274396,1334874,1238821,96053
2013-04-01,California,29553252,18565682,16842626,1723056
2013-04-01,Colorado,4048786,2764238,2571622,192616
2013-04-01,Connecticut,2854082,1863931,1711614,152317
2013-04-01,Delaware,725670,442681,412135,30546
2013-04-01,Florida,15616676,9394008,8664776,729232
2013-04-01,Georgia,7540542,4759649,4359853,399796
2013-04-01,Hawaii,1072314,647794,616903,30891
2013-04-01,Idaho,1204876,774575,720581,53994
2013-04-01,Illinois,10020076,6564365,5956555,607810
2013-04-01,Indiana,5056968,3181648,2928625,253023
2013-04-01,Iowa,2401380,1668153,1586806,81347
2013-04-01,Kansas,2180991,1490653,1409461,81192
2013-04-01,Kentucky,3406648,2064135,1898417,165718
2013-04-01,Louisiana,3520231,2102390,1960578,141812
2013-04-01,Maine,1084137,704005,655326,48679
2013-04-01,Maryland,4631489,3134729,2925125,209604
2013-04-01,Massachusetts,5395058,3515403,3278014,237389
2013-04-01,Michigan,7818028,4730864,4311970,418894
2013-04-01,Minnesota,4210788,2961290,2808242,153048
2013-04-01,Mississippi,2261758,1288199,1176746,111453
2013-04-01,Missouri,4685292,3011278,2804770,206508
2013-04-01,Montana,797508,510594,482766,27828
2013-04-01,Nebraska,1418345,1017223,978991,38232
2013-04-01,Nevada,2147154,1369806,1227979,141827
2013-04-01,Ohio,9050334,5706929,5274989,431940
2013-04-01,Oklahoma,2915228,1800235,1707161,93074
2013-04-01,Oregon,3119039,1924158,1769494,154664
2013-04-01,Pennsylvania,10173942,6433901,5964767,469134
2013-04-01,Tennessee,5054403,3092912,2845925,246987
2013-04-01,Texas,19604472,12793456,11962083,831373
2013-04-01,Utah,2055016,1378344,1318709,59635
2013-04-01,Vermont,512436,350684,334772,15912
2013-04-01,Virginia,6368944,4232119,3994223,237896
2013-04-01,Washington,5425892,3452380,3220670,231710
2013-04-01,Wisconsin,4499003,3079639,2868180,211459
2013-04-01,Wyoming,447925,302063,287539,14524
2013-05-01,Alabama,3763029,2174482,2015808,158674
2013-05-01,Alaska,538284,363431,338083,25348
2013-05-01,Arizona,5073301,3060694,2818192,242502
2013-05-01,Arkansas,2275077,1334104,1238431,95673
2013-05-01,California,29579760,18576563,16874399,1702164
2013-05-01,Colorado,4054895,2766305,2575647,190658
2013-05-01,Connecticut,2854892,1866153,1714775,151378
2013-05-01,Delaware,726339,442526,412480,30046
2013-05-01,Florida,15635293,9405649,8686257,719392
2013-05-01,Georgia,7547515,4758784,4363716,395068
2013-05-01,Hawaii,1073510,648702,618211,30491
2013-05-01,Idaho,1206138,776008,722073,53935
2013-05-01,Illinois,10022943,6564150,5958543,605607
2013-05-01,Indiana,5059482,3185716,2937252,248464
2013-05-01,Iowa,2402634,1673821,1593137,80684
2013-05-01,Kansas,2181864,1491094,1410482,80612
2013-05-01,Kentucky,3408721,2063352,1897711,165641
2013-05-01,Louisiana,3522141,2103144,1963094,140050
2013-05-01,Maine,1084318,704715,656605,48110
2013-05-01,Maryland,4634490,3134344,2926541,207803
2013-05-01,Massachusetts,5399486,3518522,3281377,237145
2013-05-01,Michigan,7820362,4738195,4320494,417701
2013-05-01,Minnesota,4213509,2960131,2808881,151250
2013-05-01,Mississippi,2262701,1280192,1170333,109859
2013-05-01,Missouri,4687010,3014209,2808028,206181
2013-05-01,Montana,798209,510966,483222,27744
2013-05-01,Nebraska,1419166,1017337,979326,38011
2013-05-01,Nevada,2149619,1370943,1231067,139876
2013-05-01,Ohio,9053073,5713147,5281766,431381
2013-05-01,Oklahoma,2917592,1801681,1708925,92756
2013-05-01,Oregon,3121022,1923376,1771464,151912
2013-05-01,Pennsylvania,10175207,6431705,5969205,462500
2013-05-01,Tennessee,5057965,3089865,2844913,244952
2013-05-01,Texas,19633581,12816378,11991479,824899
2013-05-01,Utah,2058133,1382531,1323353,59178
2013-05-01,Vermont,512553,350554,334741,15813
2013-05-01,Virginia,6375248,4236152,3998446,237706
2013-05-01,Washington,5430881,3456355,3224598,231757
2013-05-01,Wisconsin,4500856,3082194,2873099,209095
2013-05-01,Wyoming,448342,302153,287874,14279
2013-06-01,Alabama,3764923,2174677,2016898,157779
2013-06-01,Alaska,538281,363613,338220,25393
2013-06-01,Arizona,5079772,3064094,2822985,241109
2013-06-01,Arkansas,2276045,1333280,1237985,95295
2013-06-01,California,29606950,18587359,16900895,1686464
2013-06-01,Colorado,4060727,2768303,2579085,189218
2013-06-01,Connecticut,2855924,1868813,1718256,150557
2013-06-01,Delaware,727078,442641,413085,29556
2013-06-01,Florida,15654708,9417639,8706200,711439
2013-06-01,Georgia,7554106,4757233,4366608,390625
2013-06-01,Hawaii,1073629,649806,619477,30329
2013-06-01,Idaho,1207515,777564,723613,53951
2013-06-01,Illinois,10026812,6564252,5960949,603303
2013-06-01,Indiana,5062772,3190582,2946381,244201
2013-06-01,Iowa,2404245,1679506,1599483,80023
2013-06-01,Kansas,2182471,1491270,1411118,80152
2013-06-01,Kentucky,3410807,2062469,1896774,165695
2013-06-01,Louisiana,3524095,2103648,1965593,138055
2013-06-01,Maine,1084636,705441,657855,47586
2013-06-01,Maryland,4637576,3133645,2927329,206316
2013-06-01,Massachusetts,5404700,3520920,3284024,236896
2013-06-01,Michigan,7823981,4745039,4327389,417650
2013-06-01,Minnesota,4216855,2959310,2809549,149761
2013-06-01,Mississippi,2263641,1272370,1163744,108626
2013-06-01,Missouri,4689032,3015995,2810122,205873
2013-06-01,Montana,798963,511208,483568,27640
2013-06-01,Nebraska,1420027,1017004,979203,37801
2013-06-01,Nevada,2152150,1372012,1233932,138080
2013-06-01,Ohio,9057146,5717334,5285529,431805
2013-06-01,Oklahoma,2919929,1802864,1710192,92672
2013-06-01,Oregon,3123530,1923051,1773458,149593
2013-06-01,Pennsylvania,10178028,6429380,5971295,458085
2013-06-01,Tennessee,5061823,3085954,2843190,242764
2013-06-01,Texas,19662766,12837490,12018765,818725
2013-06-01,Utah,2061510,1386526,1327663,58863
2013-06-01,Vermont,512724,350425,334728,15697
2013-06-01,Virginia,6379556,4240224,4002240,237984
2013-06-01,Washington,5435401,3460427,3228621,231806
2013-06-01,Wisconsin,4503389,3083584,2876730,206854
2013-06-01,Wyoming,448731,302234,288123,14111
2013-07-01,Alabama,3766869,2174320,2016720,157600
2013-07-01,Alaska,538697,363803,338308,25495
2013-07-01,Arizona,5086380,3067255,2827358,239897
2013-07-01,Arkansas,2276997,1332281,1237390,94891
2013-07-01,California,29635123,18593103,16919448,1673655
2013-07-01,Colorado,4067025,2769662,2581932,187730
2013-07-01,Connecticut,2857034,1870801,1721124,149677
2013-07-01,Delaware,727812,442935,413831,29104
2013-07-01,Florida,15674637,9427528,8722512,705016
2013-07-01,Georgia,7560981,4753872,4367542,386330
2013-07-01,Hawaii,1074519,650974,620569,30405
2013-07-01,Idaho,1208893,779087,725099,53988
2013-07-01,Illinois,10030317,6562584,5961642,600942
2013-07-01,Indiana,5065926,3196530,2956324,240206
2013-07-01,Iowa,2405753,1683993,1604608,79385
2013-07-01,Kansas,2183388,1490847,1411224,79623
2013-07-01,Kentucky,3413114,2060497,1894998,165499
2013-07-01,Louisiana,3526293,2103958,1967784,136174
2013-07-01,Maine,1084942,705989,658878,47111
2013-07-01,Maryland,4640951,3132042,2927100,204942
2013-07-01,Massachusetts,5409770,3521770,3285397,236373
2013-07-01,Michigan,7827369,4749853,4332010,417843
2013-07-01,Minnesota,4220108,2959245,2810761,148484
2013-07-01,Mississippi,2264709,1268048,1160302,107746
2013-07-01,Missouri,4691093,3015876,2810658,205218
2013-07-01,Montana,799737,511458,483921,27537
2013-07-01,Nebraska,1420974,1015997,978454,37543
2013-07-01,Nevada,2154816,1372712,1236337,136375
2013-07-01,Ohio,9061057,5718793,5285992,432801
2013-07-01,Oklahoma,2922377,1803164,1710369,92795
2013-07-01,Oregon,3125928,1922652,1775086,147566
2013-07-01,Pennsylvania,10180604,6424767,5969474,455293
2013-07-01,Tennessee,5065824,3080892,2840265,240627
2013-07-01,Texas,19692871,12855277,12041788,813489
2013-07-01,Utah,2064852,1389933,1331380,58553
2013-07-01,Vermont,512904,350240,334676,15564
2013-07-01,Virginia,6385274,4243322,4005011,238311
2013-07-01,Washington,5440583,3464183,3232372,231811
2013-07-01,Wisconsin,4505801,3083217,2878077,205140
2013-07-01,Wyoming,449152,302271,288226,14045
2013-08-01,Alabama,3768499,2172637,2015204,157433
2013-08-01,Alaska,539112,363845,338340,25505
2013-08-01,Arizona,5094765,3069196,2831079,238117
2013-08-01,Arkansas,2278011,1330709,1236614,94095
2013-08-01,California,29665950,18587188,16930930,1656258
2013-08-01,Colorado,4073981,2769322,2584166,185156
2013-08-01,Connecticut,2858175,1871349,1723188,148161
2013-08-01,Delaware,728676,443283,414660,28623
2013-08-01,Florida,15699539,9432470,8735091,697379
2013-08-01,Georgia,7568874,4747684,4366691,380993
2013-08-01,Hawaii,1075489,652138,621567,30571
2013-08-01,Idaho,1210463,780447,726569,53878
2013-08-01,Illinois,10032173,6556695,5960397,596298
2013-08-01,Indiana,5068571,3201733,2966614,235119
2013-08-01,Iowa,2407129,1686408,1607835,78573
2013-08-01,Kansas,2184718,1489665,1411057,78608
2013-08-01,Kentucky,3414664,2056498,1892207,164291
2013-08-01,Louisiana,3528368,2103449,1969745,133704
2013-08-01,Maine,1085388,705978,659479,46499
2013-08-01,Maryland,4643937,3128842,2925935,202907
2013-08-01,Massachusetts,5414595,3520422,3285726,234696
2013-08-01,Michigan,7830628,4750495,4334709,415786
2013-08-01,Minnesota,4223049,2959719,2812839,146880
2013-08-01,Mississippi,2265558,1254811,1148171,106640
2013-08-01,Missouri,4693101,3013797,2810184,203613
2013-08-01,Montana,800442,511695,484345,27350
2013-08-01,Nebraska,1422003,1014398,977305,37093
2013-08-01,Nevada,2158236,1372608,1238307,134301
2013-08-01,Ohio,9064677,5716629,5284908,431721
2013-08-01,Oklahoma,2924485,1802134,1709443,92691
2013-08-01,Oregon,3129332,1921985,1776755,145230
2013-08-01,Pennsylvania,10183403,6416123,5964676,451447
2013-08-01,Tennessee,5069972,3074336,2836800,237536
2013-08-01,Texas,19728313,12867238,12061310,805928
2013-08-01,Utah,2067849,1392500,1334511,57989
2013-08-01,Vermont,512966,349953,334580,15373
2013-08-01,Virginia,6391397,4244602,4007012,237590
2013-08-01,Washington,5448331,3466584,3235962,230622
2013-08-01,Wisconsin,4507808,3080977,2877730,203247
2013-08-01,Wyoming,449222,302231,288200,14031
2013-09-01,Alabama,3770214,2169847,2013022,156825
2013-09-01,Alaska,539171,363710,338320,25390
2013-09-01,Arizona,5103215,3069703,2834283,235420
2013-09-01,Arkansas,2279106,1328616,1235898,92718
2013-09-01,California,29696653,18570217,16939401,1630816
2013-09-01,Colorado,4080567,2767570,2586419,181151
2013-09-01,Connecticut,2859384,1870764,1724994,145770
2013-09-01,Delaware,729578,443676,415572,28104
2013-09-01,Florida,15724553,9433614,8746255,687359
2013-09-01,Georgia,7576721,4739785,4365522,374263
2013-09-01,Hawaii,1075926,653325,622633,30692
2013-09-01,Idaho,1212088,781625,728067,53558
2013-09-01,Illinois,10034545,6547345,5959101,588244
2013-09-01,Indiana,5071500,3204516,2976182,228334
2013-09-01,Iowa,2408648,1686554,1609044,77510
2013-09-01,Kansas,2185822,1488146,1411091,77055
2013-09-01,Kentucky,3416171,2050680,1888658,162022
2013-09-01,Louisiana,3530459,2102001,1971714,130287
2013-09-01,Maine,1085923,705310,659610,45700
2013-09-01,Maryland,4646932,3124472,2924492,199980
2013-09-01,Massachusetts,5419749,3517704,3286121,231583
2013-09-01,Michigan,7834323,4747499,4336984,410515
2013-09-01,Minnesota,4226279,2960319,2815492,144827
2013-09-01,Mississippi,2266375,1252815,1147763,105052
2013-09-01,Missouri,4695256,3011160,2809780,201380
2013-09-01,Montana,801146,511880,484863,27017
2013-09-01,Nebraska,1423047,1012637,976235,36402
2013-09-01,Nevada,2161607,1371772,1240084,131688
2013-09-01,Ohio,9068774,5711245,5284794,426451
2013-09-01,Oklahoma,2926590,1800109,1707972,92137
2013-09-01,Oregon,3132931,1921524,1778975,142549
2013-09-01,Pennsylvania,10186846,6404340,5959318,445022
2013-09-01,Tennessee,5074160,3066803,2833931,232872
2013-09-01,Texas,19763523,12873858,12079341,794517
2013-09-01,Utah,2070938,1394372,1337267,57105
2013-09-01,Vermont,513076,349601,334486,15115
2013-09-01,Virginia,6396539,4244434,4009047,235387
2013-09-01,Washington,5455719,3467375,3239639,227736
2013-09-01,Wisconsin,4510094,3077408,2877039,200369
2013-09-01,Wyoming,449293,302130,288119,14011
2013-10-01,Alabama,3771896,2167230,2011093,156137
2013-10-01,Alaska,539295,363558,338279,25279
2013-10-01,Arizona,5111574,3070375,2837884,232491
2013-10-01,Arkansas,2280144,1326715,1235660,91055
2013-10-01,California,29726663,18553825,16951113,1602712
2013-10-01,Colorado,4087135,2766264,2589867,176397
2013-10-01,Connecticut,2860520,1870128,1727081,143047
2013-10-01,Delaware,730453,444215,416563,27652
2013-10-01,Florida,15749207,9436839,8759566,677273
2013-10-01,Georgia,7584668,4733883,4366214,367669
2013-10-01,Hawaii,1076293,654646,623909,30737
2013-10-01,Idaho,1213707,782755,729577,53178
2013-10-01,Illinois,10036798,6539322,5960606,578716
2013-10-01,Indiana,5074366,3205501,2984597,220904
2013-10-01,Iowa,2410150,1685404,1608832,76572
2013-10-01,Kansas,2186901,1487170,1411799,75371
2013-10-01,Kentucky,3417645,2044372,1884947,159425
2013-10-01,Louisiana,3532431,2100686,1974140,126546
2013-10-01,Maine,1086416,704366,659476,44890
2013-10-01,Maryland,4649825,3120510,2923641,196869
2013-10-01,Massachusetts,5424816,3516257,3288254,228003
2013-10-01,Michigan,7837931,4744156,4340565,403591
2013-10-01,Minnesota,4229411,2961292,2818328,142964
2013-10-01,Mississippi,2267144,1250602,1147147,103455
2013-10-01,Missouri,4697387,3010507,2810589,199918
2013-10-01,Montana,801824,512116,485480,26636
2013-10-01,Nebraska,1424077,1011485,975674,35811
2013-10-01,Nevada,2164903,1371166,1242032,129134
2013-10-01,Ohio,9072686,5705087,5287632,417455
2013-10-01,Oklahoma,2928709,1798068,1706719,91349
2013-10-01,Oregon,3136440,1922159,1781810,140349
2013-10-01,Pennsylvania,10189979,6393597,5956291,437306
2013-10-01,Tennessee,5078253,3059810,2832394,227416
2013-10-01,Texas,19798357,12880739,12099121,781618
2013-10-01,Utah,2073970,1396158,1339974,56184
2013-10-01,Vermont,513176,349300,334450,14850
2013-10-01,Virginia,6401486,4244667,4011855,232812
2013-10-01,Washington,5462940,3467791,3243553,224238
2013-10-01,Wisconsin,4512294,3073994,2877113,196881
2013-10-01,Wyoming,449366,302077,288075,14002
2013-11-01,Alabama,3773384,2165715,2010028,155687
2013-11-01,Alaska,539263,363547,338306,25241
2013-11-01,Arizona,5119649,3072551,2843115,229436
2013-11-01,Arkansas,2281058,1325461,1236175,89286
2013-11-01,California,29756007,18547876,16971722,1576154
2013-11-01,Colorado,4093376,2767651,2595558,172093
2013-11-01,Connecticut,2861561,1870266,1729880,140386
2013-11-01,Delaware,731214,444909,417594,27315
2013-11-01,Florida,15772705,9446215,8777668,668547
2013-11-01,Georgia,7592498,4732267,4370024,362243
2013-11-01,Hawaii,1076475,656212,625532,30680
2013-11-01,Idaho,1215253,781042,731179,49863
2013-11-01,Illinois,10038967,6536335,5967239,569096
2013-11-01,Indiana,5077084,3206192,2992216,213976
2013-11-01,Iowa,2411521,1684452,1608558,75894
2013-11-01,Kansas,2187720,1487212,1413405,73807
2013-11-01,Kentucky,3418877,2038670,1881766,156904
2013-11-01,Louisiana,3534161,2100476,1977442,123034
2013-11-01,Maine,1086870,703474,659283,44191
2013-11-01,Maryland,4652421,3118057,2924041,194016
2013-11-01,Massachusetts,5429678,3517745,3293116,224629
2013-11-01,Michigan,7841202,4743413,4346689,396724
2013-11-01,Minnesota,4232451,2962764,2821182,141582
2013-11-01,Mississippi,2267787,1248764,1146573,102191
2013-11-01,Missouri,4699421,3012981,2813239,199742
2013-11-01,Montana,802467,512380,486132,26248
2013-11-01,Nebraska,1424973,1011351,975833,35518
2013-11-01,Nevada,2168144,1371342,1244462,126880
2013-11-01,Ohio,9076263,5700211,5294623,405588
2013-11-01,Oklahoma,2930743,1796614,1706259,90355
2013-11-01,Oregon,3139813,1924468,1785385,139083
2013-11-01,Pennsylvania,10192700,6387329,5958121,429208
2013-11-01,Tennessee,5082093,3054206,2832369,221837
2013-11-01,Texas,19832481,12892128,12124031,768097
2013-11-01,Utah,2076934,1398215,1342906,55309
2013-11-01,Vermont,513249,349089,334466,14623
2013-11-01,Virginia,6405584,4246742,4016111,230631
2013-11-01,Washington,5469691,3468654,3247718,220936
2013-11-01,Wisconsin,4514392,3071951,2878978,192973
2013-11-01,Wyoming,449390,302109,288157,13952
2013-12-01,Alabama,3774572,2165388,2009949,155439
2013-12-01,Alaska,539431,363695,338449,25246
2013-12-01,Arizona,5127350,3076382,2850146,226236
2013-12-01,Arkansas,2281785,1324767,1237331,87436
2013-12-01,California,29783733,18554149,17001882,1552267
2013-12-01,Colorado,4099604,2772177,2603433,168744
2013-12-01,Connecticut,2862341,1871503,1733625,137878
2013-12-01,Delaware,732002,445675,418596,27079
2013-12-01,Florida,15795270,9461489,8800149,661340
2013-12-01,Georgia,7600196,4734481,4376243,358238
2013-12-01,Hawaii,1077144,657879,627380,30499
2013-12-01,Idaho,1216693,779488,732868,46620
2013-12-01,Illinois,10040361,6537549,5978331,559218
2013-12-01,Indiana,5079216,3207647,2999291,208356
2013-12-01,Iowa,2412622,1684792,1609386,75406
2013-12-01,Kansas,2188613,1488263,1415787,72476
2013-12-01,Kentucky,3419898,2034084,1879552,154532
2013-12-01,Louisiana,3535754,2101607,1981332,120275
2013-12-01,Maine,1087193,702632,659022,43610
2013-12-01,Maryland,4654826,3117158,2925695,191463
2013-12-01,Massachusetts,5433952,3522182,3300577,221605
2013-12-01,Michigan,7843590,4745607,4354920,390687
2013-12-01,Minnesota,4234970,2964246,2823768,140478
2013-12-01,Mississippi,2268395,1247492,1146243,101249
2013-12-01,Missouri,4701109,3017799,2817410,200389
2013-12-01,Montana,803034,512516,486660,25856
2013-12-01,Nebraska,1425825,1012031,976601,35430
2013-12-01,Nevada,2171241,1372217,1247354,124863
2013-12-01,Ohio,9078805,5696553,5304884,391669
2013-12-01,Oklahoma,2932602,1795533,1706508,89025
2013-12-01,Oregon,3142820,1928211,1789567,138644
2013-12-01,Pennsylvania,10194255,6386175,5964685,421490
2013-12-01,Tennessee,5085584,3049904,2833383,216521
2013-12-01,Texas,19865772,12907972,12154284,753688
2013-12-01,Utah,2079764,1400436,1346017,54419
2013-12-01,Vermont,513269,348937,334491,14446
2013-12-01,Virginia,6410731,4250846,4021840,229006
2013-12-01,Washington,5476537,3469934,3251784,218150
2013-12-01,Wisconsin,4515931,3071403,2882705,188698
2013-12-01,Wyoming,449393,302194,288374,13820
2014-01-01,Alabama,3775896,2165971,2010942,155029
2014-01-01,Alaska,539619,363966,338735,25231
2014-01-01,Arizona,5135007,3081484,2858474,223010
2014-01-01,Arkansas,2282487,1324443,1238994,85449
2014-01-01,California,29812266,18569356,17040259,1529097
2014-01-01,Colorado,4105799,2778644,2613030,165614
2014-01-01,Connecticut,2863185,1873722,1738339,135383
2014-01-01,Delaware,732837,446546,419663,26883
2014-01-01,Florida,15818006,9479786,8825090,654696
2014-01-01,Georgia,7608115,4738716,4383593,355123
2014-01-01,Hawaii,1077742,659402,629214,30188
2014-01-01,Idaho,1218117,778076,734548,43528
2014-01-01,Illinois,10041949,6539433,5991934,547499
2014-01-01,Indiana,5081350,3210348,3006208,204140
2014-01-01,Iowa,2413708,1686880,1611910,74970
2014-01-01,Kansas,2189481,1490102,1418761,71341
2014-01-01,Kentucky,3420974,2030616,1878659,151957
2014-01-01,Louisiana,3537379,2103844,1985316,118528
2014-01-01,Maine,1087515,701831,658792,43039
2014-01-01,Maryland,4657298,3117343,2928422,188921
2014-01-01,Massachusetts,5438307,3528825,3310181,218644
2014-01-01,Michigan,7846050,4749538,4364414,385124
2014-01-01,Minnesota,4237487,2965437,2826045,139392
2014-01-01,Mississippi,2269079,1246805,1146363,100442
2014-01-01,Missouri,4702832,3023454,2822595,200859
2014-01-01,Montana,803600,512421,486983,25438
2014-01-01,Nebraska,1426584,1013076,977740,35336
2014-01-01,Nevada,2174343,1373421,1250571,122850
2014-01-01,Ohio,9081389,5693500,5316915,376585
2014-01-01,Oklahoma,2934523,1794313,1707122,87191
2014-01-01,Oregon,3145835,1932624,1794235,138389
2014-01-01,Pennsylvania,10195861,6388276,5974041,414235
2014-01-01,Tennessee,5089069,3046560,2834891,211669
2014-01-01,Texas,19899461,12926206,12188294,737912
2014-01-01,Utah,2082531,1402644,1349185,53459
2014-01-01,Vermont,513280,348806,334528,14278
2014-01-01,Virginia,6415418,4256299,4028612,227687
2014-01-01,Washington,5483240,3471141,3255449,215692
2014-01-01,Wisconsin,4517494,3071739,2887465,184274
2014-01-01,Wyoming,449367,302308,288675,13633
2014-02-01,Alabama,3776877,2166876,2012653,154223
2014-02-01,Alaska,539509,364333,339157,25176
2014-02-01,Arizona,5142282,3087246,2867319,219927
2014-02-01,Arkansas,2283060,1324270,1240888,83382
2014-02-01,California,29837518,18588369,17083487,1504882
2014-02-01,Colorado,4111541,2785590,2623718,161872
2014-02-01,Connecticut,2863789,1876435,1743577,132858
2014-02-01,Delaware,733503,447591,420921,26670
2014-02-01,Florida,15838937,9497821,8849988,647833
2014-02-01,Georgia,7615165,4743210,4390706,352504
2014-02-01,Hawaii,1077845,660678,630881,29797
2014-02-01,Idaho,1219442,776745,736121,40624
2014-02-01,Illinois,10042715,6539294,6006418,532876
2014-02-01,Indiana,5083309,3214183,3013026,201157
2014-02-01,Iowa,2414682,1690118,1615655,74463
2014-02-01,Kansas,2190055,1492219,1421820,70399
2014-02-01,Kentucky,3421719,2027674,1878905,148769
2014-02-01,Louisiana,3538761,2107066,1989022,118044
2014-02-01,Maine,1087757,701068,658705,42363
2014-02-01,Maryland,4659350,3118114,2931696,186418
2014-02-01,Massachusetts,5442411,3536741,3321159,215582
2014-02-01,Michigan,7848175,4754121,4374624,379497
2014-02-01,Minnesota,4239854,2966801,2828846,137955
2014-02-01,Mississippi,2269514,1246453,1146767,99686
2014-02-01,Missouri,4704124,3028252,2827952,200300
2014-02-01,Montana,804113,512169,487185,24984
2014-02-01,Nebraska,1427283,1013940,978832,35108
2014-02-01,Nevada,2177240,1374578,1253863,120715
2014-02-01,Ohio,9083600,5691029,5328838,362191
2014-02-01,Oklahoma,2936088,1792880,1707926,84954
2014-02-01,Oregon,3148678,1936905,1799250,137655
2014-02-01,Pennsylvania,10197005,6390970,5983678,407292
2014-02-01,Tennessee,5092218,3043669,2835964,207705
2014-02-01,Texas,19931260,12944743,12223189,721554
2014-02-01,Utah,2085290,1404680,1352211,52469
2014-02-01,Vermont,513290,348678,334573,14105
2014-02-01,Virginia,6418890,4261740,4035391,226349
2014-02-01,Washington,5489276,3471891,3258702,213189
2014-02-01,Wisconsin,4518845,3072006,2892285,179721
2014-02-01,Wyoming,449336,302412,288990,13422
2014-03-01,Alabama,3777962,2167429,2014263,153166
2014-03-01,Alaska,539754,364723,339585,25138
2014-03-01,Arizona,5149581,3093246,2875911,217335
2014-03-01,Arkansas,2283711,1324213,1242674,81539
2014-03-01,California,29863107,18608224,17126546,1481678
2014-03-01,Colorado,4117658,2791859,2634418,157441
2014-03-01,Connecticut,2864494,1879255,1748668,130587
2014-03-01,Delaware,734258,448826,422367,26459
2014-03-01,Florida,15860256,9513557,8872130,641427
2014-03-01,Georgia,7622847,4746928,4396047,350881
2014-03-01,Hawaii,1078425,661775,632329,29446
2014-03-01,Idaho,1220865,775559,737567,37992
2014-03-01,Illinois,10043753,6535796,6019511,516285
2014-03-01,Indiana,5085349,3218859,3019531,199328
2014-03-01,Iowa,2415666,1693311,1619332,73979
2014-03-01,Kansas,2190902,1494043,1424398,69645
2014-03-01,Kentucky,3422732,2024499,1879447,145052
2014-03-01,Louisiana,3540264,2111847,1992426,119421
2014-03-01,Maine,1088088,700376,658761,41615
2014-03-01,Maryland,4661547,3119340,2934794,184546
2014-03-01,Massachusetts,5446508,3544719,3331902,212817
2014-03-01,Michigan,7850278,4758378,4384836,373542
2014-03-01,Minnesota,4242288,2969112,2833095,136017
2014-03-01,Mississippi,2270082,1246033,1147012,99021
2014-03-01,Missouri,4705663,3030991,2832619,198372
2014-03-01,Montana,804660,511966,487393,24573
2014-03-01,Nebraska,1428099,1014248,979472,34776
2014-03-01,Nevada,2180188,1375605,1256934,118671
2014-03-01,Ohio,9085936,5690228,5339396,350832
2014-03-01,Oklahoma,2937906,1791504,1708779,82725
2014-03-01,Oregon,3151548,1940643,1804298,136345
2014-03-01,Pennsylvania,10198199,6392273,5991065,401208
2014-03-01,Tennessee,5095612,3041048,2835726,205322
2014-03-01,Texas,19963437,12962485,12254958,707527
2014-03-01,Utah,2088050,1406514,1354871,51643
2014-03-01,Vermont,513286,348585,334605,13980
2014-03-01,Virginia,6423820,4265948,4040682,225266
2014-03-01,Washington,5495957,3472850,3261947,210903
2014-03-01,Wisconsin,4520263,3072114,2896598,175516
2014-03-01,Wyoming,449330,302506,289248,13258
2014-04-01,Alabama,3779148,2166887,2015052,151835
2014-04-01,Alaska,539920,364982,339829,25153
2014-04-01,Arizona,5157085,3098896,2883663,215233
2014-04-01,Arkansas,2284412,1324212,1244129,80083
2014-04-01,California,29890084,18624963,17164661,1460302
2014-04-01,Colorado,4123834,2796320,2644060,152260
2014-04-01,Connecticut,2865227,1882025,1753324,128701
2014-04-01,Delaware,735008,450102,423844,26258
2014-04-01,Florida,15881941,9525298,8890013,635285
2014-04-01,Georgia,7630658,4748750,4398631,350119
2014-04-01,Hawaii,1078966,662692,633518,29174
2014-04-01,Idaho,1222312,774476,738865,35611
2014-04-01,Illinois,10045091,6528094,6029065,499029
2014-04-01,Indiana,5087465,3222985,3024974,198011
2014-04-01,Iowa,2416760,1695751,1622168,73583
2014-04-01,Kansas,2191747,1495057,1426026,69031
2014-04-01,Kentucky,3423820,2020074,1879242,140832
2014-04-01,Louisiana,3541777,2118328,1995649,122679
2014-04-01,Maine,1088386,699680,658856,40824
2014-04-01,Maryland,4663823,3120501,2937114,183387
2014-04-01,Massachusetts,5450754,3551300,3340784,210516
2014-04-01,Michigan,7852565,4760730,4393862,366868
2014-04-01,Minnesota,4244776,2971996,2838498,133498
2014-04-01,Mississippi,2270655,1245010,1146757,98253
2014-04-01,Missouri,4707337,3031462,2836109,195353
2014-04-01,Montana,805196,511934,487669,24265
2014-04-01,Nebraska,1428903,1013835,979454,34381
2014-04-01,Nevada,2183244,1376354,1259583,116771
2014-04-01,Ohio,9088443,5691744,5348627,343117
2014-04-01,Oklahoma,2939772,1790356,1709600,80756
2014-04-01,Oregon,3154549,1943538,1808969,134569
2014-04-01,Pennsylvania,10199621,6390305,5994857,395448
2014-04-01,Tennessee,5099031,3038521,2834046,204475
2014-04-01,Texas,19996449,12977478,12280595,696883
2014-04-01,Utah,2090879,1408112,1357035,51077
2014-04-01,Vermont,513303,348513,334580,13933
2014-04-01,Virginia,6428555,4267774,4043315,224459
2014-04-01,Washington,5502692,3474684,3265637,209047
2014-04-01,Wisconsin,4521748,3072178,2900257,171921
2014-04-01,Wyoming,449340,302590,289389,13201
2014-05-01,Alabama,3780402,2165427,2015410,150017
2014-05-01,Alaska,539952,365047,339891,25156
2014-05-01,Arizona,5164679,3104438,2891087,213351
2014-05-01,Arkansas,2285227,1324336,1245446,78890
2014-05-01,California,29916600,18638929,17200175,1438754
2014-05-01,Colorado,4129980,2799033,2652822,146211
2014-05-01,Connecticut,2866111,1884757,1757743,127014
2014-05-01,Delaware,735746,451305,425282,26023
2014-05-01,Florida,15903940,9534040,8905898,628142
2014-05-01,Georgia,7638321,4748727,4399795,348932
2014-05-01,Hawaii,1079174,663424,634545,28879
2014-05-01,Idaho,1223807,774878,740193,34685
2014-05-01,Illinois,10046805,6518261,6036226,482035
2014-05-01,Indiana,5090010,3226182,3030027,196155
2014-05-01,Iowa,2418089,1697727,1624533,73194
2014-05-01,Kansas,2192602,1495273,1426868,68405
2014-05-01,Kentucky,3425003,2014317,1878442,135875
2014-05-01,Louisiana,3543376,2126535,1999443,127092
2014-05-01,Maine,1088766,698898,658932,39966
2014-05-01,Maryland,4666100,3121400,2939236,182164
2014-05-01,Massachusetts,5455405,3556705,3348340,208365
2014-05-01,Michigan,7855445,4760984,4402006,358978
2014-05-01,Minnesota,4247681,2975113,2844737,130376
2014-05-01,Mississippi,2271250,1243633,1146391,97242
2014-05-01,Missouri,4709237,3030820,2839226,191594
2014-05-01,Montana,805821,512134,488112,24022
2014-05-01,Nebraska,1429800,1012989,979097,33892
2014-05-01,Nevada,2186235,1376943,1262099,114844
2014-05-01,Ohio,9091567,5696376,5358794,337582
2014-05-01,Oklahoma,2941732,1790090,1711113,78977
2014-05-01,Oregon,3157729,1945984,1813583,132401
2014-05-01,Pennsylvania,10201740,6385963,5997076,388887
2014-05-01,Tennessee,5102669,3036563,2832484,204079
2014-05-01,Texas,20029222,12990622,12302615,688007
2014-05-01,Utah,2093891,1409831,1359074,50757
2014-05-01,Vermont,513384,348496,334560,13936
2014-05-01,Virginia,6432887,4267161,4043979,223182
2014-05-01,Washington,5509350,3478313,3270893,207420
2014-05-01,Wisconsin,4523688,3072776,2904115,168661
2014-05-01,Wyoming,449389,302688,289475,13213
2014-06-01,Alabama,3781842,2164102,2016249,147853
2014-06-01,Alaska,540093,364977,339893,25084
2014-06-01,Arizona,5172489,3110915,2899220,211695
2014-06-01,Arkansas,2286089,1324928,1247064,77864
2014-06-01,California,29944683,18656005,17238675,1417330
2014-06-01,Colorado,4136443,2800957,2661226,139731
2014-06-01,Connecticut,2867060,1887936,1762463,125473
2014-06-01,Delaware,736544,452472,426731,25741
2014-06-01,Florida,15926650,9543064,8923099,619965
2014-06-01,Georgia,7646501,4748412,4401903,346509
2014-06-01,Hawaii,1079608,664120,635619,28501
2014-06-01,Idaho,1225357,772518,741711,30807
2014-06-01,Illinois,10048895,6510457,6043882,466575
2014-06-01,Indiana,5092587,3228715,3035235,193480
2014-06-01,Iowa,2419419,1699665,1626906,72759
2014-06-01,Kansas,2193633,1495152,1427461,67691
2014-06-01,Kentucky,3426320,2008207,1877753,130454
2014-06-01,Louisiana,3545128,2136367,2004372,131995
2014-06-01,Maine,1089198,698129,659052,39077
2014-06-01,Maryland,4668668,3122644,2942245,180399
2014-06-01,Massachusetts,5460196,3562788,3356523,206265
2014-06-01,Michigan,7858371,4760581,4410586,349995
2014-06-01,Minnesota,4250635,2978678,2851608,127070
2014-06-01,Mississippi,2271966,1242518,1146590,95928
2014-06-01,Missouri,4711311,3030914,2843247,187667
2014-06-01,Montana,806454,512539,488704,23835
2014-06-01,Nebraska,1430764,1012254,978935,33319
2014-06-01,Nevada,2189378,1377865,1264946,112919
2014-06-01,Ohio,9094839,5704592,5372122,332470
2014-06-01,Oklahoma,2943814,1791491,1714066,77425
2014-06-01,Oregon,3160985,1948765,1818552,130213
2014-06-01,Pennsylvania,10204125,6382223,6001094,381129
2014-06-01,Tennessee,5106517,3036228,2832894,203334
2014-06-01,Texas,20063200,13005331,12325395,679936
2014-06-01,Utah,2096947,1412233,1361525,50708
2014-06-01,Vermont,513456,348595,334637,13958
2014-06-01,Virginia,6437866,4265150,4044124,221026
2014-06-01,Washington,5516406,3484570,3278515,206055
2014-06-01,Wisconsin,4525650,3074787,2909425,165362
2014-06-01,Wyoming,449410,302902,289593,13309
2014-07-01,Alabama,3783338,2163245,2017648,145597
2014-07-01,Alaska,540362,364744,339820,24924
2014-07-01,Arizona,5180459,3118643,2908222,210421
2014-07-01,Arkansas,2287037,1326166,1249184,76982
2014-07-01,California,29973268,18677566,17279967,1397599
2014-07-01,Colorado,4143100,2802732,2669021,133711
2014-07-01,Connecticut,2868086,1891461,1767363,124098
2014-07-01,Delaware,737354,453608,428207,25401
2014-07-01,Florida,15949789,9553381,8941700,611681
2014-07-01,Georgia,7654601,4748222,4405529,342693
2014-07-01,Hawaii,1080312,664779,636723,28056
2014-07-01,Idaho,1226932,774415,743273,31142
2014-07-01,Illinois,10050873,6506321,6053007,453314
2014-07-01,Indiana,5095338,3230459,3039980,190479
2014-07-01,Iowa,2420807,1701256,1628984,72272
2014-07-01,Kansas,2194773,1494899,1427996,66903
2014-07-01,Kentucky,3427780,2002336,1877122,125214
2014-07-01,Louisiana,3547016,2146989,2010030,136959
2014-07-01,Maine,1089642,697406,659150,38256
2014-07-01,Maryland,4671342,3124415,2946042,178373
2014-07-01,Massachusetts,5465033,3570532,3366302,204230
2014-07-01,Michigan,7861502,4760410,4419845,340565
2014-07-01,Minnesota,4253663,2982337,2858156,124181
2014-07-01,Mississippi,2272687,1241849,1147388,94461
2014-07-01,Missouri,4713419,3032475,2848329,184146
2014-07-01,Montana,807113,512909,489212,23697
2014-07-01,Nebraska,1431772,1011874,979130,32744
2014-07-01,Nevada,2192599,1379296,1268140,111156
2014-07-01,Ohio,9098363,5714956,5387836,327120
2014-07-01,Oklahoma,2945898,1794276,1718123,76153
2014-07-01,Oregon,3164306,1951938,1823499,128439
2014-07-01,Pennsylvania,10206633,6380460,6007565,372895
2014-07-01,Tennessee,5110481,3037420,2835451,201969
2014-07-01,Texas,20097595,13020533,12348864,671669
2014-07-01,Utah,2100046,1415313,1364434,50879
2014-07-01,Vermont,513527,348732,334745,13987
2014-07-01,Virginia,6443321,4261973,4043653,218320
2014-07-01,Washington,5523748,3493179,3287937,205242
2014-07-01,Wisconsin,4527717,3077724,2915883,161841
2014-07-01,Wyoming,449473,303175,289739,13436
2014-08-01,Alabama,3785171,2162943,2019514,143429
2014-08-01,Alaska,540603,364445,339777,24668
2014-08-01,Arizona,5189451,3127937,2918301,209636
2014-08-01,Arkansas,2288351,1328224,1251928,76296
2014-08-01,California,30003777,18704813,17324005,1380808
2014-08-01,Colorado,4151522,2805239,2676304,128935
2014-08-01,Connecticut,2868777,1894819,1771979,122840
2014-08-01,Delaware,738197,454713,429692,25021
2014-08-01,Florida,15979383,9565595,8961454,604141
2014-08-01,Georgia,7664292,4748449,4410760,337689
2014-08-01,Hawaii,1080863,665410,637809,27601
2014-08-01,Idaho,1228689,776184,744890,31294
2014-08-01,Illinois,10052122,6505638,6063338,442300
2014-08-01,Indiana,5097721,3233023,3044917,188106
2014-08-01,Iowa,2422082,1702696,1630943,71753
2014-08-01,Kansas,2195906,1494750,1428614,66136
2014-08-01,Kentucky,3429552,1997344,1876646,120698
2014-08-01,Louisiana,3549310,2157540,2015914,141626
2014-08-01,Maine,1089878,696893,659284,37609
2014-08-01,Maryland,4674244,3126888,2950361,176527
2014-08-01,Massachusetts,5469190,3580091,3377865,202226
2014-08-01,Michigan,7864342,4761597,4429841,331756
2014-08-01,Minnesota,4256649,2985812,2863719,122093
2014-08-01,Mississippi,2273462,1241705,1148638,93067
2014-08-01,Missouri,4715848,3035691,2854353,181338
2014-08-01,Montana,807887,513167,489580,23587
2014-08-01,Nebraska,1432717,1011897,979646,32251
2014-08-01,Nevada,2196560,1381318,1271663,109655
2014-08-01,Ohio,9102012,5726029,5404261,321768
2014-08-01,Oklahoma,2948530,1798094,1722930,75164
2014-08-01,Oregon,3168976,1955313,1828180,127133
2014-08-01,Pennsylvania,10209072,6382229,6016409,365820
2014-08-01,Tennessee,5115278,3040492,2840279,200213
2014-08-01,Texas,20135749,13036080,12373428,662652
2014-08-01,Utah,2103664,1418964,1367794,51170
2014-08-01,Vermont,513704,348863,334843,14020
2014-08-01,Virginia,6448300,4258573,4043065,215508
2014-08-01,Washington,5532478,3503437,3298328,205109
2014-08-01,Wisconsin,4529784,3081114,2922633,158481
2014-08-01,Wyoming,449719,303393,289922,13471
2014-09-01,Alabama,3787004,2162865,2021615,141250
2014-09-01,Alaska,540851,364135,339845,24290
2014-09-01,Arizona,5198387,3138216,2929099,209117
2014-09-01,Arkansas,2289722,1330805,1255079,75726
2014-09-01,California,30034552,18735234,17369795,1365439
2014-09-01,Colorado,4159972,2808186,2682837,125349
2014-09-01,Connecticut,2869566,1897546,1776030,121516
2014-09-01,Delaware,739121,455690,431084,24606
2014-09-01,Florida,16009146,9577872,8980727,597145
2014-09-01,Georgia,7674134,4748685,4416904,331781
2014-09-01,Hawaii,1081629,666039,638866,27173
2014-09-01,Idaho,1230456,777919,746662,31257
2014-09-01,Illinois,10053396,6506203,6073599,432604
2014-09-01,Indiana,5100064,3237161,3050703,186458
2014-09-01,Iowa,2423284,1704150,1633086,71064
2014-09-01,Kansas,2197146,1494751,1429313,65438
2014-09-01,Kentucky,3431380,1993235,1876403,116832
2014-09-01,Louisiana,3551647,2166638,2021167,145471
2014-09-01,Maine,1090164,696540,659456,37084
2014-09-01,Maryland,4677269,3129613,2954694,174919
2014-09-01,Massachusetts,5473295,3590220,3390213,200007
2014-09-01,Michigan,7867142,4763243,4439814,323429
2014-09-01,Minnesota,4259600,2988734,2868043,120691
2014-09-01,Mississippi,2274286,1241870,1150211,91659
2014-09-01,Missouri,4718289,3039992,2860932,179060
2014-09-01,Montana,808672,513367,489884,23483
2014-09-01,Nebraska,1433715,1012111,980321,31790
2014-09-01,Nevada,2200552,1383739,1275356,108383
2014-09-01,Ohio,9105659,5735306,5419107,316199
2014-09-01,Oklahoma,2951189,1802468,1728111,74357
2014-09-01,Oregon,3173535,1958331,1832536,125795
2014-09-01,Pennsylvania,10211398,6387480,6026772,360708
2014-09-01,Tennessee,5120089,3045235,2846964,198271
2014-09-01,Texas,20174227,13050337,12398563,651774
2014-09-01,Utah,2107319,1422899,1371451,51448
2014-09-01,Vermont,513902,348966,334944,14022
2014-09-01,Virginia,6453876,4255711,4042931,212780
2014-09-01,Washington,5541439,3513688,3308405,205283
2014-09-01,Wisconsin,4531863,3084262,2928668,155594
2014-09-01,Wyoming,449959,303460,290127,13333
2014-10-01,Alabama,3788819,2162682,2023989,138693
2014-10-01,Alaska,541178,363829,340035,23794
2014-10-01,Arizona,5207290,3147375,2939396,207979
2014-10-01,Arkansas,2291014,1333104,1258078,75026
2014-10-01,California,30065291,18760622,17413762,1346860
2014-10-01,Colorado,4168412,2810762,2688227,122535
2014-10-01,Connecticut,2870249,1899432,1779699,119733
2014-10-01,Delaware,739991,456448,432329,24119
2014-10-01,Florida,16038837,9586098,8996931,589167
2014-10-01,Georgia,7684016,4747387,4422548,324839
2014-10-01,Hawaii,1082361,666609,639868,26741
2014-10-01,Idaho,1232213,779643,748640,31003
2014-10-01,Illinois,10054590,6504445,6081936,422509
2014-10-01,Indiana,5102418,3241264,3056667,184597
2014-10-01,Iowa,2424508,1705341,1635343,69998
2014-10-01,Kansas,2198312,1494702,1429984,64718
2014-10-01,Kentucky,3433119,1989610,1876386,113224
2014-10-01,Louisiana,3553983,2172611,2024800,147811
2014-10-01,Maine,1090411,696052,659532,36520
2014-10-01,Maryland,4680246,3131723,2958485,173238
2014-10-01,Massachusetts,5477355,3598416,3401460,196956
2014-10-01,Michigan,7869825,4763011,4448646,314365
2014-10-01,Minnesota,4262535,2990545,2871022,119523
2014-10-01,Mississippi,2275099,1242310,1152316,89994
2014-10-01,Missouri,4720710,3044054,2867348,176706
2014-10-01,Montana,809429,513525,490239,23286
2014-10-01,Nebraska,1434661,1012100,980917,31183
2014-10-01,Nevada,2204509,1385877,1278928,106949
2014-10-01,Ohio,9109182,5740022,5429896,310126
2014-10-01,Oklahoma,2953863,1806752,1733263,73489
2014-10-01,Oregon,3178139,1960334,1836625,123709
2014-10-01,Pennsylvania,10213628,6393131,6036120,357011
2014-10-01,Tennessee,5124892,3049884,2854160,195724
2014-10-01,Texas,20212629,13058380,12420918,637462
2014-10-01,Utah,2110926,1426616,1375102,51514
2014-10-01,Vermont,514074,348999,335064,13935
2014-10-01,Virginia,6459517,4252749,4042841,209908
2014-10-01,Washington,5550339,3521452,3316839,204613
2014-10-01,Wisconsin,4533838,3086117,2933222,152895
2014-10-01,Wyoming,450204,303319,290316,13003
2014-11-01,Alabama,3790314,2162723,2026910,135813
2014-11-01,Alaska,541342,363530,340262,23268
2014-11-01,Arizona,5215731,3153926,2947951,205975
2014-11-01,Arkansas,2292159,1334565,1260362,74203
2014-11-01,California,30094154,18775765,17451977,1323788
2014-11-01,Colorado,4176464,2811968,2691945,120023
2014-11-01,Connecticut,2870767,1900520,1783052,117468
2014-11-01,Delaware,740761,457025,433436,23589
2014-11-01,Florida,16066665,9588482,9008617,579865
2014-11-01,Georgia,7693498,4744010,4426681,317329
2014-11-01,Hawaii,1082878,667024,640728,26296
2014-11-01,Idaho,1233894,781294,750676,30618
2014-11-01,Illinois,10055199,6498807,6086861,411946
2014-11-01,Indiana,5104411,3243507,3061704,181803
2014-11-01,Iowa,2425484,1705842,1637265,68577
2014-11-01,Kansas,2199173,1494484,1430308,64176
2014-11-01,Kentucky,3434586,1986279,1876349,109930
2014-11-01,Louisiana,3555955,2174782,2026322,148460
2014-11-01,Maine,1090608,695222,659414,35808
2014-11-01,Maryland,4682816,3132751,2961418,171333
2014-11-01,Massachusetts,5481096,3602853,3409823,193030
2014-11-01,Michigan,7871987,4759649,4455559,304090
2014-11-01,Minnesota,4265112,2991030,2872957,118073
2014-11-01,Mississippi,2275694,1243119,1155075,88044
2014-11-01,Missouri,4722848,3047123,2872738,174385
2014-11-01,Montana,810110,513751,490786,22965
2014-11-01,Nebraska,1435461,1011615,981159,30456
2014-11-01,Nevada,2208283,1387386,1282078,105308
2014-11-01,Ohio,9111983,5738510,5434432,304078
2014-11-01,Oklahoma,2956288,1810599,1737920,72679
2014-11-01,Oregon,3182459,1960742,1840037,120705
2014-11-01,Pennsylvania,10215030,6396471,6042204,354267
2014-11-01,Tennessee,5129292,3052910,2860333,192577
2014-11-01,Texas,20249578,13057664,12436708,620956
2014-11-01,Utah,2114402,1429762,1378419,51343
2014-11-01,Vermont,514237,348937,335207,13730
2014-11-01,Virginia,6463917,4249011,4042113,206898
2014-11-01,Washington,5558599,3525535,3323022,202513
2014-11-01,Wisconsin,4535533,3085929,2935868,150061
2014-11-01,Wyoming,450360,302997,290435,12562
2014-12-01,Alabama,3791522,2163996,2030603,133393
2014-12-01,Alaska,541292,363338,340470,22868
2014-12-01,Arizona,5223652,3158664,2954989,203675
2014-12-01,Arkansas,2293069,1335449,1261924,73525
2014-12-01,California,30119935,18785368,17484592,1300776
2014-12-01,Colorado,4183994,2812244,2694387,117857
2014-12-01,Connecticut,2871003,1901233,1786010,115223
2014-12-01,Delaware,741480,457575,434437,23138
2014-12-01,Florida,16093012,9588236,9017099,571137
2014-12-01,Georgia,7702197,4740275,4429609,310666
2014-12-01,Hawaii,1083135,667398,641508,25890
2014-12-01,Idaho,1235428,783031,752712,30319
2014-12-01,Illinois,10055054,6492057,6089359,402698
2014-12-01,Indiana,5106016,3243867,3065804,178063
2014-12-01,Iowa,2426356,1705596,1638437,67159
2014-12-01,Kansas,2199786,1494280,1430176,64104
2014-12-01,Kentucky,3435694,1983555,1876205,107350
2014-12-01,Louisiana,3557592,2174213,2026255,147958
2014-12-01,Maine,1090665,694247,659254,34993
2014-12-01,Maryland,4684903,3133445,2963878,169567
2014-12-01,Massachusetts,5484347,3603769,3414729,189040
2014-12-01,Michigan,7873568,4754985,4461008,293977
2014-12-01,Minnesota,4267379,2991295,2874858,116437
2014-12-01,Mississippi,2276091,1244773,1158482,86291
2014-12-01,Missouri,4724514,3049812,2877073,172739
2014-12-01,Montana,810716,514253,491643,22610
2014-12-01,Nebraska,1436119,1010872,980970,29902
2014-12-01,Nevada,2211859,1388719,1284896,103823
2014-12-01,Ohio,9114058,5732637,5433117,299520
2014-12-01,Oklahoma,2958392,1814538,1742065,72473
2014-12-01,Oregon,3186524,1960168,1842745,117423
2014-12-01,Pennsylvania,10215558,6397976,6045102,352874
2014-12-01,Tennessee,5133124,3054766,2865175,189591
2014-12-01,Texas,20284449,13051833,12446054,605779
2014-12-01,Utah,2117704,1432638,1381478,51160
2014-12-01,Vermont,514348,348838,335378,13460
2014-12-01,Virginia,6467759,4245503,4041135,204368
2014-12-01,Washington,5566204,3527147,3327558,199589
2014-12-01,Wisconsin,4536913,3084481,2937011,147470
2014-12-01,Wyoming,450507,302631,290474,12157
2015-01-01,Alabama,3792717,2166771,2034786,131985
2015-01-01,Alaska,541541,363226,340538,22688
2015-01-01,Arizona,5231632,3162393,2961081,201312
2015-01-01,Arkansas,2293962,1336169,1263086,73083
2015-01-01,California,30147095,18794302,17513360,1280942
2015-01-01,Colorado,4191682,2812740,2696305,116435
2015-01-01,Connecticut,2871234,1901701,1788370,113331
2015-01-01,Delaware,742189,458168,435330,22838
2015-01-01,Florida,16119608,9588873,9024705,564168
2015-01-01,Georgia,7711426,4737642,4431983,305659
2015-01-01,Hawaii,1083804,667875,642329,25546
2015-01-01,Idaho,1236985,785010,754789,30221
2015-01-01,Illinois,10054926,6487628,6091476,396152
2015-01-01,Indiana,5107398,3243609,3069876,173733
2015-01-01,Iowa,2427052,1704798,1638800,65998
2015-01-01,Kansas,2200557,1494068,1429606,64462
2015-01-01,Kentucky,3436806,1981477,1875886,105591
2015-01-01,Louisiana,3559303,2172224,2025344,146880
2015-01-01,Maine,1090698,693272,659092,34180
2015-01-01,Maryland,4687116,3134640,2966550,168090
2015-01-01,Massachusetts,5487464,3602272,3416690,185582
2015-01-01,Michigan,7874799,4751121,4465483,285638
2015-01-01,Minnesota,4269426,2992386,2877365,115021
2015-01-01,Mississippi,2276579,1247332,1162332,85000
2015-01-01,Missouri,4726122,3052395,2880669,171726
2015-01-01,Montana,811282,515033,492735,22298
2015-01-01,Nebraska,1436792,1010079,980427,29652
2015-01-01,Nevada,2215425,1390075,1287564,102511
2015-01-01,Ohio,9115824,5725314,5428302,297012
2015-01-01,Oklahoma,2960645,1819030,1745819,73211
2015-01-01,Oregon,3190400,1959718,1845083,114635
2015-01-01,Pennsylvania,10215735,6399411,6046534,352877
2015-01-01,Tennessee,5136969,3056389,2869136,187253
2015-01-01,Texas,20320317,13045727,12451402,594325
2015-01-01,Utah,2120965,1435490,1384452,51038
2015-01-01,Vermont,514435,348721,335527,13194
2015-01-01,Virginia,6472206,4242711,4040145,202566
2015-01-01,Washington,5574083,3528211,3331515,196696
2015-01-01,Wisconsin,4538023,3082864,2937399,145465
2015-01-01,Wyoming,450619,302350,290427,11923
2015-02-01,Alabama,3793390,2170601,2038928,131673
2015-02-01,Alaska,541749,363134,340415,22719
2015-02-01,Arizona,5238741,3165741,2966433,199308
2015-02-01,Arkansas,2294489,1336952,1264167,72785
2015-02-01,California,30170177,18804573,17539526,1265047
2015-02-01,Colorado,4199004,2813690,2698184,115506
2015-02-01,Connecticut,2871089,1901730,1789810,111920
2015-02-01,Delaware,742821,458835,436141,22694
2015-02-01,Florida,16143433,9592040,9032822,559218
2015-02-01,Georgia,7719736,4736239,4433957,302282
2015-02-01,Hawaii,1084437,668343,643165,25178
2015-02-01,Idaho,1238342,787221,756853,30368
2015-02-01,Illinois,10053295,6487282,6094125,393157
2015-02-01,Indiana,5108171,3243958,3074662,169296
2015-02-01,Iowa,2427387,1703904,1638715,65189
2015-02-01,Kansas,2201056,1493764,1428745,65019
2015-02-01,Kentucky,3437547,1979937,1875247,104690
2015-02-01,Louisiana,3560608,2169594,2024043,145551
2015-02-01,Maine,1090572,692242,658825,33417
2015-02-01,Maryland,4688804,3136563,2969832,166731
2015-02-01,Massachusetts,5489882,3599631,3416731,182900
2015-02-01,Michigan,7874962,4748842,4469325,279517
2015-02-01,Minnesota,4271024,2994638,2880470,114168
2015-02-01,Mississippi,2276813,1250514,1166324,84190
2015-02-01,Missouri,4727116,3054756,2883759,170997
2015-02-01,Montana,811751,515924,493824,22100
2015-02-01,Nebraska,1437272,1009386,979687,29699
2015-02-01,Nevada,2218759,1391547,1290189,101358
2015-02-01,Ohio,9116352,5719068,5423145,295923
2015-02-01,Oklahoma,2962478,1823885,1749030,74855
2015-02-01,Oregon,3193924,1960323,1847488,112835
2015-02-01,Pennsylvania,10214411,6402054,6048226,353828
2015-02-01,Tennessee,5140220,3058800,2873342,185458
2015-02-01,Texas,20353602,13042678,12455072,587606
2015-02-01,Utah,2124081,1438477,1387444,51033
2015-02-01,Vermont,514456,348536,335570,12966
2015-02-01,Virginia,6476073,4240767,4039464,201303
2015-02-01,Washington,5581414,3530246,3335608,194638
2015-02-01,Wisconsin,4538575,3081614,2937529,144085
2015-02-01,Wyoming,450732,302209,290287,11922
2015-03-01,Alabama,3794218,2174960,2042936,132024
2015-03-01,Alaska,541763,363053,340222,22831
2015-03-01,Arizona,5246030,3169469,2971786,197683
2015-03-01,Arkansas,2295183,1337920,1265637,72283
2015-03-01,California,30192273,18816299,17566611,1249688
2015-03-01,Colorado,4206284,2815196,2700859,114337
2015-03-01,Connecticut,2871016,1900978,1790269,110709
2015-03-01,Delaware,743467,459628,437007,22621
2015-03-01,Florida,16167449,9598497,9043681,554816
2015-03-01,Georgia,7727931,4735865,4436481,299384
2015-03-01,Hawaii,1084597,668758,644078,24680
2015-03-01,Idaho,1239788,789517,758877,30640
2015-03-01,Illinois,10052133,6491517,6098798,392719
2015-03-01,Indiana,5109371,3245723,3080816,164907
2015-03-01,Iowa,2428014,1703231,1638687,64544
2015-03-01,Kansas,2201561,1493443,1428091,65352
2015-03-01,Kentucky,3438481,1978823,1874526,104297
2015-03-01,Louisiana,3561944,2166522,2022881,143641
2015-03-01,Maine,1090565,691110,658472,32638
2015-03-01,Maryland,4690491,3139033,2974094,164939
2015-03-01,Massachusetts,5492682,3597341,3416770,180571
2015-03-01,Michigan,7875796,4748857,4473859,274998
2015-03-01,Minnesota,4272956,2998186,2884337,113849
2015-03-01,Mississippi,2277021,1253923,1170356,83567
2015-03-01,Missouri,4728406,3056791,2887036,169755
2015-03-01,Montana,812295,516734,494730,22004
2015-03-01,Nebraska,1437833,1009054,979132,29922
2015-03-01,Nevada,2222091,1393136,1292980,100156
2015-03-01,Ohio,9117696,5715533,5421129,294404
2015-03-01,Oklahoma,2964358,1828473,1751584,76889
2015-03-01,Oregon,3197709,1962380,1850584,111796
2015-03-01,Pennsylvania,10213980,6406408,6052263,354145
2015-03-01,Tennessee,5143697,3062426,2878956,183470
2015-03-01,Texas,20386355,13044962,12461125,583837
2015-03-01,Utah,2127259,1441814,1390696,51118
2015-03-01,Vermont,514531,348217,335461,12756
2015-03-01,Virginia,6479492,4239843,4040318,199525
2015-03-01,Washington,5588657,3533904,3340601,193303
2015-03-01,Wisconsin,4539542,3080867,2938085,142782
2015-03-01,Wyoming,450837,302218,290102,12116
2015-04-01,Alabama,3795273,2170166,2037552,132614
2015-04-01,Alaska,541860,362975,340096,22879
2015-04-01,Arizona,5253623,3174046,2977647,196399
2015-04-01,Arkansas,2296029,1338983,1267673,71310
2015-04-01,California,30216829,18826398,17594659,1231739
2015-04-01,Colorado,4213837,2817304,2704794,112510
2015-04-01,Connecticut,2871086,1899181,1789732,109449
2015-04-01,Delaware,744119,460528,437998,22530
2015-04-01,Florida,16192418,9607811,9058084,549727
2015-04-01,Georgia,7736619,4735991,4439804,296187
2015-04-01,Hawaii,1084940,669187,645104,24083
2015-04-01,Idaho,1241296,791724,760809,30915
2015-04-01,Illinois,10051577,6499013,6106082,392931
2015-04-01,Indiana,5110758,3249285,3088493,160792
2015-04-01,Iowa,2428690,1702323,1638444,63879
2015-04-01,Kansas,2202145,1493226,1428104,65122
2015-04-01,Kentucky,3439530,1977936,1873917,104019
2015-04-01,Louisiana,3563437,2162787,2021790,140997
2015-04-01,Maine,1090579,689909,658087,31822
2015-04-01,Maryland,4692382,3141417,2978798,162619
2015-04-01,Massachusetts,5495719,3595870,3417689,178181
2015-04-01,Michigan,7876897,4750757,4479763,270994
2015-04-01,Minnesota,4275054,3002331,2888543,113788
2015-04-01,Mississippi,2277330,1257058,1174188,82870
2015-04-01,Missouri,4729926,3058205,2890940,167265
2015-04-01,Montana,812851,517282,495305,21977
2015-04-01,Nebraska,1438471,1009259,979055,30204
2015-04-01,Nevada,2225535,1394785,1295937,98848
2015-04-01,Ohio,9119310,5713945,5422656,291289
2015-04-01,Oklahoma,2966457,1831977,1753289,78688
2015-04-01,Oregon,3201589,1965819,1854638,111181
2015-04-01,Pennsylvania,10213906,6412274,6059046,353228
2015-04-01,Tennessee,5147408,3066692,2885754,180938
2015-04-01,Texas,20420653,13052347,12471167,581180
2015-04-01,Utah,2130584,1445478,1394232,51246
2015-04-01,Vermont,514616,347766,335199,12567
2015-04-01,Virginia,6483301,4239190,4042765,196425
2015-04-01,Washington,5596195,3539114,3346743,192371
2015-04-01,Wisconsin,4540646,3080496,2939372,141124
2015-04-01,Wyoming,450938,302299,289899,12400
2015-05-01,Alabama,3796534,2164519,2031470,133049
2015-05-01,Alaska,542036,362798,339977,22821
2015-05-01,Arizona,5261501,3179024,2983595,195429
2015-05-01,Arkansas,2296996,1339839,1269993,69846
2015-05-01,California,30242644,18830333,17620363,1209970
2015-05-01,Colorado,4221620,2819533,2709579,109954
2015-05-01,Connecticut,2871419,1896379,1788339,108040
2015-05-01,Delaware,744838,461456,439061,22395
2015-05-01,Florida,16218527,9618147,9074570,543577
2015-05-01,Georgia,7745959,4735398,4442925,292473
2015-05-01,Hawaii,1085320,669614,646142,23472
2015-05-01,Idaho,1242885,793675,762546,31129
2015-05-01,Illinois,10051696,6506301,6114433,391868
2015-05-01,Indiana,5112558,3254041,3096911,157130
2015-05-01,Iowa,2429607,1700817,1637661,63156
2015-05-01,Kansas,2202959,1493024,1428789,64235
2015-05-01,Kentucky,3440841,1976817,1873250,103567
2015-05-01,Louisiana,3565205,2158261,2020294,137967
2015-05-01,Maine,1090689,688694,657703,30991
2015-05-01,Maryland,4694501,3142923,2982840,160083
2015-05-01,Massachusetts,5499163,3594220,3418656,175564
2015-05-01,Michigan,7878551,4753081,4486713,266368
2015-05-01,Minnesota,4277518,3005863,2892071,113792
2015-05-01,Mississippi,2277791,1259289,1177336,81953
2015-05-01,Missouri,4731896,3058587,2895171,163416
2015-05-01,Montana,813497,517493,495499,21994
2015-05-01,Nebraska,1439238,1009818,979369,30449
2015-05-01,Nevada,2229088,1396200,1298740,97460
2015-05-01,Ohio,9121634,5712467,5426068,286399
2015-05-01,Oklahoma,2968807,1833635,1753826,79809
2015-05-01,Oregon,3205720,1970139,1859558,110581
2015-05-01,Pennsylvania,10214662,6417950,6066953,350997
2015-05-01,Tennessee,5151480,3070773,2892935,177838
2015-05-01,Texas,20455987,13062363,12483045,579318
2015-05-01,Utah,2134048,1449095,1397733,51362
2015-05-01,Vermont,514728,347189,334785,12404
2015-05-01,Virginia,6487589,4237686,4045613,192073
2015-05-01,Washington,5604203,3544965,3353329,191636
2015-05-01,Wisconsin,4542174,3080195,2941178,139017
2015-05-01,Wyoming,451154,302311,289650,12661
2015-06-01,Alabama,3798019,2157472,2024484,132988
2015-06-01,Alaska,542351,362477,339787,22690
2015-06-01,Arizona,5269624,3183495,2988875,194620
2015-06-01,Arkansas,2298077,1340124,1272125,67999
2015-06-01,California,30269968,18825613,17640900,1184713
2015-06-01,Colorado,4229782,2821315,2714525,106790
2015-06-01,Connecticut,2871838,1892772,1786301,106471
2015-06-01,Delaware,745615,462330,440105,22225
2015-06-01,Florida,16245473,9627791,9091449,536342
2015-06-01,Georgia,7755736,4733228,4444943,288285
2015-06-01,Hawaii,1086160,669943,647039,22904
2015-06-01,Idaho,1244553,795165,763973,31192
2015-06-01,Illinois,10052135,6510435,6121275,389160
2015-06-01,Indiana,5114416,3258941,3105042,153899
2015-06-01,Iowa,2430604,1698838,1636400,62438
2015-06-01,Kansas,2204047,1492703,1429837,62866
2015-06-01,Kentucky,3442383,1975226,1872397,102829
2015-06-01,Louisiana,3567129,2152853,2017960,134893
2015-06-01,Maine,1090869,687442,657285,30157
2015-06-01,Maryland,4697090,3142915,2985301,157614
2015-06-01,Massachusetts,5502715,3591258,3418552,172706
2015-06-01,Michigan,7880361,4754815,4494018,260797
2015-06-01,Minnesota,4280102,3007688,2894004,113684
2015-06-01,Mississippi,2278424,1260313,1179455,80858
2015-06-01,Missouri,4734012,3057937,2899170,158767
2015-06-01,Montana,814167,517470,495452,22018
2015-06-01,Nebraska,1440080,1010488,979862,30626
2015-06-01,Nevada,2232794,1397085,1301068,96017
2015-06-01,Ohio,9124155,5709322,5428877,280445
2015-06-01,Oklahoma,2971286,1833226,1753090,80136
2015-06-01,Oregon,3209931,1974615,1865067,109548
2015-06-01,Pennsylvania,10215636,6421791,6073881,347910
2015-06-01,Tennessee,5155812,3073789,2899547,174242
2015-06-01,Texas,20492589,13072586,12493882,578704
2015-06-01,Utah,2137565,1452297,1400856,51441
2015-06-01,Vermont,514899,346525,334255,12270
2015-06-01,Virginia,6493089,4234686,4047714,186972
2015-06-01,Washington,5612692,3550112,3359187,190925
2015-06-01,Wisconsin,4543797,3079718,2943053,136665
2015-06-01,Wyoming,451324,302119,289316,12803
2015-07-01,Alabama,3799477,2149701,2017218,132483
2015-07-01,Alaska,542488,362134,339558,22576
2015-07-01,Arizona,5277926,3187178,2993303,193875
2015-07-01,Arkansas,2299219,1339927,1273942,65985
2015-07-01,California,30296923,18816836,17658045,1158791
2015-07-01,Colorado,4237868,2823037,2719557,103480
2015-07-01,Connecticut,2872304,1889106,1784137,104969
2015-07-01,Delaware,746397,463176,441109,22067
2015-07-01,Florida,16272655,9637406,9108581,528825
2015-07-01,Georgia,7764701,4730359,4446220,284139
2015-07-01,Hawaii,1086606,670277,647849,22428
2015-07-01,Idaho,1246242,796345,765212,31133
2015-07-01,Illinois,10052479,6511967,6125787,386180
2015-07-01,Indiana,5116564,3264081,3112811,151270
2015-07-01,Iowa,2431720,1697034,1635142,61892
2015-07-01,Kansas,2205000,1492465,1431085,61380
2015-07-01,Kentucky,3443963,1974094,1871994,102100
2015-07-01,Louisiana,3569129,2146855,2014908,131947
2015-07-01,Maine,1091034,686253,656874,29379
2015-07-01,Maryland,4699564,3141732,2986335,155397
2015-07-01,Massachusetts,5506549,3587263,3417329,169934
2015-07-01,Michigan,7882629,4756256,4501568,254688
2015-07-01,Minnesota,4282892,3008042,2894625,113417
2015-07-01,Mississippi,2278975,1260827,1180794,80033
2015-07-01,Missouri,4736104,3056934,2902982,153952
2015-07-01,Montana,814872,517499,495460,22039
2015-07-01,Nebraska,1440957,1011241,980537,30704
2015-07-01,Nevada,2236496,1397589,1302948,94641
2015-07-01,Ohio,9127172,5704862,5429949,274913
2015-07-01,Oklahoma,2973610,1831607,1751708,79899
2015-07-01,Oregon,3214297,1979176,1871082,108094
2015-07-01,Pennsylvania,10217178,6424397,6079630,344767
2015-07-01,Tennessee,5160228,3075793,2905360,170433
2015-07-01,Texas,20528677,13083798,12503348,580450
2015-07-01,Utah,2141186,1455143,1403612,51531
2015-07-01,Vermont,515055,345899,333746,12153
2015-07-01,Virginia,6497687,4231177,4049219,181958
2015-07-01,Washington,5621018,3554656,3363984,190672
2015-07-01,Wisconsin,4545633,3079639,2945129,134510
2015-07-01,Wyoming,451543,301719,288919,12800
2015-08-01,Alabama,3801201,2142296,2010491,131805
2015-08-01,Alaska,542917,361851,339307,22544
2015-08-01,Arizona,5287701,3190286,2997349,192937
2015-08-01,Arkansas,2300521,1339528,1275545,63983
2015-08-01,California,30322827,18810236,17674840,1135396
2015-08-01,Colorado,4245694,2825443,2724952,100491
2015-08-01,Connecticut,2872668,1886215,1782474,103741
2015-08-01,Delaware,747145,464036,442091,21945
2015-08-01,Florida,16304520,9648341,9126443,521898
2015-08-01,Georgia,7775261,4728148,4447634,280514
2015-08-01,Hawaii,1087442,670776,648736,22040
2015-08-01,Idaho,1248753,797404,766369,31035
2015-08-01,Illinois,10052472,6513391,6128765,384626
2015-08-01,Indiana,5119646,3269717,3120334,149383
2015-08-01,Iowa,2432799,1696005,1634411,61594
2015-08-01,Kansas,2206043,1492607,1432469,60138
2015-08-01,Kentucky,3445559,1974414,1872627,101787
2015-08-01,Louisiana,3570825,2141096,2011545,129551
2015-08-01,Maine,1091444,685224,656502,28722
2015-08-01,Maryland,4701204,3140095,2986765,153330
2015-08-01,Massachusetts,5510088,3583181,3415653,167528
2015-08-01,Michigan,7886210,4758144,4509543,248601
2015-08-01,Minnesota,4286218,3007887,2894759,113128
2015-08-01,Mississippi,2279661,1261680,1181932,79748
2015-08-01,Missouri,4738008,3056343,2906823,149520
2015-08-01,Montana,815722,517775,495684,22091
2015-08-01,Nebraska,1442076,1012103,981413,30690
2015-08-01,Nevada,2240387,1398013,1304599,93414
2015-08-01,Ohio,9130533,5700670,5429438,271232
2015-08-01,Oklahoma,2975237,1829635,1750196,79439
2015-08-01,Oregon,3220392,1983912,1877482,106430
2015-08-01,Pennsylvania,10219328,6426714,6084814,341900
2015-08-01,Tennessee,5165233,3077329,2910795,166534
2015-08-01,Texas,20562773,13096567,12512227,584340
2015-08-01,Utah,2145803,1457886,1406235,51651
2015-08-01,Vermont,515083,345384,333349,12035
2015-08-01,Virginia,6502056,4227968,4050212,177756
2015-08-01,Washington,5631123,3559448,3368239,191209
2015-08-01,Wisconsin,4547707,3080585,2947761,132824
2015-08-01,Wyoming,451558,301250,288478,12772
2015-09-01,Alabama,3802943,2136055,2004972,131083
2015-09-01,Alaska,543357,361622,339036,22586
2015-09-01,Arizona,5297456,3193508,3002093,191415
2015-09-01,Arkansas,2301817,1339273,1277195,62078
2015-09-01,California,30348765,18810658,17695331,1115327
2015-09-01,Colorado,4253521,2829407,2731343,98064
2015-09-01,Connecticut,2873060,1884305,1781625,102680
2015-09-01,Delaware,747902,464940,443116,21824
2015-09-01,Florida,16336389,9661738,9146394,515344
2015-09-01,Georgia,7785882,4727779,4450420,277359
2015-09-01,Hawaii,1088175,671504,649824,21680
2015-09-01,Idaho,1251267,798413,767529,30884
2015-09-01,Illinois,10052588,6517227,6132095,385132
2015-09-01,Indiana,5122740,3276546,3128292,148254
2015-09-01,Iowa,2433958,1696155,1634605,61550
2015-09-01,Kansas,2207110,1493272,1433984,59288
2015-09-01,Kentucky,3447166,1976725,1874730,101995
2015-09-01,Louisiana,3572509,2136562,2008611,127951
2015-09-01,Maine,1091811,684534,656347,28187
2015-09-01,Maryland,4702765,3138851,2987744,151107
2015-09-01,Massachusetts,5513606,3580147,3414849,165298
2015-09-01,Michigan,7889755,4761803,4518849,242954
2015-09-01,Minnesota,4289567,3008335,2895504,112831
2015-09-01,Mississippi,2280319,1263353,1183427,79926
2015-09-01,Missouri,4739901,3056675,2911038,145637
2015-09-01,Montana,816595,518275,496124,22151
2015-09-01,Nebraska,1443217,1013086,982465,30621
2015-09-01,Nevada,2244284,1398568,1306362,92206
2015-09-01,Ohio,9133856,5698995,5428901,270094
2015-09-01,Oklahoma,2976904,1828048,1749022,79026
2015-09-01,Oregon,3226425,1989069,1884395,104674
2015-09-01,Pennsylvania,10221392,6429981,6090516,339465
2015-09-01,Tennessee,5170211,3079250,2916889,162361
2015-09-01,Texas,20597035,13111812,12523886,587926
2015-09-01,Utah,2150498,1460802,1409096,51706
2015-09-01,Vermont,515145,345015,333114,11901
2015-09-01,Virginia,6506333,4225421,4050900,174521
2015-09-01,Washington,5641221,3565425,3373358,192067
2015-09-01,Wisconsin,4549782,3082966,2951433,131533
2015-09-01,Wyoming,451548,300853,288034,12819
2015-10-01,Alabama,3804782,2135797,2005232,130565
2015-10-01,Alaska,543664,361498,338801,22697
2015-10-01,Arizona,5307253,3198236,3008840,189396
2015-10-01,Arkansas,2303143,1339813,1279410,60403
2015-10-01,California,30374660,18824385,17724466,1099919
2015-10-01,Colorado,4261240,2835695,2739313,96382
2015-10-01,Connecticut,2873493,1883557,1781801,101756
2015-10-01,Delaware,748677,465959,444262,21697
2015-10-01,Florida,16368317,9679856,9170460,509396
2015-10-01,Georgia,7796741,4730976,4456067,274909
2015-10-01,Hawaii,1088651,672548,651209,21339
2015-10-01,Idaho,1253815,799645,768912,30733
2015-10-01,Illinois,10052875,6526537,6138315,388222
2015-10-01,Indiana,5125961,3286118,3137870,148248
2015-10-01,Iowa,2435125,1697907,1636189,61718
2015-10-01,Kansas,2208046,1494509,1435575,58934
2015-10-01,Kentucky,3448760,1981083,1878391,102692
2015-10-01,Louisiana,3574214,2134141,2006830,127311
2015-10-01,Maine,1092251,684485,656665,27820
2015-10-01,Maryland,4704406,3139081,2990357,148724
2015-10-01,Massachusetts,5517301,3579727,3416493,163234
2015-10-01,Michigan,7893558,4769314,4530470,238844
2015-10-01,Minnesota,4293032,3010487,2897657,112830
2015-10-01,Mississippi,2281019,1265802,1185416,80386
2015-10-01,Missouri,4741883,3058618,2916130,142488
2015-10-01,Montana,817456,519031,496790,22241
2015-10-01,Nebraska,1444360,1014321,983776,30545
2015-10-01,Nevada,2248135,1399703,1308661,91042
2015-10-01,Ohio,9137348,5702644,5430886,271758
2015-10-01,Oklahoma,2978633,1827831,1748766,79065
2015-10-01,Oregon,3232588,1995491,1892430,103061
2015-10-01,Pennsylvania,10223727,6436573,6098624,337949
2015-10-01,Tennessee,5175203,3083238,2925088,158150
2015-10-01,Texas,20631313,13133423,12543363,590060
2015-10-01,Utah,2155154,1464379,1412676,51703
2015-10-01,Vermont,515203,344859,333101,11758
2015-10-01,Virginia,6510187,4224998,4052719,172279
2015-10-01,Washington,5651071,3573801,3380768,193033
2015-10-01,Wisconsin,4551926,3087350,2956772,130578
2015-10-01,Wyoming,451574,300679,287649,13030
2015-11-01,Alabama,3806253,2127937,1997567,130370
2015-11-01,Alaska,544206,361518,338641,22877
2015-11-01,Arizona,5316586,3204955,3017642,187313
2015-11-01,Arkansas,2304202,1341300,1282346,58954
2015-11-01,California,30399646,18852382,17762494,1089888
2015-11-01,Colorado,4268872,2844179,2748716,95463
2015-11-01,Connecticut,2873656,1883966,1782985,100981
2015-11-01,Delaware,749351,467051,445489,21562
2015-11-01,Florida,16398883,9702643,9198031,504612
2015-11-01,Georgia,7807629,4737800,4464354,273446
2015-11-01,Hawaii,1089768,673778,652737,21041
2015-11-01,Idaho,1256189,801327,770672,30655
2015-11-01,Illinois,10052412,6542574,6148366,394208
2015-11-01,Indiana,5128517,3298722,3149094,149628
2015-11-01,Iowa,2435921,1701237,1639252,61985
2015-11-01,Kansas,2208941,1496037,1437062,58975
2015-11-01,Kentucky,3450120,1986651,1883128,103523
2015-11-01,Louisiana,3575593,2133748,2006151,127597
2015-11-01,Maine,1092544,685200,657554,27646
2015-11-01,Maryland,4705748,3141039,2994693,146346
2015-11-01,Massachusetts,5520358,3582932,3421499,161433
2015-11-01,Michigan,7896257,4781113,4544206,236907
2015-11-01,Minnesota,4295969,3014550,2901181,113369
2015-11-01,Mississippi,2281545,1268447,1187642,80805
2015-11-01,Missouri,4743494,3062018,2921813,140205
2015-11-01,Montana,818218,519981,497588,22393
2015-11-01,Nebraska,1445350,1015747,985231,30516
2015-11-01,Nevada,2251878,1401563,1311565,89998
2015-11-01,Ohio,9139608,5713128,5437112,276016
2015-11-01,Oklahoma,2980187,1829254,1749506,79748
2015-11-01,Oregon,3238237,2003622,1901807,101815
2015-11-01,Pennsylvania,10224547,6446815,6108866,337949
2015-11-01,Tennessee,5179769,3090043,2935651,154392
2015-11-01,Texas,20664893,13162283,12571333,590950
2015-11-01,Utah,2159614,1468832,1417067,51765
2015-11-01,Vermont,515222,344913,333306,11607
2015-11-01,Virginia,6515086,4227185,4056317,170868
2015-11-01,Washington,5661008,3585005,3390788,194217
2015-11-01,Wisconsin,4553525,3093448,2963483,129965
2015-11-01,Wyoming,451526,300834,287332,13502
2015-12-01,Alabama,3807670,2133700,2003525,130175
2015-12-01,Alaska,544288,361660,338572,23088
2015-12-01,Arizona,5325671,3212709,3027448,185261
2015-12-01,Arkansas,2305251,1343071,1285465,57606
2015-12-01,California,30422273,18886247,17804150,1082097
2015-12-01,Colorado,4275910,2853704,2758635,95069
2015-12-01,Connecticut,2873797,1884911,1784830,100081
2015-12-01,Delaware,749992,468016,446642,21374
2015-12-01,Florida,16428472,9726210,9226214,499996
2015-12-01,Georgia,7817713,4745734,4473442,272292
2015-12-01,Hawaii,1089802,674900,654135,20765
2015-12-01,Idaho,1258579,803322,772741,30581
2015-12-01,Illinois,10051892,6561973,6160489,401484
2015-12-01,Indiana,5131265,3312477,3160677,151800
2015-12-01,Iowa,2436877,1705328,1643195,62133
2015-12-01,Kansas,2209453,1497255,1438196,59059
2015-12-01,Kentucky,3451246,1992217,1888233,103984
2015-12-01,Louisiana,3576862,2134220,2005983,128237
2015-12-01,Maine,1092829,686446,658891,27555
2015-12-01,Maryland,4706659,3143703,2999779,143924
2015-12-01,Massachusetts,5523499,3588507,3428990,159517
2015-12-01,Michigan,7899267,4795181,4558668,236513
2015-12-01,Minnesota,4298949,3019343,2905253,114090
2015-12-01,Mississippi,2281963,1270497,1189803,80694
2015-12-01,Missouri,4745022,3065552,2927136,138416
2015-12-01,Montana,818959,520883,498325,22558
2015-12-01,Nebraska,1446285,1017042,986563,30479
2015-12-01,Nevada,2255466,1403650,1314754,88896
2015-12-01,Ohio,9142204,5728436,5446975,281461
2015-12-01,Oklahoma,2981527,1831352,1750553,80799
2015-12-01,Oregon,3244022,2012522,1911765,100757
2015-12-01,Pennsylvania,10225852,6458131,6118943,339188
2015-12-01,Tennessee,5184152,3098156,2947080,151076
2015-12-01,Texas,20696766,13194306,12603859,590447
2015-12-01,Utah,2164055,1473799,1421939,51860
2015-12-01,Vermont,515234,345067,333646,11421
2015-12-01,Virginia,6517537,4230228,4060702,169526
2015-12-01,Washington,5669906,3597830,3402683,195147
2015-12-01,Wisconsin,4555288,3099913,2970598,129315
2015-12-01,Wyoming,451469,301280,287030,14250
2016-01-01,Alabama,3808871,2138981,2009234,129747
2016-01-01,Alaska,545180,361853,338581,23272
2016-01-01,Arizona,5334647,3220542,3037144,183398
2016-01-01,Arkansas,2306098,1344484,1288132,56352
2016-01-01,California,30446733,18917326,17843140,1074186
2016-01-01,Colorado,4283491,2862652,2767788,94864
2016-01-01,Connecticut,2873756,1885910,1787016,98894
2016-01-01,Delaware,750671,468654,447512,21142
2016-01-01,Florida,16458012,9746916,9252093,494823
2016-01-01,Georgia,7828808,4752310,4481522,270788
2016-01-01,Hawaii,1091566,675700,655187,20513
2016-01-01,Idaho,1260815,805322,774854,30468
2016-01-01,Illinois,10050720,6579309,6171894,407415
2016-01-01,Indiana,5133138,3324395,3170641,153754
2016-01-01,Iowa,2437374,1708738,1646660,62078
2016-01-01,Kansas,2210492,1497864,1438842,59022
2016-01-01,Kentucky,3452439,1996889,1893069,103820
2016-01-01,Louisiana,3578098,2134557,2005777,128780
2016-01-01,Maine,1092946,687907,660486,27421
2016-01-01,Maryland,4707890,3145817,3004440,141377
2016-01-01,Massachusetts,5525824,3594084,3436899,157185
2016-01-01,Michigan,7900971,4808822,4571961,236861
2016-01-01,Minnesota,4301291,3022956,2908419,114537
2016-01-01,Mississippi,2282454,1271520,1191631,79889
2016-01-01,Missouri,4746243,3068547,2931518,137029
2016-01-01,Montana,819668,521545,498852,22693
2016-01-01,Nebraska,1447160,1018062,987626,30436
2016-01-01,Nevada,2259069,1405588,1317857,87731
2016-01-01,Ohio,9143345,5743731,5457717,286014
2016-01-01,Oklahoma,2982968,1832930,1751007,81923
2016-01-01,Oregon,3249240,2020991,1921114,99877
2016-01-01,Pennsylvania,10225383,6467536,6126634,340902
2016-01-01,Tennessee,5188358,3105686,2957506,148180
2016-01-01,Texas,20729955,13224910,12635778,589132
2016-01-01,Utah,2168291,1478801,1426877,51924
2016-01-01,Vermont,515143,345245,334036,11209
2016-01-01,Virginia,6523006,4232843,4065106,167737
2016-01-01,Washington,5679860,3610474,3415138,195336
2016-01-01,Wisconsin,4556269,3105263,2977051,128212
2016-01-01,Wyoming,451394,301853,286696,15157
2016-02-01,Alabama,3810043,2143456,2014380,129076
2016-02-01,Alaska,545399,362043,338619,23424
2016-02-01,Arizona,5343405,3227960,3046025,181935
2016-02-01,Arkansas,2306995,1345263,1289972,55291
2016-02-01,California,30467943,18941962,17875645,1066317
2016-02-01,Colorado,4290525,2870218,2775432,94786
2016-02-01,Connecticut,2873720,1886939,1789442,97497
2016-02-01,Delaware,751256,468905,447972,20933
2016-02-01,Florida,16486036,9763853,9274276,489577
2016-02-01,Georgia,7838741,4756401,4487435,268966
2016-02-01,Hawaii,1091817,676234,655874,20360
2016-02-01,Idaho,1263122,807148,776822,30326
2016-02-01,Illinois,10049562,6590470,6180514,409956
2016-02-01,Indiana,5135638,3332857,3178012,154845
2016-02-01,Iowa,2438141,1710383,1648419,61964
2016-02-01,Kansas,2210999,1497789,1438855,58934
2016-02-01,Kentucky,3453453,2000307,1897358,102949
2016-02-01,Louisiana,3579257,2134491,2005278,129213
2016-02-01,Maine,1093136,689398,662178,27220
2016-02-01,Maryland,4708745,3146807,3007840,138967
2016-02-01,Massachusetts,5528649,3598443,3443921,154522
2016-02-01,Michigan,7903525,4820513,4582714,237799
2016-02-01,Minnesota,4304127,3024171,2909497,114674
2016-02-01,Mississippi,2282748,1271510,1192863,78647
2016-02-01,Missouri,4747477,3070971,2934662,136309
2016-02-01,Montana,820356,521898,499113,22785
2016-02-01,Nebraska,1448030,1018720,988278,30442
2016-02-01,Nevada,2262476,1407222,1320668,86554
2016-02-01,Ohio,9145329,5754850,5466498,288352
2016-02-01,Oklahoma,2984249,1833389,1750363,83026
2016-02-01,Oregon,3254767,2028181,1928738,99443
2016-02-01,Pennsylvania,10225863,6473118,6130276,342842
2016-02-01,Tennessee,5192499,3111657,2965602,146055
2016-02-01,Texas,20761195,13252003,12662766,589237
2016-02-01,Utah,2172793,1483530,1431601,51929
2016-02-01,Vermont,515166,345423,334400,11023
2016-02-01,Virginia,6525781,4234522,4068700,165822
2016-02-01,Washington,5688716,3621594,3426657,194937
2016-02-01,Wisconsin,4557711,3108750,2981909,126841
2016-02-01,Wyoming,451385,302351,286294,16057
2016-03-01,Alabama,3811375,2146821,2018777,128044
2016-03-01,Alaska,545610,362120,338578,23542
2016-03-01,Arizona,5352249,3234359,3053620,180739
2016-03-01,Arkansas,2308015,1345319,1290874,54445
2016-03-01,California,30489297,18959258,17901022,1058236
2016-03-01,Colorado,4297576,2876122,2781378,94744
2016-03-01,Connecticut,2873702,1888081,1792129,95952
2016-03-01,Delaware,751898,468851,448073,20778
2016-03-01,Florida,16514110,9777290,9292824,484466
2016-03-01,Georgia,7849068,4796311,4529480,266831
2016-03-01,Hawaii,1091983,676608,656314,20294
2016-03-01,Idaho,1265474,808719,778561,30158
2016-03-01,Illinois,10048662,6593404,6185600,407804
2016-03-01,Indiana,5138247,3337674,3183002,154672
2016-03-01,Iowa,2438939,1710050,1648133,61917
2016-03-01,Kansas,2211607,1496952,1438043,58909
2016-03-01,Kentucky,3454600,2002784,1901323,101461
2016-03-01,Louisiana,3580477,2133521,2004061,129460
2016-03-01,Maine,1093359,690787,663837,26950
2016-03-01,Maryland,4709564,3146772,3009911,136861
2016-03-01,Massachusetts,5531634,3601685,3450057,151628
2016-03-01,Michigan,7906243,4829629,4590535,239094
2016-03-01,Minnesota,4307033,3023055,2908446,114609
2016-03-01,Mississippi,2283174,1270710,1193455,77255
2016-03-01,Missouri,4748932,3072852,2936300,136552
2016-03-01,Montana,821079,521936,499124,22812
2016-03-01,Nebraska,1448888,1018855,988365,30490
2016-03-01,Nevada,2265948,1408473,1323153,85320
2016-03-01,Ohio,9147631,5759537,5471393,288144
2016-03-01,Oklahoma,2985654,1832699,1748627,84072
2016-03-01,Oregon,3260421,2033640,1934161,99479
2016-03-01,Pennsylvania,10226626,6474416,6129729,344687
2016-03-01,Tennessee,5196802,3116195,2971290,144905
2016-03-01,Texas,20792661,13275533,12683175,592358
2016-03-01,Utah,2177280,1487708,1435988,51720
2016-03-01,Vermont,515178,345578,334690,10888
2016-03-01,Virginia,6528060,4235332,4070935,164397
2016-03-01,Washington,5697581,3630389,3436155,194234
2016-03-01,Wisconsin,4559314,3110352,2984977,125375
2016-03-01,Wyoming,451294,302567,285818,16749
2016-04-01,Alabama,3812782,2149261,2022346,126915
2016-04-01,Alaska,545942,362119,338457,23662
2016-04-01,Arizona,5361241,3239833,3059997,179836
2016-04-01,Arkansas,2309079,1344939,1291027,53912
2016-04-01,California,30512396,18973207,17921613,1051594
2016-04-01,Colorado,4304871,2880932,2786260,94672
2016-04-01,Connecticut,2873785,1889305,1794839,94466
2016-04-01,Delaware,752531,468680,447969,20711
2016-04-01,Florida,16542894,9790156,9309537,480619
2016-04-01,Georgia,7859831,4833906,4568888,265018
2016-04-01,Hawaii,1092461,676978,656743,20235
2016-04-01,Idaho,1267849,810104,780076,30028
2016-04-01,Illinois,10048172,6589117,6186891,402226
2016-04-01,Indiana,5140915,3339764,3186380,153384
2016-04-01,Iowa,2439789,1708496,1646486,62010
2016-04-01,Kansas,2212288,1495476,1436383,59093
2016-04-01,Kentucky,3455877,2005178,1905194,99984
2016-04-01,Louisiana,3581804,2131830,2002097,129733
2016-04-01,Maine,1093632,691999,665340,26659
2016-04-01,Maryland,4710558,3146561,3011264,135297
2016-04-01,Massachusetts,5534696,3604987,3456132,148855
2016-04-01,Michigan,7909088,4836910,4596471,240439
2016-04-01,Minnesota,4310025,3021085,2906473,114612
2016-04-01,Mississippi,2283610,1269674,1193563,76111
2016-04-01,Missouri,4750527,3074491,2936456,138035
2016-04-01,Montana,821797,521820,499039,22781
2016-04-01,Nebraska,1449875,1018474,987872,30602
2016-04-01,Nevada,2269583,1409538,1325445,84093
2016-04-01,Ohio,9150016,5759108,5472521,286587
2016-04-01,Oklahoma,2987151,1831282,1746117,85165
2016-04-01,Oregon,3266109,2037655,1937802,99853
2016-04-01,Pennsylvania,10227506,6472917,6126458,346459
2016-04-01,Tennessee,5201269,3120756,2975759,144997
2016-04-01,Texas,20825236,13297832,12698126,599706
2016-04-01,Utah,2181885,1491391,1440100,51291
2016-04-01,Vermont,515160,345690,334876,10814
2016-04-01,Virginia,6531334,4236772,4072587,164185
2016-04-01,Washington,5706896,3637282,3443618,193664
2016-04-01,Wisconsin,4560930,3110891,2986761,124130
2016-04-01,Wyoming,451233,302403,285301,17102
2016-05-01,Alabama,3814145,2151573,2025350,126223
2016-05-01,Alaska,546309,362119,338314,23805
2016-05-01,Arizona,5370157,3245197,3065928,179269
2016-05-01,Arkansas,2310084,1344591,1290913,53678
2016-05-01,California,30534603,18989520,17941250,1048270
2016-05-01,Colorado,4312234,2885680,2791195,94485
2016-05-01,Connecticut,2873870,1890682,1797493,93189
2016-05-01,Delaware,753166,468563,447804,20759
2016-05-01,Florida,16571697,9806455,9327449,479006
2016-05-01,Georgia,7870375,4870975,4606634,264341
2016-05-01,Hawaii,1092967,677630,657476,20154
2016-05-01,Idaho,1270248,811416,781429,29987
2016-05-01,Illinois,10047560,6580544,6184932,395612
2016-05-01,Indiana,5143600,3340290,3189022,151268
2016-05-01,Iowa,2440696,1706702,1644496,62206
2016-05-01,Kansas,2213068,1493780,1434209,59571
2016-05-01,Kentucky,3457188,2008503,1909307,99196
2016-05-01,Louisiana,3583030,2129860,1999764,130096
2016-05-01,Maine,1093899,693068,666646,26422
2016-05-01,Maryland,4711468,3147271,3012872,134399
2016-05-01,Massachusetts,5537771,3609457,3462973,146484
2016-05-01,Michigan,7911815,4843434,4601766,241668
2016-05-01,Minnesota,4313066,3019912,2904922,114990
2016-05-01,Mississippi,2284042,1269210,1193670,75540
2016-05-01,Missouri,4752183,3076191,2935649,140542
2016-05-01,Montana,822573,521715,498984,22731
2016-05-01,Nebraska,1450843,1017826,987002,30824
2016-05-01,Nevada,2273098,1410785,1327774,83011
2016-05-01,Ohio,9152322,5756166,5470836,285330
2016-05-01,Oklahoma,2988671,1829596,1743321,86275
2016-05-01,Oregon,3271771,2040822,1940533,100289
2016-05-01,Pennsylvania,10228380,6470707,6122515,348192
2016-05-01,Tennessee,5205703,3126578,2980257,146321
2016-05-01,Texas,20857325,13321031,12710616,610415
2016-05-01,Utah,2186473,1494904,1444126,50778
2016-05-01,Vermont,515170,345778,334986,10792
2016-05-01,Virginia,6534789,4240409,4074927,165482
2016-05-01,Washington,5716292,3643393,3449983,193410
2016-05-01,Wisconsin,4562657,3111252,2987959,123293
2016-05-01,Wyoming,451222,301896,284797,17099
2016-06-01,Alabama,3815642,2154315,2028210,126105
2016-06-01,Alaska,546635,362098,338159,23939
2016-06-01,Arizona,5379277,3250898,3072085,178813
2016-06-01,Arkansas,2311209,1344422,1290844,53578
2016-06-01,California,30557662,19008579,17961187,1047392
2016-06-01,Colorado,4319761,2891014,2797121,93893
2016-06-01,Connecticut,2874029,1892133,1800092,92041
2016-06-01,Delaware,753847,468515,447619,20896
2016-06-01,Florida,16601075,9826989,9347749,479240
2016-06-01,Georgia,7880992,4908561,4643573,264988
2016-06-01,Hawaii,1093490,678662,658647,20015
2016-06-01,Idaho,1272686,812750,782732,30018
2016-06-01,Illinois,10047244,6569841,6180798,389043
2016-06-01,Indiana,5146468,3339805,3191314,148491
2016-06-01,Iowa,2441687,1705132,1642812,62320
2016-06-01,Kansas,2213900,1492201,1431926,60275
2016-06-01,Kentucky,3458575,2012869,1913680,99189
2016-06-01,Louisiana,3584422,2127524,1997206,130318
2016-06-01,Maine,1094206,694036,667788,26248
2016-06-01,Maryland,4712540,3149300,3015276,134024
2016-06-01,Massachusetts,5541082,3614771,3470308,144463
2016-06-01,Michigan,7914881,4849566,4606797,242769
2016-06-01,Minnesota,4316269,3019989,2904199,115790
2016-06-01,Mississippi,2284502,1269750,1194254,75496
2016-06-01,Missouri,4753964,3077577,2934414,143163
2016-06-01,Montana,823348,521652,499016,22636
2016-06-01,Nebraska,1451894,1017046,985933,31113
2016-06-01,Nevada,2276707,1412384,1330298,82086
2016-06-01,Ohio,9155037,5752564,5467270,285294
2016-06-01,Oklahoma,2990230,1828018,1740924,87094
2016-06-01,Oregon,3277621,2043662,1943278,100384
2016-06-01,Pennsylvania,10229680,6468539,6119045,349494
2016-06-01,Tennessee,5210293,3133742,2985440,148302
2016-06-01,Texas,20889995,13344101,12722956,621145
2016-06-01,Utah,2191135,1498447,1448202,50245
2016-06-01,Vermont,515205,345859,335071,10788
2016-06-01,Virginia,6538478,4246189,4078270,167919
2016-06-01,Washington,5725845,3649388,3456222,193166
2016-06-01,Wisconsin,4564494,3111805,2989047,122758
2016-06-01,Wyoming,451169,301109,284349,16760
2016-07-01,Alabama,3817320,2157474,2031143,126331
2016-07-01,Alaska,547000,362029,338000,24029
2016-07-01,Arizona,5388764,3256816,3078706,178110
2016-07-01,Arkansas,2312505,1344309,1290861,53448
2016-07-01,California,30582360,19028074,17981056,1047018
2016-07-01,Colorado,4327483,2896793,2804247,92546
2016-07-01,Connecticut,2874369,1893536,1802669,90867
2016-07-01,Delaware,754560,468517,447440,21077
2016-07-01,Florida,16631565,9850017,9369741,480276
2016-07-01,Georgia,7891678,4947062,4680456,266606
2016-07-01,Hawaii,1094097,679858,660086,19772
2016-07-01,Idaho,1275237,814013,784003,30010
2016-07-01,Illinois,10047294,6558534,6175653,382881
2016-07-01,Indiana,5149720,3338179,3192914,145265
2016-07-01,Iowa,2442852,1703877,1641745,62132
2016-07-01,Kansas,2214883,1490884,1429885,60999
2016-07-01,Kentucky,3460228,2017591,1917963,99628
2016-07-01,Louisiana,3586053,2124777,1994428,130349
2016-07-01,Maine,1094627,694904,668817,26087
2016-07-01,Maryland,4714009,3152707,3018813,133894
2016-07-01,Massachusetts,5544738,3620318,3477693,142625
2016-07-01,Michigan,7918535,4855399,4611733,243666
2016-07-01,Minnesota,4319767,3021008,2904097,116911
2016-07-01,Mississippi,2285162,1270922,1195416,75506
2016-07-01,Missouri,4755898,3078141,2933221,144920
2016-07-01,Montana,824204,521634,499140,22494
2016-07-01,Nebraska,1453027,1016161,984777,31384
2016-07-01,Nevada,2280511,1414241,1333032,81209
2016-07-01,Ohio,9158454,5749748,5463246,286502
2016-07-01,Oklahoma,2991883,1826864,1739455,87409
2016-07-01,Oregon,3283694,2046599,1946984,99615
2016-07-01,Pennsylvania,10231756,6465434,6115856,349578
2016-07-01,Tennessee,5215287,3141665,2991411,150254
2016-07-01,Texas,20923730,13365941,12736496,629445
2016-07-01,Utah,2195928,1502055,1452325,49730
2016-07-01,Vermont,515265,345924,335154,10770
2016-07-01,Virginia,6542390,4253358,4082681,170677
2016-07-01,Washington,5735768,3655019,3462950,192069
2016-07-01,Wisconsin,4566737,3112393,2990301,122092
2016-07-01,Wyoming,451175,300247,283973,16274
2016-08-01,Alabama,3819041,2160744,2034025,126719
2016-08-01,Alaska,547166,361944,337853,24091
2016-08-01,Arizona,5398026,3262727,3085510,177217
2016-08-01,Arkansas,2313694,1344072,1290838,53234
2016-08-01,California,30603497,19046039,17999607,1046432
2016-08-01,Colorado,4333997,2902625,2812008,90617
2016-08-01,Connecticut,2874907,1894991,1805214,89777
2016-08-01,Delaware,755276,468615,447331,21284
2016-08-01,Florida,16660212,9873290,9391728,481562
2016-08-01,Georgia,7901048,4986532,4717653,268879
2016-08-01,Hawaii,1094428,680909,661451,19458
2016-08-01,Idaho,1277924,815143,785242,29901
2016-08-01,Illinois,10047320,6548208,6170083,378125
2016-08-01,Indiana,5152279,3335426,3193276,142150
2016-08-01,Iowa,2443877,1702459,1640827,61632
2016-08-01,Kansas,2215338,1489730,1428192,61538
2016-08-01,Kentucky,3461891,2022067,1921669,100398
2016-08-01,Louisiana,3586312,2121376,1991224,130152
2016-08-01,Maine,1095131,695716,669786,25930
2016-08-01,Maryland,4716465,3157347,3023343,134004
2016-08-01,Massachusetts,5548563,3625768,3484610,141158
2016-08-01,Michigan,7922091,4860940,4616444,244496
2016-08-01,Minnesota,4323214,3022594,2904394,118200
2016-08-01,Mississippi,2285881,1272319,1196860,75459
2016-08-01,Missouri,4757964,3077411,2932194,145217
2016-08-01,Montana,825155,521668,499311,22357
2016-08-01,Nebraska,1453909,1015208,983589,31619
2016-08-01,Nevada,2284685,1416277,1335898,80379
2016-08-01,Ohio,9162085,5749164,5459942,289222
2016-08-01,Oklahoma,2992749,1826152,1738948,87204
2016-08-01,Oregon,3288289,2049413,1951419,97994
2016-08-01,Pennsylvania,10234047,6460382,6111927,348455
2016-08-01,Tennessee,5220640,3148996,2997016,151980
2016-08-01,Texas,20954163,13386060,12750754,635306
2016-08-01,Utah,2200587,1505706,1456380,49326
2016-08-01,Vermont,515403,345995,335259,10736
2016-08-01,Virginia,6548312,4261151,4088025,173126
2016-08-01,Washington,5746009,3660154,3470082,190072
2016-08-01,Wisconsin,4568957,3112627,2991530,121097
2016-08-01,Wyoming,450983,299501,283660,15841
2016-09-01,Alabama,3820951,2163777,2036649,127128
2016-09-01,Alaska,547374,361974,337799,24175
2016-09-01,Arizona,5407618,3268544,3092046,176498
2016-09-01,Arkansas,2314999,1343648,1290648,53000
2016-09-01,California,30626494,19061155,18015129,1046026
2016-09-01,Colorado,4340722,2908090,2819516,88574
2016-09-01,Connecticut,2875660,1896690,1807641,89049
2016-09-01,Delaware,756102,468865,447328,21537
2016-09-01,Florida,16689784,9894617,9411626,482991
2016-09-01,Georgia,7910767,5007844,4736489,271355
2016-09-01,Hawaii,1094839,681639,662483,19156
2016-09-01,Idaho,1280709,816266,786512,29754
2016-09-01,Illinois,10047781,6539107,6164292,374815
2016-09-01,Indiana,5155140,3331610,3191886,139724
2016-09-01,Iowa,2445007,1700400,1639444,60956
2016-09-01,Kansas,2215863,1488560,1426801,61759
2016-09-01,Kentucky,3463726,2026061,1924543,101518
2016-09-01,Louisiana,3586737,2117470,1987810,129660
2016-09-01,Maine,1095713,696481,670673,25808
2016-09-01,Maryland,4719113,3162687,3028270,134417
2016-09-01,Massachusetts,5552657,3630818,3490335,140483
2016-09-01,Michigan,7925989,4866256,4620323,245933
2016-09-01,Minnesota,4326878,3024432,2904939,119493
2016-09-01,Mississippi,2286653,1273642,1198270,75372
2016-09-01,Missouri,4760235,3075144,2931162,143982
2016-09-01,Montana,826169,521755,499476,22279
2016-09-01,Nebraska,1454904,1014279,982416,31863
2016-09-01,Nevada,2289002,1418474,1338773,79701
2016-09-01,Ohio,9166161,5752040,5458133,293907
2016-09-01,Oklahoma,2993771,1825492,1738937,86555
2016-09-01,Oregon,3293114,2051528,1955705,95823
2016-09-01,Pennsylvania,10236775,6453159,6106573,346586
2016-09-01,Tennessee,5226225,3154762,3001280,153482
2016-09-01,Texas,20985782,13403980,12763563,640417
2016-09-01,Utah,2205274,1509362,1460215,49147
2016-09-01,Vermont,515579,346058,335351,10707
2016-09-01,Virginia,6554563,4269034,4094058,174976
2016-09-01,Washington,5756519,3665002,3477143,187859
2016-09-01,Wisconsin,4571331,3112289,2992319,119970
2016-09-01,Wyoming,450823,298941,283384,15557
2016-10-01,Alabama,3822861,2166110,2039127,126983
2016-10-01,Alaska,547373,362112,337870,24242
2016-10-01,Arizona,5417057,3274187,3098339,175848
2016-10-01,Arkansas,2316340,1342910,1290250,52660
2016-10-01,California,30648257,19071727,18028383,1043344
2016-10-01,Colorado,4347159,2912869,2826596,86273
2016-10-01,Connecticut,2876331,1898583,1810005,88578
2016-10-01,Delaware,756884,469237,447444,21793
2016-10-01,Florida,16718944,9912032,9428996,483036
2016-10-01,Georgia,7920402,5065858,4793054,272804
2016-10-01,Hawaii,1094781,681999,663144,18855
2016-10-01,Idaho,1283493,817413,787865,29548
2016-10-01,Illinois,10048334,6529612,6158816,370796
2016-10-01,Indiana,5158013,3326557,3188983,137574
2016-10-01,Iowa,2446168,1697326,1637247,60079
2016-10-01,Kansas,2216246,1487280,1425871,61409
2016-10-01,Kentucky,3465422,2029535,1926913,102622
2016-10-01,Louisiana,3587044,2113467,1984845,128622
2016-10-01,Maine,1096317,697115,671499,25616
2016-10-01,Maryland,4721604,3167854,3033190,134664
2016-10-01,Massachusetts,5556771,3635097,3494693,140404
2016-10-01,Michigan,7930030,4870453,4623219,247234
2016-10-01,Minnesota,4330635,3026209,2906061,120148
2016-10-01,Mississippi,2287376,1274607,1199606,75001
2016-10-01,Missouri,4762631,3071352,2930190,141162
2016-10-01,Montana,827139,521828,499594,22234
2016-10-01,Nebraska,1455876,1013352,981360,31992
2016-10-01,Nevada,2293207,1420709,1341689,79020
2016-10-01,Ohio,9170273,5757428,5457993,299435
2016-10-01,Oklahoma,2994760,1824350,1738956,85394
2016-10-01,Oregon,3297913,2052451,1959271,93180
2016-10-01,Pennsylvania,10239633,6444103,6100196,343907
2016-10-01,Tennessee,5231683,3158441,3004295,154146
2016-10-01,Texas,21016880,13419163,12774408,644755
2016-10-01,Utah,2210053,1512986,1463848,49138
2016-10-01,Vermont,515777,346102,335396,10706
2016-10-01,Virginia,6559961,4276217,4100496,175721
2016-10-01,Washington,5766564,3669217,3483903,185314
2016-10-01,Wisconsin,4573809,3111091,2992589,118502
2016-10-01,Wyoming,450635,298556,283145,15411
2016-11-01,Alabama,3824434,2167734,2042073,125661
2016-11-01,Alaska,547491,362298,338067,24231
2016-11-01,Arizona,5426062,3280006,3105116,174890
2016-11-01,Arkansas,2317392,1342237,1290085,52152
2016-11-01,California,30668672,19079948,18044658,1035290
2016-11-01,Colorado,4353436,2917546,2834159,83387
2016-11-01,Connecticut,2876745,1900809,1812673,88136
2016-11-01,Delaware,757580,469756,447782,21974
2016-11-01,Florida,16746204,9926694,9446908,479786
2016-11-01,Georgia,7929986,5066497,4794312,272185
2016-11-01,Hawaii,1095019,682195,663687,18508
2016-11-01,Idaho,1286128,818658,789438,29220
2016-11-01,Illinois,10048158,6518407,6154569,363838
2016-11-01,Indiana,5160413,3321175,3186375,134800
2016-11-01,Iowa,2447065,1693569,1634566,59003
2016-11-01,Kansas,2216532,1486064,1425661,60403
2016-11-01,Kentucky,3466939,2033028,1929665,103363
2016-11-01,Louisiana,3587097,2110081,1983120,126961
2016-11-01,Maine,1096776,697657,672408,25249
2016-11-01,Maryland,4723739,3172830,3038452,134378
2016-11-01,Massachusetts,5560400,3639080,3498632,140448
2016-11-01,Michigan,7933209,4873086,4626288,246798
2016-11-01,Minnesota,4333928,3028316,2908696,119620
2016-11-01,Mississippi,2287980,1275297,1201112,74185
2016-11-01,Missouri,4764665,3066907,2929960,136947
2016-11-01,Montana,828064,521938,499776,22162
2016-11-01,Nebraska,1456682,1012567,980719,31848
2016-11-01,Nevada,2297276,1423131,1344990,78141
2016-11-01,Ohio,9173416,5763754,5460359,303395
2016-11-01,Oklahoma,2995627,1822914,1739205,83709
2016-11-01,Oregon,3302377,2052819,1962568,90251
2016-11-01,Pennsylvania,10241288,6435694,6095476,340218
2016-11-01,Tennessee,5236761,3160471,3007297,153174
2016-11-01,Texas,21046899,13434311,12787312,646999
2016-11-01,Utah,2214643,1516777,1467644,49133
2016-11-01,Vermont,515880,346202,335457,10745
2016-11-01,Virginia,6565331,4283055,4107886,175169
2016-11-01,Washington,5776410,3673004,3490923,182081
2016-11-01,Wisconsin,4575836,3109627,2993340,116287
2016-11-01,Wyoming,450398,298248,282998,15250
2016-12-01,Alabama,3825968,2168771,2045834,122937
2016-12-01,Alaska,547590,362459,338328,24131
2016-12-01,Arizona,5434795,3286375,3112781,173594
2016-12-01,Arkansas,2318409,1342177,1290651,51526
2016-12-01,California,30688153,19090083,18068401,1021682
2016-12-01,Colorado,4359555,2922961,2842900,80061
2016-12-01,Connecticut,2877085,1903587,1815897,87690
2016-12-01,Delaware,758249,470473,448430,22043
2016-12-01,Florida,16773010,9941833,9468761,473072
2016-12-01,Georgia,7939421,5068628,4799051,269577
2016-12-01,Hawaii,1095214,682432,664308,18124
2016-12-01,Idaho,1288749,820142,791352,28790
2016-12-01,Illinois,10047713,6506520,6152559,353961
2016-12-01,Indiana,5162688,3317083,3185941,131142
2016-12-01,Iowa,2447876,1689919,1632092,57827
2016-12-01,Kansas,2216707,1485099,1426125,58974
2016-12-01,Kentucky,3468367,2036870,1933310,103560
2016-12-01,Louisiana,3587029,2107951,1982995,124956
2016-12-01,Maine,1097189,698186,673402,24784
2016-12-01,Maryland,4725774,3177879,3044323,133556
2016-12-01,Massachusetts,5563855,3643795,3503296,140499
2016-12-01,Michigan,7936205,4874253,4630737,243516
2016-12-01,Minnesota,4337066,3031048,2913051,117997
2016-12-01,Mississippi,2288535,1275809,1202794,73015
2016-12-01,Missouri,4766621,3063183,2930971,132212
2016-12-01,Montana,828950,522219,500168,22051
2016-12-01,Nebraska,1457487,1012214,980735,31479
2016-12-01,Nevada,2301284,1426046,1348939,77107
2016-12-01,Ohio,9176341,5770112,5465690,304422
2016-12-01,Oklahoma,2996384,1821747,1740013,81734
2016-12-01,Oregon,3306702,2053931,1966524,87407
2016-12-01,Pennsylvania,10242658,6430351,6094481,335870
2016-12-01,Tennessee,5241716,3161953,3011886,150067
2016-12-01,Texas,21076258,13452830,12805992,646838
2016-12-01,Utah,2219183,1520948,1471879,49069
2016-12-01,Vermont,515998,346418,335584,10834
2016-12-01,Virginia,6570569,4290653,4116919,173734
2016-12-01,Washington,5786076,3677076,3498667,178409
2016-12-01,Wisconsin,4577736,3108972,2995667,113305
2016-12-01,Wyoming,450188,297901,282982,14919
2017-01-01,Alabama,3827336,2169189,2050155,119034
2017-01-01,Alaska,547623,362577,338607,23970
2017-01-01,Arizona,5443325,3293551,3121383,172168
2017-01-01,Arkansas,2319332,1343005,1292124,50881
2017-01-01,California,30706378,19104295,18099840,1004455
2017-01-01,Colorado,4365315,2929729,2852981,76748
2017-01-01,Connecticut,2877354,1906632,1819374,87258
2017-01-01,Delaware,758922,471348,449362,21986
2017-01-01,Florida,16799082,9959680,9495705,463975
2017-01-01,Georgia,7948388,5072698,4807043,265655
2017-01-01,Hawaii,1095136,682762,665044,17718
2017-01-01,Idaho,1291268,821939,793663,28276
2017-01-01,Illinois,10046909,6496269,6153055,343214
2017-01-01,Indiana,5164740,3315526,3188666,126860
2017-01-01,Iowa,2448593,1687324,1630667,56657
2017-01-01,Kansas,2216729,1484359,1426926,57433
2017-01-01,Kentucky,3469500,2040998,1937727,103271
2017-01-01,Louisiana,3586792,2106911,1984300,122611
2017-01-01,Maine,1097564,698709,674366,24343
2017-01-01,Maryland,4727477,3183120,3050617,132503
2017-01-01,Massachusetts,5567147,3650057,3509430,140627
2017-01-01,Michigan,7938921,4874232,4637189,237043
2017-01-01,Minnesota,4340091,3034846,2919266,115580
2017-01-01,Mississippi,2288902,1276109,1204436,71673
2017-01-01,Missouri,4768305,3060674,2932864,127810
2017-01-01,Montana,829814,522736,500829,21907
2017-01-01,Nebraska,1458153,1012343,981325,31018
2017-01-01,Nevada,2305093,1429587,1353517,76070
2017-01-01,Ohio,9178815,5776773,5473846,302927
2017-01-01,Oklahoma,2996974,1821261,1741505,79756
2017-01-01,Oregon,3310911,2056713,1971741,84972
2017-01-01,Pennsylvania,10243590,6428773,6097160,331613
2017-01-01,Tennessee,5246270,3163878,3018945,144933
2017-01-01,Texas,21104864,13475517,12831319,644198
2017-01-01,Utah,2223546,1525486,1476505,48981
2017-01-01,Vermont,516063,346696,335767,10929
2017-01-01,Virginia,6574870,4299497,4127652,171845
2017-01-01,Washington,5795156,3682399,3507480,174919
2017-01-01,Wisconsin,4579412,3109927,2999980,109947
2017-01-01,Wyoming,449900,297484,283090,14394
2017-02-01,Alabama,3828265,2169168,2054720,114448
2017-02-01,Alaska,547523,362605,338829,23776
2017-02-01,Arizona,5451183,3301274,3130805,170469
2017-02-01,Arkansas,2319981,1344688,1294415,50273
2017-02-01,California,30720743,19121397,18136366,985031
2017-02-01,Colorado,4370670,2938091,2864182,73909
2017-02-01,Connecticut,2877294,1909269,1822563,86706
2017-02-01,Delaware,759440,472237,450433,21804
2017-02-01,Florida,16822770,9980408,9527052,453356
2017-02-01,Georgia,7956361,5078100,4817250,260850
2017-02-01,Hawaii,1094820,683131,665872,17259
2017-02-01,Idaho,1293661,823968,796281,27687
2017-02-01,Illinois,10044983,6488487,6155316,333171
2017-02-01,Indiana,5166404,3316422,3194259,122163
2017-02-01,Iowa,2449040,1686199,1630708,55491
2017-02-01,Kansas,2216489,1483907,1427958,55949
2017-02-01,Kentucky,3470348,2045074,1942386,102688
2017-02-01,Louisiana,3586192,2106351,1986682,119669
2017-02-01,Maine,1097810,699228,675229,23999
2017-02-01,Maryland,4728764,3188452,3057065,131387
2017-02-01,Massachusetts,5569963,3657344,3516653,140691
2017-02-01,Michigan,7940951,4873554,4645337,228217
2017-02-01,Minnesota,4342753,3039709,2927040,112669
2017-02-01,Mississippi,2289079,1276237,1205892,70345
2017-02-01,Missouri,4769419,3059217,2935347,123870
2017-02-01,Montana,830555,523443,501711,21732
2017-02-01,Nebraska,1458699,1012904,982401,30503
2017-02-01,Nevada,2308708,1433636,1358554,75082
2017-02-01,Ohio,9180547,5783542,5483674,299868
2017-02-01,Oklahoma,2997232,1821588,1743748,77840
2017-02-01,Oregon,3314845,2061602,1978539,83063
2017-02-01,Pennsylvania,10243625,6430102,6102515,327587
2017-02-01,Tennessee,5250360,3166548,3028406,138142
2017-02-01,Texas,21131020,13499782,12862492,637290
2017-02-01,Utah,2227847,1530178,1481315,48863
2017-02-01,Vermont,516120,346946,335994,10952
2017-02-01,Virginia,6578630,4309148,4139557,169591
2017-02-01,Washington,5803711,3689536,3517700,171836
2017-02-01,Wisconsin,4580718,3112689,3006097,106592
2017-02-01,Wyoming,449600,297008,283273,13735
2017-03-01,Alabama,3829333,2169063,2059199,109864
2017-03-01,Alaska,547417,362524,338908,23616
2017-03-01,Arizona,5459193,3308948,3140297,168651
2017-03-01,Arkansas,2320778,1346836,1296965,49871
2017-03-01,California,30735267,19138738,18171800,966938
2017-03-01,Colorado,4376278,2947782,2875727,72055
2017-03-01,Connecticut,2877313,1910761,1824688,86073
2017-03-01,Delaware,760014,473009,451426,21583
2017-03-01,Florida,16846758,10002242,9559207,443035
2017-03-01,Georgia,7964783,5084089,4828075,256014
2017-03-01,Hawaii,1094525,683299,666542,16757
2017-03-01,Idaho,1296159,826061,798974,27087
2017-03-01,Illinois,10043386,6483032,6157292,325740
2017-03-01,Indiana,5168285,3318619,3200762,117857
2017-03-01,Iowa,2449719,1686230,1631800,54430
2017-03-01,Kansas,2216375,1483866,1429048,54818
2017-03-01,Kentucky,3471436,2048431,1946296,102135
2017-03-01,Louisiana,3585727,2106037,1989661,116376
2017-03-01,Maine,1098136,699670,675848,23822
2017-03-01,Maryland,4730125,3193349,3062891,130458
2017-03-01,Massachusetts,5572949,3664380,3523611,140769
2017-03-01,Michigan,7943239,4872774,4653439,219335
2017-03-01,Minnesota,4345594,3044443,2934574,109869
2017-03-01,Mississippi,2289330,1276233,1206961,69272
2017-03-01,Missouri,4770874,3058640,2938027,120613
2017-03-01,Montana,831334,524216,502647,21569
2017-03-01,Nebraska,1459369,1013791,983736,30055
2017-03-01,Nevada,2312390,1437984,1363702,74282
2017-03-01,Ohio,9182728,5789264,5492641,296623
2017-03-01,Oklahoma,2997625,1822754,1746581,76173
2017-03-01,Oregon,3318897,2068264,1986270,81994
2017-03-01,Pennsylvania,10244043,6432034,6107865,324169
2017-03-01,Tennessee,5254762,3169775,3039106,130669
2017-03-01,Texas,21157545,13521412,12895119,626293
2017-03-01,Utah,2232281,1534721,1485912,48809
2017-03-01,Vermont,516208,347125,336240,10885
2017-03-01,Virginia,6582701,4318271,4151048,167223
2017-03-01,Washington,5812551,3698062,3528462,169600
2017-03-01,Wisconsin,4582253,3116581,3012701,103880
2017-03-01,Wyoming,449313,296518,283446,13072
2017-04-01,Alabama,3830510,2169397,2063832,105565
2017-04-01,Alaska,547545,362324,338797,23527
2017-04-01,Arizona,5467393,3316282,3149472,166810
2017-04-01,Arkansas,2321575,1349136,1299404,49732
2017-04-01,California,30752193,19156417,18204216,952201
2017-04-01,Colorado,4382200,2958477,2886975,71502
2017-04-01,Connecticut,2877417,1910872,1825493,85379
2017-04-01,Delaware,760618,473786,452398,21388
2017-04-01,Florida,16871541,10021874,9587640,434234
2017-04-01,Georgia,7973759,5091222,4839659,251563
2017-04-01,Hawaii,1094624,683102,666882,16220
2017-04-01,Idaho,1298673,828212,801688,26524
2017-04-01,Illinois,10042277,6480395,6158728,321667
2017-04-01,Indiana,5170204,3321686,3206865,114821
2017-04-01,Iowa,2450329,1687055,1633446,53609
2017-04-01,Kansas,2216468,1484339,1430129,54210
2017-04-01,Kentucky,3472662,2050906,1949344,101562
2017-04-01,Louisiana,3585365,2106249,1993148,113101
2017-04-01,Maine,1098491,700067,676260,23807
2017-04-01,Maryland,4731712,3197993,3068197,129796
2017-04-01,Massachusetts,5575973,3670870,3529989,140881
2017-04-01,Michigan,7945516,4873671,4660416,213255
2017-04-01,Minnesota,4348459,3048561,2940884,107677
2017-04-01,Mississippi,2289668,1276242,1207760,68482
2017-04-01,Missouri,4772470,3058858,2940847,118011
2017-04-01,Montana,832173,524980,503516,21464
2017-04-01,Nebraska,1460051,1014926,985145,29781
2017-04-01,Nevada,2316135,1442558,1368857,73701
2017-04-01,Ohio,9184900,5793990,5500107,293883
2017-04-01,Oklahoma,2998224,1825034,1750143,74891
2017-04-01,Oregon,3322961,2075771,1993891,81880
2017-04-01,Pennsylvania,10244449,6432707,6111244,321463
2017-04-01,Tennessee,5259299,3173752,3050343,123409
2017-04-01,Texas,21185490,13539599,12926792,612807
2017-04-01,Utah,2236716,1539025,1490178,48847
2017-04-01,Vermont,516283,347240,336510,10730
2017-04-01,Virginia,6587696,4326576,4161649,164927
2017-04-01,Washington,5821915,3707560,3538912,168648
2017-04-01,Wisconsin,4583785,3120906,3018674,102232
2017-04-01,Wyoming,449046,296125,283584,12541
2017-05-01,Alabama,3831738,2170254,2068766,101488
2017-05-01,Alaska,547568,362029,338550,23479
2017-05-01,Arizona,5475632,3322775,3157971,164804
2017-05-01,Arkansas,2322473,1351283,1301495,49788
2017-05-01,California,30768143,19173509,18233484,940025
2017-05-01,Colorado,4388075,2969650,2897307,72343
2017-05-01,Connecticut,2877571,1909656,1825046,84610
2017-05-01,Delaware,761229,474681,453457,21224
2017-05-01,Florida,16896488,10035568,9608502,427066
2017-05-01,Georgia,7982640,5099686,4852300,247386
2017-05-01,Hawaii,1094527,682436,666824,15612
2017-05-01,Idaho,1301254,830435,804386,26049
2017-05-01,Illinois,10041245,6480342,6160153,320189
2017-05-01,Indiana,5172316,3325107,3211596,113511
2017-05-01,Iowa,2451132,1688010,1635031,52979
2017-05-01,Kansas,2216547,1485132,1431168,53964
2017-05-01,Kentucky,3473934,2052494,1951741,100753
2017-05-01,Louisiana,3585080,2106810,1996900,109910
2017-05-01,Maine,1098886,700407,676534,23873
2017-05-01,Maryland,4733208,3202591,3073263,129328
2017-05-01,Massachusetts,5579253,3676709,3535808,140901
2017-05-01,Michigan,7948140,4877498,4665848,211650
2017-05-01,Minnesota,4351521,3051857,2945848,106009
2017-05-01,Mississippi,2290029,1276089,1208352,67737
2017-05-01,Missouri,4774274,3059510,2943719,115791
2017-05-01,Montana,833044,525640,504229,21411
2017-05-01,Nebraska,1460788,1016136,986512,29624
2017-05-01,Nevada,2319911,1447183,1373995,73188
2017-05-01,Ohio,9187468,5798349,5506621,291728
2017-05-01,Oklahoma,2998855,1828387,1754403,73984
2017-05-01,Oregon,3327202,2082873,2000363,82510
2017-05-01,Pennsylvania,10245398,6430882,6111812,319070
2017-05-01,Tennessee,5263952,3178589,3061471,117118
2017-05-01,Texas,21212877,13554747,12956771,597976
2017-05-01,Utah,2241236,1542965,1494109,48856
2017-05-01,Vermont,516395,347293,336775,10518
2017-05-01,Virginia,6592107,4334159,4171541,162618
2017-05-01,Washington,5831159,3717174,3548309,168865
2017-05-01,Wisconsin,4585572,3125083,3023465,101618
2017-05-01,Wyoming,448807,295897,283669,12228
2017-06-01,Alabama,3833212,2171313,2073459,97854
2017-06-01,Alaska,547498,361709,338239,23470
2017-06-01,Arizona,5484293,3328309,3165349,162960
2017-06-01,Arkansas,2323505,1352962,1302925,50037
2017-06-01,California,30785787,19188584,18258506,930078
2017-06-01,Colorado,4394135,2980602,2906089,74513
2017-06-01,Connecticut,2877943,1907293,1823366,83927
2017-06-01,Delaware,761894,475693,454570,21123
2017-06-01,Florida,16922604,10042754,9620715,422039
2017-06-01,Georgia,7991681,5108679,4864903,243776
2017-06-01,Hawaii,1094338,681277,666324,14953
2017-06-01,Idaho,1303917,832754,807001,25753
2017-06-01,Illinois,10040833,6482173,6161540,320633
2017-06-01,Indiana,5174848,3328244,3214341,113903
2017-06-01,Iowa,2452121,1688463,1635980,52483
2017-06-01,Kansas,2216714,1485827,1431955,53872
2017-06-01,Kentucky,3475403,2053206,1953465,99741
2017-06-01,Louisiana,3584978,2107644,2000528,107116
2017-06-01,Maine,1099367,700618,676626,23992
2017-06-01,Maryland,4735001,3206885,3077664,129221
2017-06-01,Massachusetts,5582922,3681881,3540960,140921
2017-06-01,Michigan,7951337,4883773,4669549,214224
2017-06-01,Minnesota,4354936,3054311,2949555,104756
2017-06-01,Mississippi,2290451,1275600,1208597,67003
2017-06-01,Missouri,4776343,3060109,2946086,114023
2017-06-01,Montana,833938,526118,504679,21439
2017-06-01,Nebraska,1461662,1017213,987682,29531
2017-06-01,Nevada,2323776,1451672,1378935,72737
2017-06-01,Ohio,9190673,5803149,5512740,290409
2017-06-01,Oklahoma,2999600,1832045,1758622,73423
2017-06-01,Oregon,3331658,2088296,2004680,83616
2017-06-01,Pennsylvania,10247076,6426822,6109464,317358
2017-06-01,Tennessee,5268917,3184073,3071416,112657
2017-06-01,Texas,21241618,13567834,12983477,584357
2017-06-01,Utah,2245932,1546385,1497558,48827
2017-06-01,Vermont,516530,347283,336961,10322
2017-06-01,Virginia,6596798,4340500,4180059,160441
2017-06-01,Washington,5840658,3725985,3555963,170022
2017-06-01,Wisconsin,4587663,3128427,3026599,101828
2017-06-01,Wyoming,448586,295839,283652,12187
2017-07-01,Alabama,3834828,2172434,2077532,94902
2017-07-01,Alaska,547459,361372,337880,23492
2017-07-01,Arizona,5493149,3333523,3171760,161763
2017-07-01,Arkansas,2324707,1353952,1303536,50416
2017-07-01,California,30803890,19201013,18279336,921677
2017-07-01,Colorado,4400398,2991064,2913469,77595
2017-07-01,Connecticut,2878402,1904292,1820854,83438
2017-07-01,Delaware,762579,476718,455623,21095
2017-07-01,Florida,16949383,10045858,9626706,419152
2017-07-01,Georgia,8000403,5117098,4876282,240816
2017-07-01,Hawaii,1094083,679818,665480,14338
2017-07-01,Idaho,1306643,835212,809546,25666
2017-07-01,Illinois,10040493,6485261,6163441,321820
2017-07-01,Indiana,5177619,3330989,3215762,115227
2017-07-01,Iowa,2453207,1688210,1636179,52031
2017-07-01,Kansas,2216971,1486048,1432274,53774
2017-07-01,Kentucky,3477035,2053360,1954844,98516
2017-07-01,Louisiana,3585050,2108807,2003873,104934
2017-07-01,Maine,1099895,700664,676579,24085
2017-07-01,Maryland,4737038,3210414,3080784,129630
2017-07-01,Massachusetts,5586853,3686544,3545472,141072
2017-07-01,Michigan,7954986,4891251,4671432,219819
2017-07-01,Minnesota,4358552,3056135,2952276,103859
2017-07-01,Mississippi,2291018,1274892,1208572,66320
2017-07-01,Missouri,4778332,3060236,2947425,112811
2017-07-01,Montana,834883,526397,504854,21543
2017-07-01,Nebraska,1462522,1018050,988499,29551
2017-07-01,Nevada,2327779,1456066,1383638,72428
2017-07-01,Ohio,9194409,5808288,5518553,289735
2017-07-01,Oklahoma,3000330,1835214,1762128,73086
2017-07-01,Oregon,3336293,2091404,2006490,84914
2017-07-01,Pennsylvania,10249321,6422159,6105265,316894
2017-07-01,Tennessee,5274154,3190171,3079880,110291
2017-07-01,Texas,21270568,13580571,13006707,573864
2017-07-01,Utah,2250729,1549348,1500540,48808
2017-07-01,Vermont,516703,347261,337065,10196
2017-07-01,Virginia,6601547,4345164,4186663,158501
2017-07-01,Washington,5850357,3733560,3561691,171869
2017-07-01,Wisconsin,4590052,3130392,3027959,102433
2017-07-01,Wyoming,448383,295849,283529,12320
2017-08-01,Alabama,3836284,2173420,2080982,92438
2017-08-01,Alaska,547544,360967,337476,23491
2017-08-01,Arizona,5503164,3338499,3177252,161247
2017-08-01,Arkansas,2325716,1354029,1303256,50773
2017-08-01,California,30819479,19207201,18295260,911941
2017-08-01,Colorado,4407473,3000310,2919729,80581
2017-08-01,Connecticut,2879206,1900892,1817915,82977
2017-08-01,Delaware,763394,477559,456485,21074
2017-08-01,Florida,16972737,10047193,9630155,417038
2017-08-01,Georgia,8008915,5123228,4885270,237958
2017-08-01,Hawaii,1094423,678281,664462,13819
2017-08-01,Idaho,1309260,837672,811937,25735
2017-08-01,Illinois,10039057,6487193,6165765,321428
2017-08-01,Indiana,5180760,3332632,3216545,116087
2017-08-01,Iowa,2453951,1687256,1635852,51404
2017-08-01,Kansas,2217666,1485446,1431965,53481
2017-08-01,Kentucky,3478094,2052817,1956097,96720
2017-08-01,Louisiana,3585268,2109984,2006905,103079
2017-08-01,Maine,1100450,700393,676405,23988
2017-08-01,Maryland,4738850,3212288,3081991,130297
2017-08-01,Massachusetts,5589635,3690538,3549475,141063
2017-08-01,Michigan,7957470,4897535,4671469,226066
2017-08-01,Minnesota,4361737,3056876,2954054,102822
2017-08-01,Mississippi,2290790,1273694,1208366,65328
2017-08-01,Missouri,4779763,3059314,2947410,111904
2017-08-01,Montana,835644,526441,504835,21606
2017-08-01,Nebraska,1463343,1018474,988890,29584
2017-08-01,Nevada,2332350,1460204,1388027,72177
2017-08-01,Ohio,9197134,5810790,5522691,288099
2017-08-01,Oklahoma,3001447,1837411,1764665,72746
2017-08-01,Oregon,3339709,2092306,2006395,85911
2017-08-01,Pennsylvania,10251862,6417593,6100495,317098
2017-08-01,Tennessee,5279315,3196140,3086679,109461
2017-08-01,Texas,21298416,13593327,13027129,566198
2017-08-01,Utah,2254998,1551755,1503031,48724
2017-08-01,Vermont,516820,347209,337067,10142
2017-08-01,Virginia,6605682,4347497,4191060,156437
2017-08-01,Washington,5858523,3739479,3565829,173650
2017-08-01,Wisconsin,4592196,3130281,3027790,102491
2017-08-01,Wyoming,448464,295767,283306,12461
2017-09-01,Alabama,3838035,2174284,2083955,90329
2017-09-01,Alaska,547502,360456,337018,23438
2017-09-01,Arizona,5513490,3343281,3181931,161350
2017-09-01,Arkansas,2326910,1353191,1302198,50993
2017-09-01,California,30836381,19205489,18305583,899906
2017-09-01,Colorado,4414637,3007904,2925084,82820
2017-09-01,Connecticut,2880192,1897481,1815026,82455
2017-09-01,Delaware,764246,478093,457096,20997
2017-09-01,Florida,16996993,10049386,9634812,414574
2017-09-01,Georgia,8017782,5126244,4891272,234972
2017-09-01,Hawaii,1094481,676852,663397,13455
2017-09-01,Idaho,1311939,839874,814038,25836
2017-09-01,Illinois,10038262,6486526,6167822,318704
2017-09-01,Indiana,5184267,3332796,3217165,115631
2017-09-01,Iowa,2454856,1685957,1635376,50581
2017-09-01,Kansas,2218423,1484004,1431031,52973
2017-09-01,Kentucky,3479282,2051538,1957165,94373
2017-09-01,Louisiana,3585673,2110547,2009169,101378
2017-09-01,Maine,1101052,699765,676114,23651
2017-09-01,Maryland,4740827,3212242,3081233,131009
2017-09-01,Massachusetts,5592879,3694046,3553339,140707
2017-09-01,Michigan,7960565,4900650,4670169,230481
2017-09-01,Minnesota,4365287,3056493,2955002,101491
2017-09-01,Mississippi,2290654,1272142,1207988,64154
2017-09-01,Missouri,4781508,3057184,2946127,111057
2017-09-01,Montana,836473,526314,504715,21599
2017-09-01,Nebraska,1464244,1018517,988939,29578
2017-09-01,Nevada,2337073,1463974,1392071,71903
2017-09-01,Ohio,9200536,5807977,5523756,284221
2017-09-01,Oklahoma,3002702,1838590,1766356,72234
2017-09-01,Oregon,3343356,2091858,2005446,86412
2017-09-01,Pennsylvania,10255068,6413273,6095963,317310
2017-09-01,Tennessee,5284708,3200884,3091335,109549
2017-09-01,Texas,21327298,13607109,13046231,560878
2017-09-01,Utah,2259385,1553597,1505038,48559
2017-09-01,Vermont,516929,347119,336971,10148
2017-09-01,Virginia,6609542,4347495,4193599,153896
2017-09-01,Washington,5866671,3743944,3569329,174615
2017-09-01,Wisconsin,4594649,3128052,3026722,101330
2017-09-01,Wyoming,448572,295569,282993,12576
2017-10-01,Alabama,3839599,2175287,2086645,88642
2017-10-01,Alaska,547573,359848,336528,23320
2017-10-01,Arizona,5523611,3348460,3186515,161945
2017-10-01,Arkansas,2327969,1351778,1300709,51069
2017-10-01,California,30852515,19197839,18311750,886089
2017-10-01,Colorado,4421760,3014208,2929814,84394
2017-10-01,Connecticut,2881056,1894614,1812716,81898
2017-10-01,Delaware,765073,478334,457505,20829
2017-10-01,Florida,17020550,10055130,9643784,411346
2017-10-01,Georgia,8026805,5126458,4894551,231907
2017-10-01,Hawaii,1094821,675743,662435,13308
2017-10-01,Idaho,1314549,841736,815904,25832
2017-10-01,Illinois,10037181,6484232,6169848,314384
2017-10-01,Indiana,5187398,3332592,3218745,113847
2017-10-01,Iowa,2455642,1684906,1635230,49676
2017-10-01,Kansas,2219134,1482030,1429661,52369
2017-10-01,Kentucky,3480379,2049805,1957957,91848
2017-10-01,Louisiana,3585905,2110276,2010339,99937
2017-10-01,Maine,1101594,698877,675770,23107
2017-10-01,Maryland,4742681,3210692,3079083,131609
2017-10-01,Massachusetts,5595748,3697825,3557753,140072
2017-10-01,Michigan,7963143,4900628,4668899,231729
2017-10-01,Minnesota,4368498,3055419,2955517,99902
2017-10-01,Mississippi,2290413,1270674,1207493,63181
2017-10-01,Missouri,4783136,3054135,2944066,110069
2017-10-01,Montana,837239,526175,504652,21523
2017-10-01,Nebraska,1465130,1018455,988846,29609
2017-10-01,Nevada,2341692,1467530,1395936,71594
2017-10-01,Ohio,9203275,5800315,5522183,278132
2017-10-01,Oklahoma,3003945,1839031,1767593,71438
2017-10-01,Oregon,3346759,2090739,2004265,86474
2017-10-01,Pennsylvania,10257611,6409099,6092440,316659
2017-10-01,Tennessee,5289889,3204138,3094084,110054
2017-10-01,Texas,21355857,13623107,13065751,557356
2017-10-01,Utah,2263655,1555070,1506746,48324
2017-10-01,Vermont,517040,347009,336825,10184
2017-10-01,Virginia,6613781,4345973,4195160,150813
2017-10-01,Washington,5874858,3748170,3573613,174557
2017-10-01,Wisconsin,4596797,3124552,3025510,99042
2017-10-01,Wyoming,448675,295266,282642,12624
2017-11-01,Alabama,3840846,2176815,2089251,87564
2017-11-01,Alaska,547493,359183,336030,23153
2017-11-01,Arizona,5533249,3354747,3191841,162906
2017-11-01,Arkansas,2328862,1350238,1299105,51133
2017-11-01,California,30866794,19188228,18315925,872303
2017-11-01,Colorado,4428527,3019710,2934083,85627
2017-11-01,Connecticut,2881667,1892550,1811201,81349
2017-11-01,Delaware,765819,478380,457801,20579
2017-11-01,Florida,17042366,10065132,9657617,407515
2017-11-01,Georgia,8035420,5124644,4895693,228951
2017-11-01,Hawaii,1094907,675091,661704,13387
2017-11-01,Idaho,1317091,843277,817568,25709
2017-11-01,Illinois,10035540,6480972,6172168,308804
2017-11-01,Indiana,5190316,3333287,3221704,111583
2017-11-01,Iowa,2456255,1684439,1635605,48834
2017-11-01,Kansas,2219649,1480090,1428313,51777
2017-11-01,Kentucky,3481197,2048118,1958520,89598
2017-11-01,Louisiana,3585883,2109668,2010670,98998
2017-11-01,Maine,1102055,697884,675446,22438
2017-11-01,Maryland,4744069,3208246,3076318,131928
2017-11-01,Massachusetts,5598288,3702569,3563231,139338
2017-11-01,Michigan,7965234,4899063,4668803,230260
2017-11-01,Minnesota,4371458,3053958,2955548,98410
2017-11-01,Mississippi,2289988,1269533,1206957,62576
2017-11-01,Missouri,4784494,3050948,2942075,108873
2017-11-01,Montana,837939,526100,504706,21394
2017-11-01,Nebraska,1465866,1018576,988849,29727
2017-11-01,Nevada,2346147,1471033,1399784,71249
2017-11-01,Ohio,9205445,5789953,5518469,271484
2017-11-01,Oklahoma,3005018,1839077,1768585,70492
2017-11-01,Oregon,3349993,2089217,2003003,86214
2017-11-01,Pennsylvania,10259423,6404762,6090015,314747
2017-11-01,Tennessee,5294714,3206656,3095949,110707
2017-11-01,Texas,21383059,13642082,13086199,555883
2017-11-01,Utah,2267884,1556391,1508305,48086
2017-11-01,Vermont,517098,346902,336660,10242
2017-11-01,Virginia,6617090,4344061,4196626,147435
2017-11-01,Washington,5882465,3753036,3579389,173647
2017-11-01,Wisconsin,4598712,3120718,3024296,96422
2017-11-01,Wyoming,448765,294918,282312,12606
2017-12-01,Alabama,3842023,2179230,2092237,86993
2017-12-01,Alaska,547432,358526,335617,22909
2017-12-01,Arizona,5542691,3362580,3199046,163534
2017-12-01,Arkansas,2329671,1349031,1297910,51121
2017-12-01,California,30879995,19182534,18323965,858569
2017-12-01,Colorado,4435085,3025458,2938973,86485
2017-12-01,Connecticut,2882187,1891578,1810954,80624
2017-12-01,Delaware,766575,478425,458213,20212
2017-12-01,Florida,17063554,10078698,9676332,402366
2017-12-01,Georgia,8043726,5122032,4896327,225705
2017-12-01,Hawaii,1094964,675014,661427,13587
2017-12-01,Idaho,1319571,844659,819217,25442
2017-12-01,Illinois,10033620,6477489,6175723,301766
2017-12-01,Indiana,5193094,3336523,3226789,109734
2017-12-01,Iowa,2456773,1684895,1636887,48008
2017-12-01,Kansas,2220045,1478871,1427761,51110
2017-12-01,Kentucky,3481919,2047042,1959220,87822
2017-12-01,Louisiana,3585740,2109360,2010854,98506
2017-12-01,Maine,1102473,697064,675379,21685
2017-12-01,Maryland,4745331,3205929,3074412,131517
2017-12-01,Massachusetts,5600704,3709437,3571124,138313
2017-12-01,Michigan,7967152,4898103,4671444,226659
2017-12-01,Minnesota,4374313,3052877,2955820,97057
2017-12-01,Mississippi,2289575,1268984,1206654,62330
2017-12-01,Missouri,4785721,3048580,2941381,107199
2017-12-01,Montana,838625,526159,504981,21178
2017-12-01,Nebraska,1466539,1019080,989285,29795
2017-12-01,Nevada,2350496,1474724,1404048,70676
2017-12-01,Ohio,9207338,5779940,5514338,265602
2017-12-01,Oklahoma,3005976,1839259,1769890,69369
2017-12-01,Oregon,3353105,2087613,2001932,85681
2017-12-01,Pennsylvania,10260876,6400997,6090204,310793
2017-12-01,Tennessee,5299362,3209518,3098335,111183
2017-12-01,Texas,21409531,13665077,13109868,555209
2017-12-01,Utah,2272008,1557913,1510140,47773
2017-12-01,Vermont,517141,346882,336590,10292
2017-12-01,Virginia,6620166,4343279,4199520,143759
2017-12-01,Washington,5889827,3759169,3587252,171917
2017-12-01,Wisconsin,4600474,3117484,3023479,94005
2017-12-01,Wyoming,448829,294626,282110,12516
2018-01-01,Alabama,3842844,2182961,2096016,86945
2018-01-01,Alaska,547313,357976,335376,22600
2018-01-01,Arizona,5551621,3371802,3208269,163533
2018-01-01,Arkansas,2330250,1348493,1297465,51028
2018-01-01,California,30890810,19186939,18340530,846409
2018-01-01,Colorado,4441224,3032602,2945476,87126
2018-01-01,Connecticut,2882546,1891941,1812205,79736
2018-01-01,Delaware,767213,478737,458994,19743
2018-01-01,Florida,17083177,10094868,9698758,396110
2018-01-01,Georgia,8051351,5120617,4898384,222233
2018-01-01,Hawaii,1094930,675532,661678,13854
2018-01-01,Idaho,1321923,846096,821038,25058
2018-01-01,Illinois,10030718,6474645,6180172,294473
2018-01-01,Indiana,5195245,3343628,3234462,109166
2018-01-01,Iowa,2457002,1686760,1639603,47157
2018-01-01,Kansas,2220190,1478888,1428440,50448
2018-01-01,Kentucky,3482222,2047270,1960528,86742
2018-01-01,Louisiana,3585241,2110256,2011412,98844
2018-01-01,Maine,1102745,696715,675727,20988
2018-01-01,Maryland,4746158,3204969,3074606,130363
2018-01-01,Massachusetts,5602485,3719210,3582134,137076
2018-01-01,Michigan,7968173,4899799,4677844,221955
2018-01-01,Minnesota,4376667,3052881,2957004,95877
2018-01-01,Mississippi,2288841,1269247,1206837,62410
2018-01-01,Missouri,4786436,3047945,2942676,105269
2018-01-01,Montana,839190,526475,505573,20902
2018-01-01,Nebraska,1467060,1020119,990360,29759
2018-01-01,Nevada,2354665,1478950,1409064,69886
2018-01-01,Ohio,9208200,5773937,5512010,261927
2018-01-01,Oklahoma,3006598,1840123,1772069,68054
2018-01-01,Oregon,3355813,2086480,2001475,85005
2018-01-01,Pennsylvania,10261172,6399720,6094610,305110
2018-01-01,Tennessee,5303405,3214031,3102578,111453
2018-01-01,Texas,21434170,13693123,13138321,554802
2018-01-01,Utah,2275847,1559995,1512589,47406
2018-01-01,Vermont,517147,347008,336691,10317
2018-01-01,Virginia,6622634,4345082,4204892,140190
2018-01-01,Washington,5896573,3766857,3597102,169755
2018-01-01,Wisconsin,4601689,3115813,3023388,92425
2018-01-01,Wyoming,448752,294468,282098,12370
2018-02-01,Alabama,3843324,2188262,2100950,87312
2018-02-01,Alaska,547162,357584,335332,22252
2018-02-01,Arizona,5560108,3382193,3219201,162992
2018-02-01,Arkansas,2330637,1348774,1297946,50828
2018-02-01,California,30899826,19204510,18367883,836627
2018-02-01,Colorado,4447177,3041757,2953788,87969
2018-02-01,Connecticut,2882640,1893797,1815043,78754
2018-02-01,Delaware,767793,479452,460238,19214
2018-02-01,Florida,17100836,10112442,9722964,389478
2018-02-01,Georgia,8058536,5121972,4903215,218757
2018-02-01,Hawaii,1094855,676487,662313,14174
2018-02-01,Idaho,1324143,847823,823192,24631
2018-02-01,Illinois,10027117,6473960,6185619,288341
2018-02-01,Indiana,5197039,3354808,3244681,110127
2018-02-01,Iowa,2457017,1690160,1643877,46283
2018-02-01,Kansas,2220217,1480139,1430270,49869
2018-02-01,Kentucky,3482315,2049235,1962904,86331
2018-02-01,Louisiana,3584500,2112853,2012697,100156
2018-02-01,Maine,1102935,697051,676495,20556
2018-02-01,Maryland,4746675,3206152,3077411,128741
2018-02-01,Massachusetts,5604017,3731705,3595898,135807
2018-02-01,Michigan,7968592,4905018,4687974,217044
2018-02-01,Minnesota,4378743,3054190,2959364,94826
2018-02-01,Mississippi,2287915,1270291,1207670,62621
2018-02-01,Missouri,4786746,3049442,2945977,103465
2018-02-01,Montana,839690,527129,506506,20623
2018-02-01,Nebraska,1467492,1021728,992075,29653
2018-02-01,Nevada,2358680,1483928,1414984,68944
2018-02-01,Ohio,9208371,5773989,5513002,260987
2018-02-01,Oklahoma,3007027,1841719,1775155,66564
2018-02-01,Oregon,3358353,2086099,2001846,84253
2018-02-01,Pennsylvania,10260662,6402748,6103969,298779
2018-02-01,Tennessee,5307103,3221015,3109516,111499
2018-02-01,Texas,21457851,13726198,13171861,554337
2018-02-01,Utah,2279686,1562818,1515805,47013
2018-02-01,Vermont,517110,347283,336985,10298
2018-02-01,Virginia,6624733,4350085,4213072,137013
2018-02-01,Washington,5903000,3775904,3608234,167670
2018-02-01,Wisconsin,4602577,3116020,3023966,92054
2018-02-01,Wyoming,448751,294517,282309,12208
2018-03-01,Alabama,3844151,2194413,2106567,87846
2018-03-01,Alaska,547013,357334,335453,21881
2018-03-01,Arizona,5568852,3393031,3230988,162043
2018-03-01,Arkansas,2331244,1349706,1299277,50429
2018-03-01,California,30909161,19230515,18402166,828349
2018-03-01,Colorado,4453360,3052129,2962859,89270
2018-03-01,Connecticut,2882894,1896858,1819188,77670
2018-03-01,Delaware,768427,480397,461728,18669
2018-03-01,Florida,17119346,10129065,9746259,382806
2018-03-01,Georgia,8066189,5125263,4910072,215191
2018-03-01,Hawaii,1094601,677536,663025,14511
2018-03-01,Idaho,1326556,849801,825587,24214
2018-03-01,Illinois,10024274,6475075,6191213,283862
2018-03-01,Indiana,5199477,3368255,3256239,112016
2018-03-01,Iowa,2457371,1694429,1649080,45349
2018-03-01,Kansas,2220385,1482004,1432705,49299
2018-03-01,Kentucky,3482775,2052231,1966007,86224
2018-03-01,Louisiana,3584009,2116436,2014495,101941
2018-03-01,Maine,1103257,697913,677414,20499
2018-03-01,Maryland,4747351,3209128,3082124,127004
2018-03-01,Massachusetts,5605957,3745005,3610502,134503
2018-03-01,Michigan,7969842,4911910,4699988,211922
2018-03-01,Minnesota,4381261,3056279,2962612,93667
2018-03-01,Mississippi,2287263,1271591,1208890,62701
2018-03-01,Missouri,4787572,3051958,2950244,101714
2018-03-01,Montana,840283,528027,507660,20367
2018-03-01,Nebraska,1468056,1023608,994139,29469
2018-03-01,Nevada,2362787,1489418,1421502,67916
2018-03-01,Ohio,9209589,5778905,5516995,261910
2018-03-01,Oklahoma,3007661,1843317,1778506,64811
2018-03-01,Oregon,3361174,2086069,2002748,83321
2018-03-01,Pennsylvania,10261195,6409669,6116996,292673
2018-03-01,Tennessee,5311385,3229830,3118348,111482
2018-03-01,Texas,21481979,13760252,13207711,552541
2018-03-01,Utah,2283762,1566099,1519478,46621
2018-03-01,Vermont,517126,347602,337411,10191
2018-03-01,Virginia,6627094,4357000,4222810,134190
2018-03-01,Washington,5909842,3785391,3619556,165835
2018-03-01,Wisconsin,4603990,3117125,3024438,92687
2018-03-01,Wyoming,448769,294716,282659,12057
2018-04-01,Alabama,3845163,2199908,2111657,88251
2018-04-01,Alaska,546953,357074,335568,21506
2018-04-01,Arizona,5577991,3403018,3242081,160937
2018-04-01,Arkansas,2331994,1350582,1300793,49789
2018-04-01,California,30920923,19253408,18432929,820479
2018-04-01,Colorado,4459903,3061667,2970736,90931
2018-04-01,Connecticut,2883318,1900268,1823822,76446
2018-04-01,Delaware,769129,481109,462946,18163
2018-04-01,Florida,17138968,10142429,9766492,375937
2018-04-01,Georgia,8074439,5126921,4915738,211183
2018-04-01,Hawaii,1094559,678188,663346,14842
2018-04-01,Idaho,1329009,851659,827821,23838
2018-04-01,Illinois,10022064,6475418,6194840,280578
2018-04-01,Indiana,5202122,3380235,3266486,113749
2018-04-01,Iowa,2457850,1698163,1653820,44343
2018-04-01,Kansas,2220716,1483562,1434887,48675
2018-04-01,Kentucky,3483458,2054773,1968609,86164
2018-04-01,Louisiana,3583789,2119160,2015748,103412
2018-04-01,Maine,1103646,698806,677999,20807
2018-04-01,Maryland,4748453,3211975,3086643,125332
2018-04-01,Massachusetts,5608217,3756373,3623302,133071
2018-04-01,Michigan,7971408,4916643,4710297,206346
2018-04-01,Minnesota,4384009,3057591,2965374,92217
2018-04-01,Mississippi,2286692,1272237,1209728,62509
2018-04-01,Missouri,4788659,3053598,2953666,99932
2018-04-01,Montana,840926,528864,508721,20143
2018-04-01,Nebraska,1468702,1025187,996003,29184
2018-04-01,Nevada,2367014,1494703,1427845,66858
2018-04-01,Ohio,9211216,5784668,5521643,263025
2018-04-01,Oklahoma,3008550,1843631,1780922,62709
2018-04-01,Oregon,3364161,2085619,2003488,82131
2018-04-01,Pennsylvania,10262265,6417656,6130260,287396
2018-04-01,Tennessee,5315866,3238203,3126526,111677
2018-04-01,Texas,21507743,13787345,13239109,548236
2018-04-01,Utah,2287936,1569078,1522836,46242
2018-04-01,Vermont,517166,347794,337818,9976
2018-04-01,Virginia,6630075,4362275,4230745,131530
2018-04-01,Washington,5917125,3793493,3629330,164163
2018-04-01,Wisconsin,4605623,3117197,3023573,93624
2018-04-01,Wyoming,448778,294881,282952,11929
2018-05-01,Alabama,3846214,2204018,2115600,88418
2018-05-01,Alaska,546849,356751,335562,21189
2018-05-01,Arizona,5587102,3411942,3251635,160307
2018-05-01,Arkansas,2332706,1350984,1301886,49098
2018-05-01,California,30932127,19266305,18452187,814118
2018-05-01,Colorado,4466430,3069014,2976321,92693
2018-05-01,Connecticut,2883769,1903173,1827941,75232
2018-05-01,Delaware,769793,481368,463601,17767
2018-05-01,Florida,17159029,10152646,9783249,369397
2018-05-01,Georgia,8082472,5124874,4917827,207047
2018-05-01,Hawaii,1094494,678080,662878,15202
2018-05-01,Idaho,1331478,853206,829637,23569
2018-05-01,Illinois,10019843,6474084,6195369,278715
2018-05-01,Indiana,5204828,3388093,3273253,114840
2018-05-01,Iowa,2458351,1700602,1657136,43466
2018-05-01,Kansas,2221142,1484310,1436137,48173
2018-05-01,Kentucky,3484178,2055956,1969707,86249
2018-05-01,Louisiana,3583521,2120097,2015790,104307
2018-05-01,Maine,1104078,699368,677975,21393
2018-05-01,Maryland,4749436,3213273,3089369,123904
2018-05-01,Massachusetts,5610576,3764502,3632876,131626
2018-05-01,Michigan,7973138,4917756,4716518,201238
2018-05-01,Minnesota,4386886,3057515,2966661,90854
2018-05-01,Mississippi,2286106,1271766,1209656,62110
2018-05-01,Missouri,4789836,3053492,2955112,98380
2018-05-01,Montana,841612,529432,509458,19974
2018-05-01,Nebraska,1469394,1026190,997262,28928
2018-05-01,Nevada,2371246,1499417,1433492,65925
2018-05-01,Ohio,9212935,5788378,5524996,263382
2018-05-01,Oklahoma,3009443,1842245,1781734,60511
2018-05-01,Oregon,3367204,2084570,2003509,81061
2018-05-01,Pennsylvania,10263521,6424860,6140956,283904
2018-05-01,Tennessee,5320415,3244648,3132230,112418
2018-05-01,Texas,21533031,13804383,13261553,542830
2018-05-01,Utah,2292135,1571338,1525399,45939
2018-05-01,Vermont,517233,347768,338091,9677
2018-05-01,Virginia,6632998,4363522,4234415,129107
2018-05-01,Washington,5924416,3799729,3636666,163063
2018-05-01,Wisconsin,4607399,3115023,3020609,94414
2018-05-01,Wyoming,448836,294922,283074,11848
2018-06-01,Alabama,3847544,2207073,2118912,88161
2018-06-01,Alaska,546842,356386,335437,20949
2018-06-01,Arizona,5596687,3420589,3260103,160486
2018-06-01,Arkansas,2333693,1351120,1302603,48517
2018-06-01,California,30945958,19270242,18460417,809825
2018-06-01,Colorado,4473320,3074101,2979881,94220
2018-06-01,Connecticut,2884412,1905435,1831333,74102
2018-06-01,Delaware,770534,481274,463790,17484
2018-06-01,Florida,17180446,10160799,9797419,363380
2018-06-01,Georgia,8091122,5120023,4916843,203180
2018-06-01,Hawaii,1094527,677250,661656,15594
2018-06-01,Idaho,1334068,854488,831059,23429
2018-06-01,Illinois,10018412,6471829,6193825,278004
2018-06-01,Indiana,5207986,3391359,3276087,115272
2018-06-01,Iowa,2459105,1701899,1659049,42850
2018-06-01,Kansas,2221740,1484247,1436387,47860
2018-06-01,Kentucky,3485194,2055805,1969481,86324
2018-06-01,Louisiana,3583497,2119425,2014944,104481
2018-06-01,Maine,1104553,699517,677472,22045
2018-06-01,Maryland,4750835,3213197,3090654,122543
2018-06-01,Massachusetts,5613358,3769575,3639452,130123
2018-06-01,Michigan,7975494,4916598,4718713,197885
2018-06-01,Minnesota,4390089,3056725,2966924,89801
2018-06-01,Mississippi,2285729,1270400,1208844,61556
2018-06-01,Missouri,4791444,3051919,2954854,97065
2018-06-01,Montana,842349,529731,509881,19850
2018-06-01,Nebraska,1470220,1026709,997935,28774
2018-06-01,Nevada,2375683,1503645,1438463,65182
2018-06-01,Ohio,9215446,5789189,5526823,262366
2018-06-01,Oklahoma,3010581,1839765,1781269,58496
2018-06-01,Oregon,3370550,2083578,2003041,80537
2018-06-01,Pennsylvania,10265616,6430815,6148676,282139
2018-06-01,Tennessee,5325367,3249692,3136100,113592
2018-06-01,Texas,21560149,13813952,13276750,537202
2018-06-01,Utah,2296468,1573018,1527284,45734
2018-06-01,Vermont,517318,347508,338197,9311
2018-06-01,Virginia,6636443,4361696,4234693,127003
2018-06-01,Washington,5932181,3805332,3642504,162828
2018-06-01,Wisconsin,4609561,3110709,3015956,94753
2018-06-01,Wyoming,448910,294888,283058,11830
2018-07-01,Alabama,3848927,2209486,2122081,87405
2018-07-01,Alaska,546800,355997,335238,20759
2018-07-01,Arizona,5606364,3429631,3268114,161517
2018-07-01,Arkansas,2334646,1351324,1303180,48144
2018-07-01,California,30959830,19268853,18461524,807329
2018-07-01,Colorado,4480233,3077524,2982172,95352
2018-07-01,Connecticut,2885151,1907281,1834216,73065
2018-07-01,Delaware,771294,481027,463754,17273
2018-07-01,Florida,17202053,10168495,9810226,358269
2018-07-01,Georgia,8099961,5114194,4914255,199939
2018-07-01,Hawaii,1094542,675970,659970,16000
2018-07-01,Idaho,1336679,855618,832227,23391
2018-07-01,Illinois,10017132,6469057,6191198,277859
2018-07-01,Indiana,5211178,3390366,3275234,115132
2018-07-01,Iowa,2459864,1702498,1659981,42517
2018-07-01,Kansas,2222318,1483713,1435984,47729
2018-07-01,Kentucky,3486211,2054538,1968263,86275
2018-07-01,Louisiana,3583576,2117389,2013613,103776
2018-07-01,Maine,1105094,699250,676703,22547
2018-07-01,Maryland,4752274,3212560,3091527,121033
2018-07-01,Massachusetts,5616196,3772277,3643761,128516
2018-07-01,Michigan,7977918,4914886,4718428,196458
2018-07-01,Minnesota,4393361,3056034,2966981,89053
2018-07-01,Mississippi,2285366,1268712,1207617,61095
2018-07-01,Missouri,4793072,3049568,2953691,95877
2018-07-01,Montana,843114,529899,510161,19738
2018-07-01,Nebraska,1471009,1027013,998342,28671
2018-07-01,Nevada,2380077,1507577,1442964,64613
2018-07-01,Ohio,9218047,5788201,5527800,260401
2018-07-01,Oklahoma,3011765,1836927,1780107,56820
2018-07-01,Oregon,3373930,2083007,2002204,80803
2018-07-01,Pennsylvania,10267863,6435383,6154147,281236
2018-07-01,Tennessee,5330423,3253735,3139083,114652
2018-07-01,Texas,21587399,13820010,13288411,531599
2018-07-01,Utah,2300883,1574389,1528807,45582
2018-07-01,Vermont,517426,347042,338124,8918
2018-07-01,Virginia,6639962,4358677,4233607,125070
2018-07-01,Washington,5940044,3811529,3648109,163420
2018-07-01,Wisconsin,4611747,3105219,3010677,94542
2018-07-01,Wyoming,448998,294834,282972,11862
2018-08-01,Alabama,3850814,2212016,2125526,86490
2018-08-01,Alaska,546781,355617,334975,20642
2018-08-01,Arizona,5617446,3440243,3276561,163682
2018-08-01,Arkansas,2335827,1352139,1303997,48142
2018-08-01,California,30970329,19270079,18461462,808617
2018-08-01,Colorado,4486530,3080565,2984346,96219
2018-08-01,Connecticut,2885383,1909124,1836818,72306
2018-08-01,Delaware,772185,480933,463791,17142
2018-08-01,Florida,17223189,10178508,9823085,355423
2018-08-01,Georgia,8109883,5110058,4911908,198150
2018-08-01,Hawaii,1094296,674563,658106,16457
2018-08-01,Idaho,1339682,856913,833422,23491
2018-08-01,Illinois,10016480,6467671,6188958,278713
2018-08-01,Indiana,5214498,3387434,3272499,114935
2018-08-01,Iowa,2461141,1703333,1660747,42586
2018-08-01,Kansas,2223002,1483428,1435542,47886
2018-08-01,Kentucky,3487490,2053047,1966805,86242
2018-08-01,Louisiana,3584025,2114941,2012209,102732
2018-08-01,Maine,1105765,698811,675981,22830
2018-08-01,Maryland,4753977,3213051,3093337,119714
2018-08-01,Massachusetts,5618480,3774325,3647139,127186
2018-08-01,Michigan,7979891,4915118,4718222,196896
2018-08-01,Minnesota,4396490,3056843,2967632,89211
2018-08-01,Mississippi,2285791,1267636,1206365,61271
2018-08-01,Missouri,4795418,3047803,2952775,95028
2018-08-01,Montana,843928,530192,510521,19671
2018-08-01,Nebraska,1471841,1027610,998876,28734
2018-08-01,Nevada,2384929,1511751,1447388,64363
2018-08-01,Ohio,9221239,5789478,5530446,259032
2018-08-01,Oklahoma,3013749,1834604,1778785,55819
2018-08-01,Oregon,3377359,2083770,2001773,81997
2018-08-01,Pennsylvania,10269662,6439999,6159078,280921
2018-08-01,Tennessee,5335262,3258019,3142661,115358
2018-08-01,Texas,21619194,13828877,13300862,528015
2018-08-01,Utah,2305312,1575998,1530465,45533
2018-08-01,Vermont,517535,346511,337949,8562
2018-08-01,Virginia,6644538,4357084,4233403,123681
2018-08-01,Washington,5947638,3819548,3654812,164736
2018-08-01,Wisconsin,4614177,3100243,3006087,94156
2018-08-01,Wyoming,449256,294837,282913,11924
2018-09-01,Alabama,3852862,2215093,2129494,85599
2018-09-01,Alaska,546810,355262,334648,20614
2018-09-01,Arizona,5628819,3452490,3285694,166796
2018-09-01,Arkansas,2337119,1353808,1305242,48566
2018-09-01,California,30982488,19278256,18464140,814116
2018-09-01,Colorado,4493046,3084266,2987503,96763
2018-09-01,Connecticut,2885801,1911006,1839115,71891
2018-09-01,Delaware,773154,481160,464075,17085
2018-09-01,Florida,17245228,10191438,9836152,355286
2018-09-01,Georgia,8120220,5108726,4910760,197966
2018-09-01,Hawaii,1094105,673225,656251,16974
2018-09-01,Idaho,1342766,858575,834807,23768
2018-09-01,Illinois,10016318,6468643,6187856,280787
2018-09-01,Indiana,5218075,3384907,3269816,115091
2018-09-01,Iowa,2462548,1704965,1662001,42964
2018-09-01,Kansas,2223814,1483781,1435489,48292
2018-09-01,Kentucky,3488910,2052059,1965835,86224
2018-09-01,Louisiana,3584643,2113166,2011109,102057
2018-09-01,Maine,1106507,698422,675550,22872
2018-09-01,Maryland,4755987,3215658,3096714,118944
2018-09-01,Massachusetts,5621085,3776708,3650408,126300
2018-09-01,Michigan,7982196,4918359,4719671,198688
2018-09-01,Minnesota,4399843,3059533,2968877,90656
2018-09-01,Mississippi,2286353,1267533,1205274,62259
2018-09-01,Missouri,4797969,3047698,2952946,94752
2018-09-01,Montana,844790,530703,511062,19641
2018-09-01,Nebraska,1472783,1028717,999678,29039
2018-09-01,Nevada,2389933,1516485,1452009,64476
2018-09-01,Ohio,9224861,5795216,5535911,259305
2018-09-01,Oklahoma,3015886,1833310,1777570,55740
2018-09-01,Oregon,3380908,2086354,2002439,83915
2018-09-01,Pennsylvania,10271919,6445572,6164598,280974
2018-09-01,Tennessee,5340338,3263749,3148219,115530
2018-09-01,Texas,21652158,13843885,13316200,527685
2018-09-01,Utah,2309837,1578152,1532590,45562
2018-09-01,Vermont,517681,346038,337762,8276
2018-09-01,Virginia,6649427,4358761,4235458,123303
2018-09-01,Washington,5955494,3829378,3662492,166886
2018-09-01,Wisconsin,4616745,3096571,3002676,93895
2018-09-01,Wyoming,449533,294898,282959,11939
2018-10-01,Alabama,3854756,2218770,2134057,84713
2018-10-01,Alaska,546788,354987,334327,20660
2018-10-01,Arizona,5639899,3465247,3294961,170286
2018-10-01,Arkansas,2338313,1356111,1306904,49207
2018-10-01,California,30992869,19293358,18471026,822332
2018-10-01,Colorado,4499357,3088998,2992253,96745
2018-10-01,Connecticut,2886031,1912705,1840959,71746
2018-10-01,Delaware,774073,481767,464695,17072
2018-10-01,Florida,17266363,10205938,9848907,357031
2018-10-01,Georgia,8130168,5109997,4911177,198820
2018-10-01,Hawaii,1093829,672060,654568,17492
2018-10-01,Idaho,1345769,860610,836399,24211
2018-10-01,Illinois,10015684,6471017,6187236,283781
2018-10-01,Indiana,5221428,3384050,3268290,115760
2018-10-01,Iowa,2463857,1707672,1664072,43600
2018-10-01,Kansas,2224508,1484784,1435982,48802
2018-10-01,Kentucky,3490193,2051989,1965753,86236
2018-10-01,Louisiana,3585062,2112204,2010424,101780
2018-10-01,Maine,1107211,698151,675484,22667
2018-10-01,Maryland,4757696,3220485,3101703,118782
2018-10-01,Massachusetts,5623415,3779466,3653764,125702
2018-10-01,Michigan,7984164,4924179,4722933,201246
2018-10-01,Minnesota,4402999,3063412,2970270,93142
2018-10-01,Mississippi,2286775,1268334,1204462,63872
2018-10-01,Missouri,4800342,3049782,2954580,95202
2018-10-01,Montana,845583,531356,511722,19634
2018-10-01,Nebraska,1473613,1030316,1000760,29556
2018-10-01,Nevada,2394798,1521728,1456914,64814
2018-10-01,Ohio,9228042,5804046,5543346,260700
2018-10-01,Oklahoma,3017853,1833190,1776737,56453
2018-10-01,Oregon,3384353,2090454,2004408,86046
2018-10-01,Pennsylvania,10273714,6452492,6171169,281323
2018-10-01,Tennessee,5345197,3271345,3156200,115145
2018-10-01,Texas,21683967,13864768,13335259,529509
2018-10-01,Utah,2314283,1580850,1535286,45564
2018-10-01,Vermont,517774,345660,337597,8063
2018-10-01,Virginia,6654002,4364231,4240248,123983
2018-10-01,Washington,5963059,3840188,3670355,169833
2018-10-01,Wisconsin,4619204,3094379,3000471,93908
2018-10-01,Wyoming,449778,294995,283131,11864
2018-11-01,Alabama,3856154,2222802,2139030,83772
2018-11-01,Alaska,546733,354791,334087,20704
2018-11-01,Arizona,5650376,3477513,3304082,173431
2018-11-01,Arkansas,2339226,1358656,1308923,49733
2018-11-01,California,31000966,19311991,18481262,830729
2018-11-01,Colorado,4505271,3094552,2998449,96103
2018-11-01,Connecticut,2885954,1914128,1842422,71706
2018-11-01,Delaware,774895,482709,465633,17076
2018-11-01,Florida,17285441,10220222,9861136,359086
2018-11-01,Georgia,8139345,5113084,4913287,199797
2018-11-01,Hawaii,1093583,671088,653151,17937
2018-11-01,Idaho,1348642,862994,838269,24725
2018-11-01,Illinois,10013950,6474852,6187073,287779
2018-11-01,Indiana,5224176,3385579,3268810,116769
2018-11-01,Iowa,2464858,1711649,1667225,44424
2018-11-01,Kansas,2224934,1486153,1436908,49245
2018-11-01,Kentucky,3491101,2052885,1966565,86320
2018-11-01,Louisiana,3585137,2111546,2010065,101481
2018-11-01,Maine,1107768,697896,675669,22227
2018-11-01,Maryland,4758978,3227063,3107999,119064
2018-11-01,Massachusetts,5625242,3782165,3657030,125135
2018-11-01,Michigan,7985290,4931644,4727384,204260
2018-11-01,Minnesota,4405705,3067728,2971706,96022
2018-11-01,Mississippi,2286954,1269864,1203942,65922
2018-11-01,Missouri,4802145,3053543,2957393,96150
2018-11-01,Montana,846300,532085,512437,19648
2018-11-01,Nebraska,1474305,1032250,1002062,30188
2018-11-01,Nevada,2399462,1527304,1462170,65134
2018-11-01,Ohio,9230154,5813355,5552197,261158
2018-11-01,Oklahoma,3019516,1834179,1776669,57510
2018-11-01,Oregon,3387402,2095533,2007705,87828
2018-11-01,Pennsylvania,10274249,6460337,6178551,281786
2018-11-01,Tennessee,5349521,3280821,3166444,114377
2018-11-01,Texas,21713757,13888671,13357878,530793
2018-11-01,Utah,2318480,1584026,1538597,45429
2018-11-01,Vermont,517846,345389,337476,7913
2018-11-01,Virginia,6657983,4372860,4247614,125246
2018-11-01,Washington,5970124,3851215,3678279,172936
2018-11-01,Wisconsin,4621113,3093703,2999369,94334
2018-11-01,Wyoming,449941,295102,283416,11686
2018-12-01,Alabama,3857442,2226751,2144197,82554
2018-12-01,Alaska,546663,354566,333931,20635
2018-12-01,Arizona,5660505,3488395,3312873,175522
2018-12-01,Arkansas,2340021,1360949,1311102,49847
2018-12-01,California,31007415,19327664,18492465,835199
2018-12-01,Colorado,4510886,3099887,3005135,94752
2018-12-01,Connecticut,2885775,1915020,1843489,71531
2018-12-01,Delaware,775662,483777,466721,17056
2018-12-01,Florida,17303538,10232330,9872842,359488
2018-12-01,Georgia,8148150,5116798,4916885,199913
2018-12-01,Hawaii,1093269,670180,651974,18206
2018-12-01,Idaho,1351412,865525,840393,25132
2018-12-01,Illinois,10011743,6479035,6187431,291604
2018-12-01,Indiana,5226671,3388040,3270676,117364
2018-12-01,Iowa,2465707,1716455,1671199,45256
2018-12-01,Kansas,2225238,1487403,1437993,49410
2018-12-01,Kentucky,3491863,2054479,1968189,86290
2018-12-01,Louisiana,3585010,2110632,2009979,100653
2018-12-01,Maine,1108245,697440,675886,21554
2018-12-01,Maryland,4760033,3234226,3114968,119258
2018-12-01,Massachusetts,5626729,3784000,3659729,124271
2018-12-01,Michigan,7986018,4938752,4731861,206891
2018-12-01,Minnesota,4408141,3071438,2973113,98325
2018-12-01,Mississippi,2287035,1271512,1203781,67731
2018-12-01,Missouri,4803671,3057685,2960620,97065
2018-12-01,Montana,846955,532808,513165,19643
2018-12-01,Nebraska,1474901,1034171,1003405,30766
2018-12-01,Nevada,2403986,1532865,1467684,65181
2018-12-01,Ohio,9231796,5820069,5561420,258649
2018-12-01,Oklahoma,3020959,1835859,1777527,58332
2018-12-01,Oregon,3390287,2100526,2011924,88602
2018-12-01,Pennsylvania,10274249,6467194,6185428,281766
2018-12-01,Tennessee,5353537,3291684,3178225,113459
2018-12-01,Texas,21742357,13910127,13382106,528021
2018-12-01,Utah,2322551,1587436,1542359,45077
2018-12-01,Vermont,517887,345196,337387,7809
2018-12-01,Virginia,6661589,4383123,4256692,126431
2018-12-01,Washington,5976850,3861335,3686272,175063
2018-12-01,Wisconsin,4622766,3093618,2998620,94998
2018-12-01,Wyoming,450154,295151,283759,11392
2019-01-01,Alabama,3858512,2229899,2149188,80711
2019-01-01,Alaska,546579,354226,333822,20404
2019-01-01,Arizona,5670393,3497563,3321318,176245
2019-01-01,Arkansas,2340710,1362495,1313091,49404
2019-01-01,California,31012788,19334306,18501317,832989
2019-01-01,Colorado,4516317,3104049,3011353,92696
2019-01-01,Connecticut,2885407,1915116,1844065,71051
2019-01-01,Delaware,776420,484604,467642,16962
2019-01-01,Florida,17320950,10240878,9884007,356871
2019-01-01,Georgia,8156579,5119814,4921294,198520
2019-01-01,Hawaii,1092891,669216,650983,18233
2019-01-01,Idaho,1354143,867880,842597,25283
2019-01-01,Illinois,10009039,6481193,6188462,292731
2019-01-01,Indiana,5228912,3389065,3272106,116959
2019-01-01,Iowa,2466434,1720862,1674943,45919
2019-01-01,Kansas,2225406,1488175,1439031,49144
2019-01-01,Kentucky,3492386,2056192,1970166,86026
2019-01-01,Louisiana,3584760,2109231,2010280,98951
2019-01-01,Maine,1108679,696627,675932,20695
2019-01-01,Maryland,4760866,3240729,3121909,118820
2019-01-01,Massachusetts,5627960,3784356,3661520,122836
2019-01-01,Michigan,7986297,4943420,4735037,208383
2019-01-01,Minnesota,4410297,3073895,2974372,99523
2019-01-01,Mississippi,2287007,1272778,1203954,68824
2019-01-01,Missouri,4804992,3061111,2963576,97535
2019-01-01,Montana,847596,533342,513765,19577
2019-01-01,Nebraska,1475406,1035771,1004580,31191
2019-01-01,Nevada,2408437,1538037,1473244,64793
2019-01-01,Ohio,9232906,5821680,5569078,252602
2019-01-01,Oklahoma,3022283,1837515,1778982,58533
2019-01-01,Oregon,3392962,2104052,2016017,88035
2019-01-01,Pennsylvania,10273786,6471515,6190529,280986
2019-01-01,Tennessee,5357263,3302421,3189960,112461
2019-01-01,Texas,21770174,13925005,13405426,519579
2019-01-01,Utah,2326530,1590728,1546260,44468
2019-01-01,Vermont,517878,345044,337315,7729
2019-01-01,Virginia,6664897,4392956,4266093,126863
2019-01-01,Washington,5983264,3869370,3694099,175271
2019-01-01,Wisconsin,4624157,3093213,2997422,95791
2019-01-01,Wyoming,450258,295087,284091,10996
2019-02-01,Alabama,3859089,2231539,2153542,77997
2019-02-01,Alaska,546404,353848,333818,20030
2019-02-01,Arizona,5679559,3505030,3329490,175540
2019-02-01,Arkansas,2341109,1363048,1314551,48497
2019-02-01,California,31014817,19329357,18505844,823513
2019-02-01,Colorado,4521344,3106730,3016857,89873
2019-02-01,Connecticut,2884720,1914273,1844132,70141
2019-02-01,Delaware,777040,485013,468253,16760
2019-02-01,Florida,17335625,10246115,9895249,350866
2019-02-01,Georgia,8164162,5121124,4925912,195212
2019-02-01,Hawaii,1092373,668172,650161,18011
2019-02-01,Idaho,1356695,869873,844753,25120
2019-02-01,Illinois,10005294,6479413,6189942,289471
2019-02-01,Indiana,5230605,3387179,3271793,115386
2019-02-01,Iowa,2466914,1724077,1677806,46271
2019-02-01,Kansas,2225385,1488377,1439945,48432
2019-02-01,Kentucky,3492597,2057471,1971899,85572
2019-02-01,Louisiana,3584066,2107156,2010838,96318
2019-02-01,Maine,1108981,695458,675738,19720
2019-02-01,Maryland,4761146,3245796,3128338,117458
2019-02-01,Massachusetts,5628669,3783198,3662566,120632
2019-02-01,Michigan,7985730,4945098,4736749,208349
2019-02-01,Minnesota,4412091,3075308,2975818,99490
2019-02-01,Mississippi,2286684,1273521,1204365,69156
2019-02-01,Missouri,4805762,3063239,2965866,97373
2019-02-01,Montana,848103,533591,514177,19414
2019-02-01,Nebraska,1475799,1036833,1005468,31365
2019-02-01,Nevada,2412610,1542686,1478727,63959
2019-02-01,Ohio,9233071,5818965,5574672,244293
2019-02-01,Oklahoma,3023300,1838736,1780731,58005
2019-02-01,Oregon,3395298,2105435,2019199,86236
2019-02-01,Pennsylvania,10272066,6472348,6193118,279230
2019-02-01,Tennessee,5360432,3311358,3200006,111352
2019-02-01,Texas,21795969,13933148,13426644,506504
2019-02-01,Utah,2330395,1593690,1550084,43606
2019-02-01,Vermont,517850,344853,337215,7638
2019-02-01,Virginia,6667480,4400891,4274830,126061
2019-02-01,Washington,5989125,3875239,3702019,173220
2019-02-01,Wisconsin,4625075,3092376,2995774,96602
2019-02-01,Wyoming,450382,294948,284366,10582
2019-03-01,Alabama,3860039,2231949,2157197,74752
2019-03-01,Alaska,546284,353549,333909,19640
2019-03-01,Arizona,5689006,3511703,3337412,174291
2019-03-01,Arkansas,2341740,1362776,1315205,47571
2019-03-01,California,31017497,19317936,18507077,810859
2019-03-01,Colorado,4526747,3108718,3022045,86673
2019-03-01,Connecticut,2884267,1913006,1843951,69055
2019-03-01,Delaware,777740,485202,468646,16556
2019-03-01,Florida,17351326,10251856,9908175,343681
2019-03-01,Georgia,8172347,5121857,4930893,190964
2019-03-01,Hawaii,1091842,667192,649533,17659
2019-03-01,Idaho,1359388,871655,846865,24790
2019-03-01,Illinois,10002260,6474417,6192065,282352
2019-03-01,Indiana,5232865,3382749,3269690,113059
2019-03-01,Iowa,2467642,1726422,1679946,46476
2019-03-01,Kansas,2225581,1488364,1440776,47588
2019-03-01,Kentucky,3493161,2058799,1973474,85325
2019-03-01,Louisiana,3583666,2105146,2011546,93600
2019-03-01,Maine,1109377,694264,675443,18821
2019-03-01,Maryland,4761718,3249927,3134185,115742
2019-03-01,Massachusetts,5629802,3781651,3663545,118106
2019-03-01,Michigan,7985849,4945693,4737913,207780
2019-03-01,Minnesota,4414293,3076838,2978103,98735
2019-03-01,Mississippi,2286551,1274119,1204988,69131
2019-03-01,Missouri,4807015,3064481,2967585,96896
2019-03-01,Montana,848735,533751,514527,19224
2019-03-01,Nebraska,1476308,1037455,1006093,31362
2019-03-01,Nevada,2416855,1547115,1484140,62975
2019-03-01,Ohio,9234157,5816150,5579091,237059
2019-03-01,Oklahoma,3024561,1839713,1782614,57099
2019-03-01,Oregon,3397908,2105348,2021425,83923
2019-03-01,Pennsylvania,10271309,6471650,6193849,277801
2019-03-01,Tennessee,5364123,3318354,3207976,110378
2019-03-01,Texas,21822493,13939862,13446764,493098
2019-03-01,Utah,2334391,1596458,1553781,42677
2019-03-01,Vermont,517867,344585,337039,7546
2019-03-01,Virginia,6670614,4406888,4282641,124247
2019-03-01,Washington,5995444,3880632,3710734,169898
2019-03-01,Wisconsin,4626472,3091788,2994026,97762
2019-03-01,Wyoming,450554,294879,284585,10294
2019-04-01,Alabama,3861170,2231885,2160522,71363
2019-04-01,Alaska,546243,353455,334118,19337
2019-04-01,Arizona,5698836,3518531,3345552,172979
2019-04-01,Arkansas,2342453,1362147,1315218,46929
2019-04-01,California,31022564,19307869,18509723,798146
2019-04-01,Colorado,4532350,3111401,3027728,83673
2019-04-01,Connecticut,2883945,1912141,1844115,68026
2019-04-01,Delaware,778516,485472,469010,16462
2019-04-01,Florida,17368100,10262411,9924815,337596
2019-04-01,Georgia,8180996,5124177,4937384,186793
2019-04-01,Hawaii,1091436,666492,649218,17274
2019-04-01,Idaho,1362162,873540,849086,24454
2019-04-01,Illinois,9999793,6468028,6195174,272854
2019-04-01,Indiana,5235328,3377518,3267048,110470
2019-04-01,Iowa,2468454,1728498,1681846,46652
2019-04-01,Kansas,2225860,1488596,1441764,46832
2019-04-01,Kentucky,3493890,2060715,1975453,85262
2019-04-01,Louisiana,3583469,2104457,2012866,91591
2019-04-01,Maine,1109866,693551,675339,18212
2019-04-01,Maryland,4762584,3254220,3139974,114246
2019-04-01,Massachusetts,5631202,3780674,3664967,115707
2019-04-01,Michigan,7986340,4947165,4739875,207290
2019-04-01,Minnesota,4416696,3079545,2981872,97673
2019-04-01,Mississippi,2286578,1275117,1205974,69143
2019-04-01,Missouri,4808486,3065787,2969425,96362
2019-04-01,Montana,849362,534099,515027,19072
2019-04-01,Nebraska,1476899,1037923,1006710,31213
2019-04-01,Nevada,2421273,1551757,1489729,62028
2019-04-01,Ohio,9235661,5816663,5583268,233395
2019-04-01,Oklahoma,3025979,1840830,1784644,56186
2019-04-01,Oregon,3400710,2104724,2023005,81719
2019-04-01,Pennsylvania,10271002,6472106,6194704,277402
2019-04-01,Tennessee,5368049,3324074,3214505,109569
2019-04-01,Texas,21850614,13951498,13468880,482618
2019-04-01,Utah,2338541,1599362,1557593,41769
2019-04-01,Vermont,517854,344265,336792,7473
2019-04-01,Virginia,6674083,4411682,4289972,121710
2019-04-01,Washington,6002058,3887284,3720954,166330
2019-04-01,Wisconsin,4628057,3091979,2992614,99365
2019-04-01,Wyoming,450675,294998,284810,10188
2019-05-01,Alabama,3862424,2232174,2163952,68222
2019-05-01,Alaska,546150,353548,334381,19167
2019-05-01,Arizona,5708829,3525840,3353848,171992
2019-05-01,Arkansas,2343292,1361669,1314928,46741
2019-05-01,California,31027526,19304550,18515934,788616
2019-05-01,Colorado,4538098,3115281,3033852,81429
2019-05-01,Connecticut,2883745,1912281,1844977,67304
2019-05-01,Delaware,779251,485988,469399,16589
2019-05-01,Florida,17385414,10279930,9945628,334302
2019-05-01,Georgia,8189728,5129326,4945860,183466
2019-05-01,Hawaii,1091012,666331,649390,16941
2019-05-01,Idaho,1364985,875679,851447,24232
2019-05-01,Illinois,9997605,6460957,6197805,263152
2019-05-01,Indiana,5238060,3373177,3264961,108216
2019-05-01,Iowa,2469440,1730668,1683725,46943
2019-05-01,Kansas,2226234,1489343,1443000,46343
2019-05-01,Kentucky,3494766,2063398,1978208,85190
2019-05-01,Louisiana,3583350,2105899,2014912,90987
2019-05-01,Maine,1110412,693551,675536,18015
2019-05-01,Maryland,4763531,3259436,3146040,113396
2019-05-01,Massachusetts,5632822,3780393,3666566,113827
2019-05-01,Michigan,7987208,4949277,4742543,206734
2019-05-01,Minnesota,4419361,3083737,2987022,96715
2019-05-01,Mississippi,2286635,1276925,1207363,69562
2019-05-01,Missouri,4810200,3067922,2971711,96211
2019-05-01,Montana,850047,534802,515782,19020
2019-05-01,Nebraska,1477544,1038432,1007448,30984
2019-05-01,Nevada,2425739,1556867,1495541,61326
2019-05-01,Ohio,9237539,5821487,5587417,234070
2019-05-01,Oklahoma,3027519,1842273,1786601,55672
2019-05-01,Oregon,3403640,2104117,2024197,79920
2019-05-01,Pennsylvania,10271186,6475481,6196790,278691
2019-05-01,Tennessee,5372175,3328478,3219371,109107
2019-05-01,Texas,21878787,13971880,13494116,477764
2019-05-01,Utah,2342806,1602567,1561589,40978
2019-05-01,Vermont,517915,343936,336481,7455
2019-05-01,Virginia,6677682,4416125,4297055,119070
2019-05-01,Washington,6008920,3895753,3732380,163373
2019-05-01,Wisconsin,4629921,3092979,2991772,101207
2019-05-01,Wyoming,450891,295316,285047,10269
2019-06-01,Alabama,3863995,2233402,2167676,65726
2019-06-01,Alaska,546141,353731,334599,19132
2019-06-01,Arizona,5719237,3533838,3362138,171700
2019-06-01,Arkansas,2344321,1361790,1314740,47050
2019-06-01,California,31035051,19311393,18526089,785304
2019-06-01,Colorado,4544250,3120345,3040081,80264
2019-06-01,Connecticut,2883772,1913645,1846526,67119
2019-06-01,Delaware,780094,486815,469813,17002
2019-06-01,Florida,17404169,10304147,9970073,334074
2019-06-01,Georgia,8199141,5137205,4955924,181281
2019-06-01,Hawaii,1090709,666771,650122,16649
2019-06-01,Idaho,1367964,878119,853906,24213
2019-06-01,Illinois,9996220,6453401,6198247,255154
2019-06-01,Indiana,5241157,3371205,3264478,106727
2019-06-01,Iowa,2470620,1733102,1685595,47507
2019-06-01,Kansas,2226826,1490822,1444540,46282
2019-06-01,Kentucky,3495916,2066908,1981633,85275
2019-06-01,Louisiana,3583530,2109754,2017549,92205
2019-06-01,Maine,1111030,694253,676002,18251
2019-06-01,Maryland,4764863,3265661,3152291,113370
2019-06-01,Massachusetts,5634880,3780828,3668102,112726
2019-06-01,Michigan,7988642,4951350,4745349,206001
2019-06-01,Minnesota,4422372,3089207,2992843,96364
2019-06-01,Mississippi,2286865,1279530,1208933,70597
2019-06-01,Missouri,4812270,3071618,2974560,97058
2019-06-01,Montana,850830,535862,516760,19102
2019-06-01,Nebraska,1478351,1039213,1008354,30859
2019-06-01,Nevada,2430418,1562556,1501566,60990
2019-06-01,Ohio,9240152,5830138,5591950,238188
2019-06-01,Oklahoma,3029295,1843994,1788112,55882
2019-06-01,Oregon,3406868,2104097,2025554,78543
2019-06-01,Pennsylvania,10272181,6482360,6200143,282217
2019-06-01,Tennessee,5376724,3331228,3221931,109297
2019-06-01,Texas,21908726,14001987,13521952,480035
2019-06-01,Utah,2347248,1606145,1565787,40358
2019-06-01,Vermont,518005,343701,336152,7549
2019-06-01,Virginia,6681878,4421093,4304002,117091
2019-06-01,Washington,6016231,3905366,3743850,161516
2019-06-01,Wisconsin,4632110,3094520,2991596,102924
2019-06-01,Wyoming,451126,295794,285278,10516
2019-07-01,Alabama,3865605,2235879,2171719,64160
2019-07-01,Alaska,546124,353957,334776,19181
2019-07-01,Arizona,5729725,3542350,3370439,171911
2019-07-01,Arkansas,2345384,1362767,1315064,47703
2019-07-01,California,31042729,19328532,18540122,788410
2019-07-01,Colorado,4550388,3126269,3046294,79975
2019-07-01,Connecticut,2883814,1915887,1848378,67509
2019-07-01,Delaware,780911,487919,470296,17623
2019-07-01,Florida,17423120,10332690,9996851,335839
2019-07-01,Georgia,8208646,5146869,4966970,179899
2019-07-01,Hawaii,1090419,667702,651326,16376
2019-07-01,Idaho,1370929,880762,856393,24369
2019-07-01,Illinois,9994924,6445778,6196074,249704
2019-07-01,Indiana,5244373,3372715,3266416,106299
2019-07-01,Iowa,2471822,1735802,1687468,48334
2019-07-01,Kansas,2227416,1493014,1446400,46614
2019-07-01,Kentucky,3497135,2071101,1985516,85585
2019-07-01,Louisiana,3583771,2115698,2020553,95145
2019-07-01,Maine,1111651,695443,676713,18730
2019-07-01,Maryland,4766235,3272522,3158624,113898
2019-07-01,Massachusetts,5637007,3781940,3669520,112420
2019-07-01,Michigan,7990228,4953147,4748325,204822
2019-07-01,Minnesota,4425397,3095230,2998435,96795
2019-07-01,Mississippi,2287134,1282461,1210441,72020
2019-07-01,Missouri,4814438,3077086,2978080,99006
2019-07-01,Montana,851600,537145,517862,19283
2019-07-01,Nebraska,1479137,1040368,1009438,30930
2019-07-01,Nevada,2435079,1568679,1507794,60885
2019-07-01,Ohio,9242913,5840899,5597492,243407
2019-07-01,Oklahoma,3031109,1845998,1789265,56733
2019-07-01,Oregon,3410117,2105063,2027770,77293
2019-07-01,Pennsylvania,10273325,6492519,6204677,287842
2019-07-01,Tennessee,5381375,3333056,3222787,110269
2019-07-01,Texas,21938858,14039457,13551722,487735
2019-07-01,Utah,2351704,1610100,1570182,39918
2019-07-01,Vermont,518111,343661,335893,7768
2019-07-01,Virginia,6686119,4427256,4311089,116167
2019-07-01,Washington,6023628,3915017,3754579,160438
2019-07-01,Wisconsin,4634420,3096087,2991888,104199
2019-07-01,Wyoming,451343,296350,285492,10858
2019-08-01,Alabama,3867674,2239172,2175837,63335
2019-08-01,Alaska,546150,354167,335004,19163
2019-08-01,Arizona,5742211,3550819,3378991,171828
2019-08-01,Arkansas,2346922,1364569,1316245,48324
2019-08-01,California,31051769,19352881,18558815,794066
2019-08-01,Colorado,4556290,3132792,3052730,80062
2019-08-01,Connecticut,2884364,1918619,1850457,68162
2019-08-01,Delaware,781909,489118,470836,18282
2019-08-01,Florida,17446500,10362186,10024780,337406
2019-08-01,Georgia,8217762,5157087,4978768,178319
2019-08-01,Hawaii,1090268,669054,652992,16062
2019-08-01,Idaho,1374226,883352,858885,24467
2019-08-01,Illinois,9993687,6437758,6192198,245560
2019-08-01,Indiana,5247759,3377418,3270800,106618
2019-08-01,Iowa,2472948,1738561,1689416,49145
2019-08-01,Kansas,2228430,1495521,1448506,47015
2019-08-01,Kentucky,3498575,2075521,1989597,85924
2019-08-01,Louisiana,3584102,2122853,2023921,98932
2019-08-01,Maine,1112377,696744,677613,19131
2019-08-01,Maryland,4767772,3279210,3165105,114105
2019-08-01,Massachusetts,5639040,3783223,3670782,112441
2019-08-01,Michigan,7992084,4954309,4751549,202760
2019-08-01,Minnesota,4428165,3100765,3003367,97398
2019-08-01,Mississippi,2287500,1285009,1211834,73175
2019-08-01,Missouri,4817071,3083765,2982141,101624
2019-08-01,Montana,852602,538480,519016,19464
2019-08-01,Nebraska,1480038,1041747,1010685,31062
2019-08-01,Nevada,2439491,1574877,1514207,60670
2019-08-01,Ohio,9245841,5851393,5604276,247117
2019-08-01,Oklahoma,3033521,1848246,1790611,57635
2019-08-01,Oregon,3413384,2106623,2030826,75797
2019-08-01,Pennsylvania,10275707,6504482,6210321,294161
2019-08-01,Tennessee,5387165,3335043,3223344,111699
2019-08-01,Texas,21973020,14078792,13582783,496009
2019-08-01,Utah,2356169,1614348,1574747,39601
2019-08-01,Vermont,518273,343841,335776,8065
2019-08-01,Virginia,6690638,4434846,4319000,115846
2019-08-01,Washington,6031259,3923782,3764361,159421
2019-08-01,Wisconsin,4636987,3097266,2992435,104831
2019-08-01,Wyoming,451683,296892,285705,11187
2019-09-01,Alabama,3869937,2242568,2179776,62792
2019-09-01,Alaska,546193,354265,335381,18884
2019-09-01,Arizona,5754979,3559219,3388474,170745
2019-09-01,Arkansas,2348558,1367000,1318483,48517
2019-09-01,California,31062463,19381576,18584676,796900
2019-09-01,Colorado,4562413,3139764,3059740,80024
2019-09-01,Connecticut,2885043,1921554,1852927,68627
2019-09-01,Delaware,782978,490313,471510,18803
2019-09-01,Florida,17470770,10391422,10054571,336851
2019-09-01,Georgia,8227288,5167986,4992227,175759
2019-09-01,Hawaii,1090192,670771,655171,15600
2019-09-01,Idaho,1377619,885757,861511,24246
2019-09-01,Illinois,9992956,6429207,6188739,240468
2019-09-01,Indiana,5251359,3384123,3277361,106762
2019-09-01,Iowa,2474160,1741239,1691639,49600
2019-09-01,Kansas,2229568,1498108,1450972,47136
2019-09-01,Kentucky,3500176,2079723,1993779,85944
2019-09-01,Louisiana,3584700,2130301,2028230,102071
2019-09-01,Maine,1113156,697848,678669,19179
2019-09-01,Maryland,4769535,3285417,3172340,113077
2019-09-01,Massachusetts,5641308,3784702,3672571,112131
2019-09-01,Michigan,7994298,4954741,4755863,198878
2019-09-01,Minnesota,4431178,3105451,3008299,97152
2019-09-01,Mississippi,2287965,1286610,1213257,73353
2019-09-01,Missouri,4819891,3090723,2986755,103968
2019-09-01,Montana,853702,539844,520319,19525
2019-09-01,Nebraska,1481039,1043236,1012221,31015
2019-09-01,Nevada,2443975,1581000,1520987,60013
2019-09-01,Ohio,9249209,5860933,5613289,247644
2019-09-01,Oklahoma,3036112,1850817,1792888,57929
2019-09-01,Oregon,3416813,2108206,2034404,73802
2019-09-01,Pennsylvania,10278544,6516504,6217673,298831
2019-09-01,Tennessee,5393158,3338025,3225049,112976
2019-09-01,Texas,22008347,14115779,13616230,499549
2019-09-01,Utah,2360793,1618931,1579660,39271
2019-09-01,Vermont,518428,344211,335862,8349
2019-09-01,Virginia,6695531,4443686,4328656,115030
2019-09-01,Washington,6039196,3931891,3774351,157540
2019-09-01,Wisconsin,4639751,3098154,2993572,104582
2019-09-01,Wyoming,452040,297378,285966,11412
2019-10-01,Alabama,3872005,2245134,2182927,62207
2019-10-01,Alaska,546253,354160,335789,18371
2019-10-01,Arizona,5767426,3567196,3398108,169088
2019-10-01,Arkansas,2350098,1369548,1321163,48385
2019-10-01,California,31071318,19409073,18611910,797163
2019-10-01,Colorado,4568307,3146155,3066205,79950
2019-10-01,Connecticut,2885631,1923882,1855057,68825
2019-10-01,Delaware,783996,491392,472205,19187
2019-10-01,Florida,17494169,10417919,10083201,334718
2019-10-01,Georgia,8236438,5178965,5006146,172819
2019-10-01,Hawaii,1090017,672425,657423,15002
2019-10-01,Idaho,1380905,887783,864059,23724
2019-10-01,Illinois,9991696,6419051,6185129,233922
2019-10-01,Indiana,5254766,3389710,3283284,106426
2019-10-01,Iowa,2475313,1742983,1693374,49609
2019-10-01,Kansas,2230598,1500323,1453350,46973
2019-10-01,Kentucky,3501637,2082967,1997368,85599
2019-10-01,Louisiana,3585062,2137472,2033350,104122
2019-10-01,Maine,1113920,698672,679614,19058
2019-10-01,Maryland,4771088,3290807,3179659,111148
2019-10-01,Massachusetts,5643397,3785377,3674106,111271
2019-10-01,Michigan,7996150,4953762,4760278,193484
2019-10-01,Minnesota,4434016,3109362,3013162,96200
2019-10-01,Mississippi,2288305,1287058,1214486,72572
2019-10-01,Missouri,4822582,3096557,2990876,105681
2019-10-01,Montana,854715,541118,521645,19473
2019-10-01,Nebraska,1481955,1044517,1013744,30773
2019-10-01,Nevada,2448374,1586738,1527688,59050
2019-10-01,Ohio,9252182,5869890,5623254,246636
2019-10-01,Oklahoma,3038533,1853060,1795497,57563
2019-10-01,Oregon,3420102,2109607,2037899,71708
2019-10-01,Pennsylvania,10280988,6526543,6224885,301658
2019-10-01,Tennessee,5398996,3341366,3227055,114311
2019-10-01,Texas,22042462,14145807,13647759,498048
2019-10-01,Utah,2365287,1623452,1584461,38991
2019-10-01,Vermont,518595,344591,336052,8539
2019-10-01,Virginia,6700112,4452045,4338608,113437
2019-10-01,Washington,6046858,3939393,3784478,154915
2019-10-01,Wisconsin,4642347,3098170,2994445,103725
2019-10-01,Wyoming,452379,297774,286188,11586
2019-11-01,Alabama,3873710,2245681,2184363,61318
2019-11-01,Alaska,546204,353902,336054,17848
2019-11-01,Arizona,5779302,3573493,3405586,167907
2019-11-01,Arkansas,2351416,1371392,1323096,48296
2019-11-01,California,31078032,19428005,18629523,798482
2019-11-01,Colorado,4573834,3150945,3070651,80294
2019-11-01,Connecticut,2885855,1924643,1855727,68916
2019-11-01,Delaware,784946,492180,472634,19546
2019-11-01,Florida,17515663,10438251,10104965,333286
2019-11-01,Georgia,8244931,5188077,5017472,170605
2019-11-01,Hawaii,1089866,673465,659069,14396
2019-11-01,Idaho,1384052,889088,866032,23056
2019-11-01,Illinois,9989539,6405026,6178403,226623
2019-11-01,Indiana,5257617,3390052,3284278,105774
2019-11-01,Iowa,2476140,1742464,1693168,49296
2019-11-01,Kansas,2231343,1501501,1454798,46703
2019-11-01,Kentucky,3502739,2084262,1999126,85136
2019-11-01,Louisiana,3585109,2143640,2038123,105517
2019-11-01,Maine,1114519,699245,680075,19170
2019-11-01,Maryland,4772202,3294632,3185322,109310
2019-11-01,Massachusetts,5644916,3783053,3673157,109896
2019-11-01,Michigan,7997211,4949900,4762274,187626
2019-11-01,Minnesota,4436354,3112333,3016931,95402
2019-11-01,Mississippi,2288427,1286445,1214960,71485
2019-11-01,Missouri,4824710,3099989,2992970,107019
2019-11-01,Montana,855635,542047,522638,19409
2019-11-01,Nebraska,1482720,1045143,1014641,30502
2019-11-01,Nevada,2452584,1591578,1533376,58202
2019-11-01,Ohio,9254101,5878907,5630337,248570
2019-11-01,Oklahoma,3040628,1853848,1797021,56827
2019-11-01,Oregon,3423008,2110217,2040020,70197
2019-11-01,Pennsylvania,10282189,6532247,6228361,303886
2019-11-01,Tennessee,5404250,3342928,3226750,116178
2019-11-01,Texas,22074778,14164707,13669808,494899
2019-11-01,Utah,2369514,1627137,1588237,38900
2019-11-01,Vermont,518664,344687,336111,8576
2019-11-01,Virginia,6704073,4457320,4345864,111456
2019-11-01,Washington,6053960,3945768,3792879,152889
2019-11-01,Wisconsin,4644458,3096036,2993399,102637
2019-11-01,Wyoming,452666,298072,286213,11859
2019-12-01,Alabama,3875217,2243805,2183474,60331
2019-12-01,Alaska,546167,353626,336041,17585
2019-12-01,Arizona,5790821,3577998,3409326,168672
2019-12-01,Arkansas,2352592,1372227,1323423,48804
2019-12-01,California,31082947,19436766,18629682,807084
2019-12-01,Colorado,4579096,3153757,3072012,81745
2019-12-01,Connecticut,2885994,1923545,1854195,69350
2019-12-01,Delaware,785852,492735,472624,20111
2019-12-01,Florida,17536150,10451550,10115912,335638
2019-12-01,Georgia,8252983,5194430,5023703,170727
2019-12-01,Hawaii,1089657,673650,659676,13974
2019-12-01,Idaho,1387150,889686,867044,22642
2019-12-01,Illinois,9986797,6387664,6166253,221411
2019-12-01,Indiana,5260181,3384041,3278446,105595
2019-12-01,Iowa,2476859,1739293,1690212,49081
2019-12-01,Kansas,2232017,1501433,1454675,46758
2019-12-01,Kentucky,3503649,2083463,1998285,85178
2019-12-01,Louisiana,3584977,2148287,2041203,107084
2019-12-01,Maine,1115080,699593,679814,19779
2019-12-01,Maryland,4773117,3296994,3187889,109105
2019-12-01,Massachusetts,5646173,3776027,3667667,108360
2019-12-01,Michigan,7997875,4943738,4759897,183841
2019-12-01,Minnesota,4438470,3114576,3018498,96078
2019-12-01,Mississippi,2288447,1285312,1214113,71199
2019-12-01,Missouri,4826623,3100780,2992178,108602
2019-12-01,Montana,856541,542499,522984,19515
2019-12-01,Nebraska,1483375,1044977,1014498,30479
2019-12-01,Nevada,2456633,1595314,1537291,58023
2019-12-01,Ohio,9255603,5887786,5631692,256094
2019-12-01,Oklahoma,3042581,1852804,1796353,56451
2019-12-01,Oregon,3425727,2109883,2039745,70138
2019-12-01,Pennsylvania,10282920,6533827,6225747,308080
2019-12-01,Tennessee,5409243,3341819,3222404,119415
2019-12-01,Texas,22105815,14174181,13677859,496322
2019-12-01,Utah,2373687,1629570,1590354,39216
2019-12-01,Vermont,518756,344333,335826,8507
2019-12-01,Virginia,6707692,4457736,4347665,110071
2019-12-01,Washington,6060751,3951421,3798056,153365
2019-12-01,Wisconsin,4646321,3091661,2989464,102197
2019-12-01,Wyoming,452928,298339,285925,12414
2020-01-01,Alabama,3876526,2240277,2180872,59405
2020-01-01,Alaska,546109,353349,335692,17657
2020-01-01,Arizona,5802213,3581294,3409624,171670
2020-01-01,Arkansas,2353674,1372291,1322159,50132
2020-01-01,California,31086836,19437115,18613291,823824
2020-01-01,Colorado,4584112,3154544,3070164,84380
2020-01-01,Connecticut,2885953,1921041,1850746,70295
2020-01-01,Delaware,786721,493327,472306,21021
2020-01-01,Florida,17555962,10458937,10116910,342027
2020-01-01,Georgia,8260627,5198431,5024604,173827
2020-01-01,Hawaii,1089395,673017,659237,13780
2020-01-01,Idaho,1390161,889944,867117,22827
2020-01-01,Illinois,9983613,6370035,6149010,221025
2020-01-01,Indiana,5262529,3372996,3266538,106458
2020-01-01,Iowa,2477479,1734173,1684860,49313
2020-01-01,Kansas,2232550,1500177,1453029,47148
2020-01-01,Kentucky,3504469,2081086,1995321,85765
2020-01-01,Louisiana,3584646,2150907,2041637,109270
2020-01-01,Maine,1115592,699646,678873,20773
2020-01-01,Maryland,4773748,3298221,3187160,111061
2020-01-01,Massachusetts,5647161,3763790,3657139,106651
2020-01-01,Michigan,7998157,4936707,4753182,183525
2020-01-01,Minnesota,4440365,3116174,3017331,98843
2020-01-01,Mississippi,2288349,1284171,1211954,72217
2020-01-01,Missouri,4828271,3099592,2989051,110541
2020-01-01,Montana,857398,542553,522727,19826
2020-01-01,Nebraska,1484013,1044199,1013444,30755
2020-01-01,Nevada,2460603,1597920,1539287,58633
2020-01-01,Ohio,9256594,5895125,5627571,267554
2020-01-01,Oklahoma,3044378,1850300,1793406,56894
2020-01-01,Oregon,3428283,2108977,2037231,71746
2020-01-01,Pennsylvania,10283103,6532104,6216949,315155
2020-01-01,Tennessee,5413972,3338446,3214183,124263
2020-01-01,Texas,22136086,14178765,13673709,505056
2020-01-01,Utah,2377669,1630818,1590908,39910
2020-01-01,Vermont,518807,343628,335164,8464
2020-01-01,Virginia,6711014,4453855,4343866,109989
2020-01-01,Washington,6067267,3957004,3799953,157051
2020-01-01,Wisconsin,4647953,3084954,2982788,102166
2020-01-01,Wyoming,453129,298600,285320,13280
2020-02-01,Alabama,3877055,2236491,2177852,58639
2020-02-01,Alaska,545922,352940,335023,17917
2020-02-01,Arizona,5812433,3584045,3407756,176289
2020-02-01,Arkansas,2354279,1371944,1319917,52027
2020-02-01,California,31086594,19433049,18587756,845293
2020-02-01,Colorado,4588565,3153582,3065913,87669
2020-02-01,Connecticut,2885386,1917993,1846218,71775
2020-02-01,Delaware,787402,494035,471865,22170
2020-02-01,Florida,17571923,10461404,10111574,349830
2020-02-01,Georgia,8266924,5201435,5021666,179769
2020-02-01,Hawaii,1088920,671901,658112,13789
2020-02-01,Idaho,1392964,890044,866502,23542
2020-02-01,Illinois,9978724,6355061,6128641,226420
2020-02-01,Indiana,5263980,3359160,3250571,108589
2020-02-01,Iowa,2477569,1727949,1678066,49883
2020-02-01,Kansas,2232676,1498044,1450486,47558
2020-02-01,Kentucky,3504588,2077898,1991434,86464
2020-02-01,Louisiana,3583665,2151507,2039411,112096
2020-02-01,Maine,1115854,699067,677448,21619
2020-02-01,Maryland,4773523,3298443,3184239,114204
2020-02-01,Massachusetts,5647178,3747222,3642616,104606
2020-02-01,Michigan,7996913,4927949,4743379,184570
2020-02-01,Minnesota,4441480,3117081,3013513,103568
2020-02-01,Mississippi,2287820,1283304,1209022,74282
2020-02-01,Missouri,4828978,3097559,2984967,112592
2020-02-01,Montana,858070,542368,522142,20226
2020-02-01,Nebraska,1484359,1043340,1012002,31338
2020-02-01,Nevada,2464244,1599451,1539656,59795
2020-02-01,Ohio,9255817,5899009,5619606,279403
2020-02-01,Oklahoma,3045622,1847072,1788930,58142
2020-02-01,Oregon,3430274,2107699,2033344,74355
2020-02-01,Pennsylvania,10281185,6528498,6204448,324050
2020-02-01,Tennessee,5417729,3333471,3203564,129907
2020-02-01,Texas,22163701,14182317,13662942,519375
2020-02-01,Utah,2381430,1631216,1590455,40761
2020-02-01,Vermont,518755,342887,334270,8617
2020-02-01,Virginia,6713131,4448623,4337089,111534
2020-02-01,Washington,6072840,3961975,3799304,162671
2020-02-01,Wisconsin,4648731,3075655,2974233,101422
2020-02-01,Wyoming,453321,298818,284507,14311
2020-03-01,Alabama,3878006,2234170,2176275,57895
2020-03-01,Alaska,545866,352404,334331,18073
2020-03-01,Arizona,5823018,3587701,3406748,180953
2020-03-01,Arkansas,2355118,1372102,1318251,53851
2020-03-01,California,31087184,19168665,18304574,864091
2020-03-01,Colorado,4593310,3099232,2953112,146120
2020-03-01,Connecticut,2885051,1915644,1842200,73444
2020-03-01,Delaware,788163,481344,458200,23144
2020-03-01,Florida,17589075,10629624,10106833,522791
2020-03-01,Georgia,8273938,5205472,5018477,186995
2020-03-01,Hawaii,1088470,671079,657086,13993
2020-03-01,Idaho,1395898,890190,865860,24330
2020-03-01,Illinois,9974673,6345433,6109809,235624
2020-03-01,Indiana,5265950,3346411,3235038,111373
2020-03-01,Iowa,2477947,1721723,1671622,50101
2020-03-01,Kansas,2233058,1495882,1448406,47476
2020-03-01,Kentucky,3505113,2075112,1988308,86804
2020-03-01,Louisiana,3583040,2150787,2036022,114765
2020-03-01,Maine,1116239,697728,676175,21553
2020-03-01,Maryland,4773662,3298663,3181957,116706
2020-03-01,Massachusetts,5647723,3728887,3627179,101708
2020-03-01,Michigan,7996478,4917789,4734860,182929
2020-03-01,Minnesota,4443088,3118380,3008879,109501
2020-03-01,Mississippi,2287475,1283188,1206406,76782
2020-03-01,Missouri,4830226,3096593,2982405,114188
2020-03-01,Montana,858828,542146,521657,20489
2020-03-01,Nebraska,1484852,1043236,1011133,32103
2020-03-01,Nevada,2467941,1587900,1485811,102089
2020-03-01,Ohio,9256097,5836682,5549718,286964
2020-03-01,Oklahoma,3047166,1844387,1784671,59716
2020-03-01,Oregon,3432553,2106741,2030098,76643
2020-03-01,Pennsylvania,10280347,6525913,6194061,331852
2020-03-01,Tennessee,5422052,3328051,3193850,134201
2020-03-01,Texas,22192219,13986789,13306781,680008
2020-03-01,Utah,2385460,1631706,1590309,41397
2020-03-01,Vermont,518754,342487,333471,9016
2020-03-01,Virginia,6715837,4447482,4333184,114298
2020-03-01,Washington,6078919,3932003,3724793,207210
2020-03-01,Wisconsin,4649987,3065273,2966524,98749
2020-03-01,Wyoming,453558,299040,283757,15283
2020-04-01,Alabama,3879108,2187272,1899019,288253
2020-04-01,Alaska,545788,345671,304991,40680
2020-04-01,Arizona,5834004,3545107,3040409,504698
2020-04-01,Arkansas,2356097,1371571,1234204,137367
2020-04-01,California,31090131,18590864,15624429,2966435
2020-04-01,Colorado,4598343,2983132,2621363,361769
2020-04-01,Connecticut,2884884,1826611,1669743,156868
2020-04-01,Delaware,788966,474498,411017,63481
2020-04-01,Florida,17607252,9765316,8400513,1364803
2020-04-01,Georgia,8281411,4985895,4365055,620840
2020-04-01,Hawaii,1088090,637563,497928,139635
2020-04-01,Idaho,1398886,876528,775219,101309
2020-04-01,Illinois,9971141,6026243,5029765,996478
2020-04-01,Indiana,5268170,3225032,2680097,544935
2020-04-01,Iowa,2478425,1712557,1522362,190195
2020-04-01,Kansas,2233522,1485985,1298910,187075
2020-04-01,Kentucky,3505783,2087483,1734915,352568
2020-04-01,Louisiana,3582557,2041667,1773471,268196
2020-04-01,Maine,1116663,654335,594673,59662
2020-04-01,Maryland,4774055,3131058,2848836,282222
2020-04-01,Massachusetts,5648468,3409863,2851481,558382
2020-04-01,Michigan,7996378,4586421,3502065,1084356
2020-04-01,Minnesota,4444837,3012976,2740570,272406
2020-04-01,Mississippi,2287269,1218052,1027052,191000
2020-04-01,Missouri,4831693,2980434,2606915,373519
2020-04-01,Montana,859622,543608,479153,64455
2020-04-01,Nebraska,1485441,1051562,973730,77832
2020-04-01,Nevada,2471833,1497652,1055435,442217
2020-04-01,Ohio,9256776,5539776,4630914,908862
2020-04-01,Oklahoma,3048864,1821680,1585139,236541
2020-04-01,Oregon,3434992,2049533,1778695,270838
2020-04-01,Pennsylvania,10279924,6313806,5290771,1023035
2020-04-01,Tennessee,5426617,3183054,2679469,503585
2020-04-01,Texas,22222320,13368039,11640170,1727869
2020-04-01,Utah,2389585,1624093,1460079,164014
2020-04-01,Vermont,518778,353857,301638,52219
2020-04-01,Virginia,6718918,4391242,3895532,495710
2020-04-01,Washington,6085331,3988363,3336286,652077
2020-04-01,Wisconsin,4651479,3061130,2607992,453138
2020-04-01,Wyoming,453794,290960,274922,16038
2020-05-01,Alabama,3879383,2218789,2044109,174680
2020-05-01,Alaska,545650,345359,305247,40112
2020-05-01,Arizona,5843415,3619124,3236482,382642
2020-05-01,Arkansas,2356584,1352008,1237273,114735
2020-05-01,California,31081351,18392528,15529319,2863209
2020-05-01,Colorado,4602402,3105848,2744873,360975
2020-05-01,Connecticut,2883940,1886540,1671130,215410
2020-05-01,Delaware,789583,475201,412227,62974
2020-05-01,Florida,17620672,9949585,8533164,1416421
2020-05-01,Georgia,8286668,5030665,4558036,472629
2020-05-01,Hawaii,1087260,638894,498685,140209
2020-05-01,Idaho,1401631,882245,808995,73250
2020-05-01,Illinois,9965041,6158659,5211779,946880
2020-05-01,Indiana,5269325,3264747,2874299,390448
2020-05-01,Iowa,2478455,1660842,1523062,137780
2020-05-01,Kansas,2233534,1488938,1354666,134272
2020-05-01,Kentucky,3505869,2073314,1846754,226560
2020-05-01,Louisiana,3581304,2039684,1771746,267938
2020-05-01,Maine,1116950,681019,624764,56255
2020-05-01,Maryland,4773107,3135302,2854474,280828
2020-05-01,Massachusetts,5647805,3609060,3056433,552627
2020-05-01,Michigan,7994582,4695183,3718354,976829
2020-05-01,Minnesota,4445755,3087954,2739692,348262
2020-05-01,Mississippi,2286517,1227107,1091934,135173
2020-05-01,Missouri,4832218,2891970,2613065,278905
2020-05-01,Montana,860294,528223,480130,48093
2020-05-01,Nebraska,1485719,1031661,975917,55744
2020-05-01,Nevada,2474993,1435029,1083335,351694
2020-05-01,Ohio,9255576,5831829,4965227,866602
2020-05-01,Oklahoma,3049957,1831486,1657368,174118
2020-05-01,Oregon,3436725,2121025,1873383,247642
2020-05-01,Pennsylvania,10277311,6412123,5549484,862639
2020-05-01,Tennessee,5430156,3150509,2848150,302359
2020-05-01,Texas,22245728,13567930,11992731,1575199
2020-05-01,Utah,2393257,1583682,1463992,119690
2020-05-01,Vermont,518699,332962,301923,31039
2020-05-01,Virginia,6720219,4274171,3912282,361889
2020-05-01,Washington,6090159,3904883,3417587,487296
2020-05-01,Wisconsin,4652037,3052908,2736271,316637
2020-05-01,Wyoming,453942,300611,275096,25515
2020-06-01,Alabama,3879980,2221436,2049715,171721
2020-06-01,Alaska,545489,345254,306122,39132
2020-06-01,Arizona,5853318,3561870,3180733,381137
2020-06-01,Arkansas,2357230,1347387,1242595,104792
2020-06-01,California,31075328,18813142,16161036,2652106
2020-06-01,Colorado,4606805,3154711,2796909,357802
2020-06-01,Connecticut,2883299,1890666,1675483,215183
2020-06-01,Delaware,790266,475871,414294,61577
2020-06-01,Florida,17635636,9898486,8749388,1149098
2020-06-01,Georgia,8292650,4990499,4569851,420648
2020-06-01,Hawaii,1086459,639357,549249,90108
2020-06-01,Idaho,1404514,884808,822839,61969
2020-06-01,Illinois,9959743,6356264,5452932,903332
2020-06-01,Indiana,5270927,3284240,2950944,333296
2020-06-01,Iowa,2478689,1645540,1528543,116997
2020-06-01,Kansas,2233723,1481232,1377977,103255
2020-06-01,Kentucky,3506224,1962690,1851652,111038
2020-06-01,Louisiana,3580287,1955017,1772157,182860
2020-06-01,Maine,1117286,661977,626891,35086
2020-06-01,Maryland,4772600,3235141,2957538,277603
2020-06-01,Massachusetts,5647618,3683679,3138699,544980
2020-06-01,Michigan,7993462,4917012,4221930,695082
2020-06-01,Minnesota,4446981,3178494,2894566,283928
2020-06-01,Mississippi,2285922,1235797,1117094,118703
2020-06-01,Missouri,4833125,2994804,2752806,241998
2020-06-01,Montana,861056,549295,507756,41539
2020-06-01,Nebraska,1486137,1048401,979531,68870
2020-06-01,Nevada,2478346,1504348,1272287,232061
2020-06-01,Ohio,9255121,5680927,5093233,587694
2020-06-01,Oklahoma,3051282,1838543,1687262,151281
2020-06-01,Oregon,3438732,2133140,1913733,219407
2020-06-01,Pennsylvania,10275510,6421698,5567918,853780
2020-06-01,Tennessee,5434065,3156214,2862152,294062
2020-06-01,Texas,22271053,14068625,12638796,1429829
2020-06-01,Utah,2397123,1650824,1547616,103208
2020-06-01,Vermont,518679,327912,302806,25106
2020-06-01,Virginia,6722117,4320856,3939193,381663
2020-06-01,Washington,6095478,3877618,3457295,420323
2020-06-01,Wisconsin,4653004,3049234,2786485,262749
2020-06-01,Wyoming,454118,297883,275846,22037
2020-07-01,Alabama,3880648,2221858,2056348,165510
2020-07-01,Alaska,545364,345354,307513,37841
2020-07-01,Arizona,5863335,3610878,3233654,377224
2020-07-01,Arkansas,2357952,1344406,1249195,95211
2020-07-01,California,31069557,18731539,16268045,2463494
2020-07-01,Colorado,4611317,3070601,2844310,226291
2020-07-01,Connecticut,2882679,1895751,1681865,213886
2020-07-01,Delaware,790928,489517,449079,40438
2020-07-01,Florida,17650810,10108143,8940935,1167208
2020-07-01,Georgia,8298770,4966280,4587883,378397
2020-07-01,Hawaii,1085710,641845,551240,90605
2020-07-01,Idaho,1407405,887190,835264,51926
2020-07-01,Illinois,9954618,6146834,5409563,737271
2020-07-01,Indiana,5272639,3304366,3019818,284548
2020-07-01,Iowa,2478961,1637807,1538161,99646
2020-07-01,Kansas,2233951,1497429,1398770,98659
2020-07-01,Kentucky,3506659,1968434,1858922,109512
2020-07-01,Louisiana,3579383,1952856,1775157,177699
2020-07-01,Maine,1117659,690375,629790,60585
2020-07-01,Maryland,4772159,3151830,2877939,273891
2020-07-01,Massachusetts,5647519,3563106,3213230,349876
2020-07-01,Michigan,7992512,4835421,4399525,435896
2020-07-01,Minnesota,4448291,3136773,2898989,237784
2020-07-01,Mississippi,2285425,1245129,1138838,106291
2020-07-01,Missouri,4834175,3101654,2891126,210528
2020-07-01,Montana,861803,545747,509831,35916
2020-07-01,Nebraska,1486531,1028806,983881,44925
2020-07-01,Nevada,2481749,1512588,1261549,251039
2020-07-01,Ohio,9254910,5735320,5199086,536234
2020-07-01,Oklahoma,3052681,1846738,1714448,132290
2020-07-01,Oregon,3440819,2037847,1842992,194855
2020-07-01,Pennsylvania,10273917,6431720,5592719,839001
2020-07-01,Tennessee,5438126,3167388,2884231,283157
2020-07-01,Texas,22296608,14005509,12704427,1301082
2020-07-01,Utah,2401050,1645536,1556112,89424
2020-07-01,Vermont,518664,324705,304020,20685
2020-07-01,Virginia,6724104,4313312,3972148,341164
2020-07-01,Washington,6100875,3920431,3497219,423212
2020-07-01,Wisconsin,4654069,3049237,2829923,219314
2020-07-01,Wyoming,454334,297259,277055,20204
2020-08-01,Alabama,3882472,2218586,2061877,156709
2020-08-01,Alaska,545315,332996,308923,24073
2020-08-01,Arizona,5875190,3518731,3272951,245780
2020-08-01,Arkansas,2359375,1341356,1254825,86531
2020-08-01,California,31074765,18666663,16365343,2301320
2020-08-01,Colorado,4616798,3105843,2884052,221791
2020-08-01,Connecticut,2882475,1841890,1687722,154168
2020-08-01,Delaware,791842,490233,451598,38635
2020-08-01,Florida,17669527,9991016,9206578,784438
2020-08-01,Georgia,8306713,4951494,4606347,345147
2020-08-01,Hawaii,1085305,643435,552752,90683
2020-08-01,Idaho,1410666,889123,845684,43439
2020-08-01,Illinois,9951889,6251739,5556088,695651
2020-08-01,Indiana,5275194,3320857,3077335,243522
2020-08-01,Iowa,2479628,1634482,1548511,85971
2020-08-01,Kansas,2234666,1509706,1415790,93916
2020-08-01,Kentucky,3507887,1974553,1865892,108661
2020-08-01,Louisiana,3579331,2096160,1924464,171696
2020-08-01,Maine,1118255,666897,632379,34518
2020-08-01,Maryland,4772659,3161767,2890448,271319
2020-08-01,Massachusetts,5647588,3614444,3277606,336838
2020-08-01,Michigan,7993400,4841531,4428898,412633
2020-08-01,Minnesota,4450313,3107608,2903291,204317
2020-08-01,Mississippi,2285698,1253922,1156630,97292
2020-08-01,Missouri,4836296,3089395,2904372,185023
2020-08-01,Montana,862714,542642,511307,31335
2020-08-01,Nebraska,1487267,1028809,987515,41294
2020-08-01,Nevada,2485827,1523576,1302740,220836
2020-08-01,Ohio,9256696,5803203,5280326,522877
2020-08-01,Oklahoma,3054823,1853864,1736890,116974
2020-08-01,Oregon,3443733,2086120,1911571,174549
2020-08-01,Pennsylvania,10274843,6252470,5614075,638395
2020-08-01,Tennessee,5443591,3377475,3104367,273108
2020-08-01,Texas,22327142,14095792,13118386,977406
2020-08-01,Utah,2405329,1642626,1564538,78088
2020-08-01,Vermont,518754,322293,305041,17252
2020-08-01,Virginia,6727072,4376496,4068442,308054
2020-08-01,Washington,6107080,3886077,3532848,353229
2020-08-01,Wisconsin,4656094,3050916,2864676,186240
2020-08-01,Wyoming,454672,296712,278278,18434
2020-09-01,Alabama,3884533,2212712,2065378,147334
2020-09-01,Alaska,545254,333247,309975,23272
2020-09-01,Arizona,5887367,3541969,3299327,242642
2020-09-01,Arkansas,2360906,1337649,1258219,79430
2020-09-01,California,31081669,18385558,16435503,1950055
2020-09-01,Colorado,4622504,3133342,2914426,218916
2020-09-01,Connecticut,2882419,1844073,1691446,152627
2020-09-01,Delaware,792821,490907,453405,37502
2020-09-01,Florida,17689159,10052895,9333690,719205
2020-09-01,Georgia,8315078,4940860,4620784,320076
2020-09-01,Hawaii,1084946,610118,519692,90426
2020-09-01,Idaho,1414009,908599,853750,54849
2020-09-01,Illinois,9949614,6363924,5703261,660663
2020-09-01,Indiana,5277977,3331816,3121310,210506
2020-09-01,Iowa,2480410,1632810,1556751,76059
2020-09-01,Kansas,2235531,1472356,1382202,90154
2020-09-01,Kentucky,3509267,1979845,1870874,108971
2020-09-01,Louisiana,3579467,2095001,1927988,167013
2020-09-01,Maine,1118905,666384,634000,32384
2020-09-01,Maryland,4773360,3009144,2800001,209143
2020-09-01,Massachusetts,5647956,3655222,3330763,324459
2020-09-01,Michigan,7994613,4848757,4450747,398010
2020-09-01,Minnesota,4452562,3086445,2905954,180491
2020-09-01,Mississippi,2286039,1261776,1170336,91440
2020-09-01,Missouri,4838656,3079960,2914028,165932
2020-09-01,Montana,863704,539685,511783,27902
2020-09-01,Nebraska,1488070,1028194,989626,38568
2020-09-01,Nevada,2489990,1535174,1335440,199734
2020-09-01,Ohio,9258910,5668842,5250401,418441
2020-09-01,Oklahoma,3057131,1858861,1753633,105228
2020-09-01,Oregon,3446867,2107097,1948079,159018
2020-09-01,Pennsylvania,10276251,6317241,5867228,450013
2020-09-01,Tennessee,5449301,3388990,3122079,266911
2020-09-01,Texas,22358893,13978180,12872257,1105923
2020-09-01,Utah,2409740,1640259,1571099,69160
2020-09-01,Vermont,518848,320189,305589,14600
2020-09-01,Virginia,6730369,4302424,4020210,282214
2020-09-01,Washington,6113541,3870014,3560713,309301
2020-09-01,Wisconsin,4658297,3128082,2965386,162696
2020-09-01,Wyoming,454998,296176,279179,16997
2020-10-01,Alabama,3886383,2266300,2158999,107301
2020-10-01,Alaska,545223,354075,331171,22904
2020-10-01,Arizona,5899190,3556433,3315121,241312
2020-10-01,Arkansas,2362323,1333366,1259359,74007
2020-10-01,California,31086721,18904638,17050260,1854378
2020-10-01,Colorado,4627942,3153491,2935611,217880
2020-10-01,Connecticut,2882202,1844473,1692736,151737
2020-10-01,Delaware,793770,481815,454271,27544
2020-10-01,Florida,17707888,10010524,9427112,583412
2020-10-01,Georgia,8323051,5133190,4831831,301359
2020-10-01,Hawaii,1084522,643115,553195,89920
2020-10-01,Idaho,1417281,903294,859499,43795
2020-10-01,Illinois,9946882,6326464,5813987,512477
2020-10-01,Indiana,5280606,3338006,3152745,185261
2020-10-01,Iowa,2481099,1630576,1561396,69180
2020-10-01,Kansas,2236251,1508097,1437158,70939
2020-10-01,Kentucky,3510534,1983293,1873315,109978
2020-10-01,Louisiana,3579445,2094453,1929972,164481
2020-10-01,Maine,1119531,666379,634487,31892
2020-10-01,Maryland,4773863,3113628,2903239,210389
2020-10-01,Massachusetts,5648070,3688327,3373320,315007
2020-10-01,Michigan,7995545,4854613,4461770,392843
2020-10-01,Minnesota,4454624,3070211,2906452,163759
2020-10-01,Mississippi,2286309,1268234,1180316,87918
2020-10-01,Missouri,4840816,3071517,2919089,152428
2020-10-01,Montana,864626,536872,511419,25453
2020-10-01,Nebraska,1488824,1026818,990239,36579
2020-10-01,Nevada,2494084,1545744,1360394,185350
2020-10-01,Ohio,9260740,5698877,5380157,318720
2020-10-01,Oklahoma,3059281,1861590,1765143,96447
2020-10-01,Oregon,3449790,2122565,1974681,147884
2020-10-01,Pennsylvania,10277210,6314482,5870140,444342
2020-10-01,Tennessee,5454779,3396932,3131888,265044
2020-10-01,Texas,22389388,14220838,13177348,1043490
2020-10-01,Utah,2414062,1637215,1574896,62319
2020-10-01,Vermont,518954,318369,305655,12714
2020-10-01,Virginia,6733361,4290462,4027562,262900
2020-10-01,Washington,6119759,3981810,3704008,277802
2020-10-01,Wisconsin,4660353,3054307,2908317,145990
2020-10-01,Wyoming,455331,295623,279620,16003
2020-11-01,Alabama,3887946,2263901,2158343,105558
2020-11-01,Alaska,545133,354071,331069,23002
2020-11-01,Arizona,5910601,3563927,3322173,241754
2020-11-01,Arkansas,2363579,1328600,1258385,70215
2020-11-01,California,31090632,18604626,16983903,1620723
2020-11-01,Colorado,4633108,3166511,2947931,218580
2020-11-01,Connecticut,2881741,1843528,1691777,151751
2020-11-01,Delaware,794630,481873,453979,27894
2020-11-01,Florida,17725160,10025050,9485302,539748
2020-11-01,Georgia,8330547,5116371,4831240,285131
2020-11-01,Hawaii,1084113,655912,588368,67544
2020-11-01,Idaho,1420432,901615,862991,38624
2020-11-01,Illinois,9943419,6161356,5662138,499218
2020-11-01,Indiana,5282747,3340983,3173510,167473
2020-11-01,Iowa,2481531,1625043,1560883,64160
2020-11-01,Kansas,2236775,1513503,1442525,70978
2020-11-01,Kentucky,3511462,1983374,1872685,110689
2020-11-01,Louisiana,3579170,2094642,1929950,164692
2020-11-01,Maine,1120025,666706,633957,32749
2020-11-01,Maryland,4774038,3113418,2901959,211459
2020-11-01,Massachusetts,5647713,3721554,3408246,313308
2020-11-01,Michigan,7995779,4855661,4458979,396682
2020-11-01,Minnesota,4456287,3057403,2905452,151951
2020-11-01,Mississippi,2286424,1272826,1187251,85575
2020-11-01,Missouri,4842526,3061073,2918134,142939
2020-11-01,Montana,865491,534549,510758,23791
2020-11-01,Nebraska,1489408,1024861,989563,35298
2020-11-01,Nevada,2498025,1509102,1378050,131052
2020-11-01,Ohio,9261688,5732818,5413227,319591
2020-11-01,Oklahoma,3061177,1861831,1772259,89572
2020-11-01,Oregon,3452417,2132974,1992470,140504
2020-11-01,Pennsylvania,10277120,6310994,5865408,445586
2020-11-01,Tennessee,5459887,3314879,3130511,184368
2020-11-01,Texas,22418959,13992055,12989789,1002266
2020-11-01,Utah,2418202,1631847,1574574,57273
2020-11-01,Vermont,518950,316982,305386,11596
2020-11-01,Virginia,6735886,4271293,4023075,248218
2020-11-01,Washington,6125522,3842951,3586497,256454
2020-11-01,Wisconsin,4661965,3054158,2921245,132913
2020-11-01,Wyoming,455610,295063,279509,15554
2020-12-01,Alabama,3889304,2264054,2157736,106318
2020-12-01,Alaska,545002,354035,330888,23147
2020-12-01,Arizona,5921658,3569317,3326907,242410
2020-12-01,Arkansas,2364696,1379313,1312142,67171
2020-12-01,California,31092761,18705475,16957019,1748456
2020-12-01,Colorado,4638089,3176560,2957291,219269
2020-12-01,Connecticut,2881139,1842967,1690960,152007
2020-12-01,Delaware,795439,481840,453637,28203
2020-12-01,Florida,17741498,10043992,9528878,515114
2020-12-01,Georgia,8337625,5100297,4829189,271108
2020-12-01,Hawaii,1083643,655587,588168,67419
2020-12-01,Idaho,1423536,900245,865649,34596
2020-12-01,Illinois,9939435,6150544,5659671,490873
2020-12-01,Indiana,5284652,3343929,3190041,153888
2020-12-01,Iowa,2481817,1619441,1559562,59879
2020-12-01,Kansas,2237175,1518416,1446860,71556
2020-12-01,Kentucky,3512248,1982759,1871847,110912
2020-12-01,Louisiana,3578682,2095025,1929532,165493
2020-12-01,Maine,1120437,666913,633553,33360
2020-12-01,Maryland,4773973,3112292,2900385,211907
2020-12-01,Massachusetts,5647094,3753070,3438583,314487
2020-12-01,Michigan,7995651,4855353,4454983,400370
2020-12-01,Minnesota,4457728,3048729,2904806,143923
2020-12-01,Mississippi,2286392,1276640,1192792,83848
2020-12-01,Missouri,4844027,3051663,2916551,135112
2020-12-01,Montana,866314,532934,510472,22462
2020-12-01,Nebraska,1489954,1023600,989072,34528
2020-12-01,Nevada,2501811,1516397,1391773,124624
2020-12-01,Ohio,9262241,5763310,5442603,320707
2020-12-01,Oklahoma,3062909,1861928,1777990,83938
2020-12-01,Oregon,3454895,2141252,2006503,134749
2020-12-01,Pennsylvania,10276507,6310050,5862162,447888
2020-12-01,Tennessee,5464698,3313650,3127609,186041
2020-12-01,Texas,22447253,14133518,13162510,971008
2020-12-01,Utah,2422249,1626916,1573578,53338
2020-12-01,Vermont,518976,316150,305226,10924
2020-12-01,Virginia,6738044,4255079,4018875,236204
2020-12-01,Washington,6131010,3830416,3590957,239459
2020-12-01,Wisconsin,4663376,3053836,2932229,121607
2020-12-01,Wyoming,455877,294630,279346,15284
2021-01-01,Alabama,3890500,2257961,2160236,97725
2021-01-01,Alaska,544894,354958,331373,23585
2021-01-01,Arizona,5932506,3571263,3331367,239896
2021-01-01,Arkansas,2365706,1375929,1312405,63524
2021-01-01,California,31093847,18668523,16988683,1679840
2021-01-01,Colorado,4642794,3183395,2972204,211191
2021-01-01,Connecticut,2880415,1839727,1690546,149181
2021-01-01,Delaware,796235,487378,457875,29503
2021-01-01,Florida,17757100,10068685,9587059,481626
2021-01-01,Georgia,8344325,5112237,4853777,258460
2021-01-01,Hawaii,1083148,655766,588116,67650
2021-01-01,Idaho,1426574,900287,869144,31143
2021-01-01,Illinois,9935021,6146410,5673481,472929
2021-01-01,Indiana,5286270,3347810,3206431,141379
2021-01-01,Iowa,2482022,1625153,1567143,58010
2021-01-01,Kansas,2237486,1502248,1450464,51784
2021-01-01,Kentucky,3512884,1989380,1882979,106401
2021-01-01,Louisiana,3578075,2084330,1925840,158490
2021-01-01,Maine,1120850,671317,636270,35047
2021-01-01,Maryland,4773686,3106287,2907520,198767
2021-01-01,Massachusetts,5646187,3756720,3461950,294770
2021-01-01,Michigan,7995094,4736547,4465785,270762
2021-01-01,Minnesota,4458943,3025807,2889849,135958
2021-01-01,Mississippi,2286271,1279970,1197779,82191
2021-01-01,Missouri,4845259,3042955,2912406,130549
2021-01-01,Montana,867082,532910,511691,21219
2021-01-01,Nebraska,1490395,1024822,992112,32710
2021-01-01,Nevada,2505533,1536046,1405483,130563
2021-01-01,Ohio,9262261,5768594,5462512,306082
2021-01-01,Oklahoma,3064511,1864691,1783422,81269
2021-01-01,Oregon,3457167,2150483,2017032,133451
2021-01-01,Pennsylvania,10275393,6294551,5837381,457170
2021-01-01,Tennessee,5469230,3317190,3146950,170240
2021-01-01,Texas,22474687,14063544,13104983,958561
2021-01-01,Utah,2426150,1630721,1580527,50194
2021-01-01,Vermont,518952,314630,304521,10109
2021-01-01,Virginia,6739873,4254052,4026838,227214
2021-01-01,Washington,6136163,3835229,3606638,228591
2021-01-01,Wisconsin,4664495,3056717,2939823,116894
2021-01-01,Wyoming,456106,295132,280002,15130
2021-02-01,Alabama,3891139,2249475,2158410,91065
2021-02-01,Alaska,544693,351042,327734,23308
2021-02-01,Arizona,5942577,3580159,3333218,246941
2021-02-01,Arkansas,2366377,1363154,1301585,61569
2021-02-01,California,31091641,18944536,17334333,1610203
2021-02-01,Colorado,4647075,3187192,2977934,209258
2021-02-01,Connecticut,2879316,1712892,1566755,146137
2021-02-01,Delaware,796901,488849,457878,30971
2021-02-01,Florida,17769891,10124081,9649964,474117
2021-02-01,Georgia,8350072,5145311,4899537,245774
2021-02-01,Hawaii,1082480,655353,595209,60144
2021-02-01,Idaho,1429397,899796,870056,29740
2021-02-01,Illinois,9929473,6138343,5684103,454240
2021-02-01,Indiana,5287355,3342839,3208862,133977
2021-02-01,Iowa,2481881,1628644,1570309,58335
2021-02-01,Kansas,2237550,1499299,1451432,47867
2021-02-01,Kentucky,3513075,1993122,1889699,103423
2021-02-01,Louisiana,3576989,2076336,1919136,157200
2021-02-01,Maine,1121094,672438,639943,32495
2021-02-01,Maryland,4772844,3101248,2909635,191613
2021-02-01,Massachusetts,5644665,3744815,3477684,267131
2021-02-01,Michigan,7993560,4695245,4451945,243300
2021-02-01,Minnesota,4459692,3022136,2892393,129743
2021-02-01,Mississippi,2285852,1281419,1200442,80977
2021-02-01,Missouri,4845885,3050852,2921918,128934
2021-02-01,Montana,867716,531389,510726,20663
2021-02-01,Nebraska,1490687,1021103,989085,32018
2021-02-01,Nevada,2508958,1545250,1416663,128587
2021-02-01,Ohio,9261248,5755857,5467067,288790
2021-02-01,Oklahoma,3065768,1865479,1784164,81315
2021-02-01,Oregon,3459073,2152206,2021269,130937
2021-02-01,Pennsylvania,10273015,6330147,5867367,462780
2021-02-01,Tennessee,5473138,3308238,3145757,162481
2021-02-01,Texas,22500029,14005438,13034964,970474
2021-02-01,Utah,2429915,1630609,1581835,48774
2021-02-01,Vermont,518856,313279,303681,9598
2021-02-01,Virginia,6740927,4238057,4018030,220027
2021-02-01,Washington,6140754,3837392,3621486,215906
2021-02-01,Wisconsin,4665137,3059210,2942805,116405
2021-02-01,Wyoming,456315,295331,279791,15540
