ds,name,civ,labor,emp,unemp
01/01/2008,Alabama,3577198,2182712,2083744,98968
01/01/2008,Alaska,498693,352640,330728,21912
01/01/2008,Arizona,4822624,3048650,2918156,130494
01/01/2008,Arkansas,2177814,1353678,1284620,69058
01/01/2008,California,27453421,18047064,16979728,1067336
01/01/2008,Colorado,3733587,2729192,2615692,113500
01/01/2008,Connecticut,2718370,1869605,1779846,89759
01/01/2008,Delaware,673835,449481,432002,17479
01/01/2008,Florida,14421176,9166494,8780743,385751
01/01/2008,Georgia,7145219,4866898,4601237,265661
01/01/2008,Hawaii,972401,640525,620658,19867
01/01/2008,Idaho,1125010,753003,729462,23541
01/01/2008,Illinois,9782110,6709673,6334043,375630
01/01/2008,Indiana,4858075,3222317,3068926,153391
01/01/2008,Iowa,2313758,1671514,1610160,61354
01/01/2008,Kansas,2104656,1488330,1424783,63547
01/01/2008,Kentucky,3293294,2027269,1919001,108268
01/01/2008,Louisiana,3328228,2046613,1963488,83125
01/01/2008,Maine,1060238,701344,668746,32598
01/01/2008,Maryland,4342905,3006981,2899910,107071
01/01/2008,Massachusetts,5161571,3443336,3287272,156064
01/01/2008,Michigan,7775722,4962050,4604930,357120
01/01/2008,Minnesota,4034155,2896805,2760194,136611
01/01/2008,Mississippi,2180462,1303465,1224659,78806
01/01/2008,Missouri,4557530,3064242,2899013,165229
01/01/2008,Montana,755967,510364,490873,19491
01/01/2008,Nebraska,1347708,984852,955811,29041
01/01/2008,Nevada,1961491,1364101,1291670,72431
01/01/2008,Ohio,8918397,6014754,5675960,338794
01/01/2008,Oklahoma,2731019,1726265,1667262,59003
01/01/2008,Oregon,2951299,1925863,1827073,98790
01/01/2008,Pennsylvania,9863659,6397499,6090155,307344
01/01/2008,Tennessee,4795355,3050278,2887750,162528
01/01/2008,Texas,17582139,11551722,11049469,502253
01/01/2008,Utah,1914712,1390196,1350736,39460
01/01/2008,Vermont,503680,352192,337980,14212
01/01/2008,Virginia,5895643,4089713,3941102,148611
01/01/2008,Washington,5051757,3446781,3288083,158698
01/01/2008,Wisconsin,4375769,3092444,2952857,139587
01/01/2008,Wyoming,407544,294176,286531,7645
01/02/2008,Alabama,3579499,2182002,2079970,102032
01/02/2008,Alaska,499046,353200,331231,21969
01/02/2008,Arizona,4830910,3055250,2919912,135338
01/02/2008,Arkansas,2179102,1353823,1286093,67730
01/02/2008,California,27479147,18061461,16972015,1089446
01/02/2008,Colorado,3739334,2730710,2615827,114883
01/02/2008,Connecticut,2719672,1871046,1779792,91254
01/02/2008,Delaware,674570,450124,432276,17848
01/02/2008,Florida,14430272,9169252,8765562,403690
01/02/2008,Georgia,7154305,4877596,4604149,273447
01/02/2008,Hawaii,972875,641682,621470,20212
01/02/2008,Idaho,1126616,751556,728191,23365
01/02/2008,Illinois,9786404,6708900,6329578,379322
01/02/2008,Indiana,4860492,3225717,3071079,154638
01/02/2008,Iowa,2314422,1672496,1611271,61225
01/02/2008,Kansas,2105468,1488077,1425145,62932
01/02/2008,Kentucky,3295867,2026297,1917658,108639
01/02/2008,Louisiana,3332810,2049281,1964932,84349
01/02/2008,Maine,1060512,701507,669081,32426
01/02/2008,Maryland,4344772,3010368,2902178,108190
01/02/2008,Massachusetts,5164974,3445463,3288107,157356
01/02/2008,Michigan,7773898,4952602,4595514,357088
01/02/2008,Minnesota,4036544,2897217,2760058,137159
01/02/2008,Mississippi,2181475,1302924,1223753,79171
01/02/2008,Missouri,4560490,3063107,2897024,166083
01/02/2008,Montana,756618,510816,491021,19795
01/02/2008,Nebraska,1348302,985443,956411,29032
01/02/2008,Nevada,1964358,1366231,1291488,74743
01/02/2008,Ohio,8919307,6011252,5672357,338895
01/02/2008,Oklahoma,2732742,1727384,1670591,56793
01/02/2008,Oregon,2954500,1926271,1828799,97472
01/02/2008,Pennsylvania,9866910,6403801,6095607,308194
01/02/2008,Tennessee,4799873,3050932,2884998,165934
01/02/2008,Texas,17609205,11569544,11068110,501434
01/02/2008,Utah,1918073,1390331,1350305,40026
01/02/2008,Vermont,503793,352351,337975,14376
01/02/2008,Virginia,5900482,4097974,3947359,150615
01/02/2008,Washington,5057807,3451561,3292130,159431
01/02/2008,Wisconsin,4377602,3092050,2956324,135726
01/02/2008,Wyoming,408100,294628,286996,7632
01/03/2008,Alabama,3582052,2181312,2075441,105871
01/03/2008,Alaska,499412,353867,331722,22145
01/03/2008,Arizona,4839400,3062260,2920981,141279
01/03/2008,Arkansas,2180553,1354111,1287098,67013
01/03/2008,California,27505162,18079489,16958869,1120620
01/03/2008,Colorado,3745254,2731524,2614588,116936
01/03/2008,Connecticut,2721142,1872549,1779225,93324
01/03/2008,Delaware,675366,450558,432198,18360
01/03/2008,Florida,14439993,9169367,8745057,424310
01/03/2008,Georgia,7163749,4889427,4607194,282233
01/03/2008,Hawaii,973332,642622,621796,20826
01/03/2008,Idaho,1128349,750634,726940,23694
01/03/2008,Illinois,9791250,6703482,6317160,386322
01/03/2008,Indiana,4863316,3229511,3071330,158181
01/03/2008,Iowa,2315303,1673699,1611773,61926
01/03/2008,Kansas,2106418,1488306,1425587,62719
01/03/2008,Kentucky,3298681,2026753,1916245,110508
01/03/2008,Louisiana,3337626,2051196,1966079,85117
01/03/2008,Maine,1060902,701834,669166,32668
01/03/2008,Maryland,4346938,3014563,2903324,111239
01/03/2008,Massachusetts,5168747,3448080,3288084,159996
01/03/2008,Michigan,7772766,4943787,4583166,360621
01/03/2008,Minnesota,4039257,2898610,2759179,139431
01/03/2008,Mississippi,2182554,1301731,1221681,80050
01/03/2008,Missouri,4563774,3062698,2894477,168221
01/03/2008,Montana,757375,511130,490799,20331
01/03/2008,Nebraska,1348963,986086,956801,29285
01/03/2008,Nevada,1967341,1368224,1290616,77608
01/03/2008,Ohio,8920917,6008457,5664400,344057
01/03/2008,Oklahoma,2734661,1729075,1673464,55611
01/03/2008,Oregon,2957914,1927307,1829599,97708
01/03/2008,Pennsylvania,9870932,6410873,6099944,310929
01/03/2008,Tennessee,4804746,3052029,2881036,170993
01/03/2008,Texas,17636630,11587968,11084171,503797
01/03/2008,Utah,1921544,1390054,1349332,40722
01/03/2008,Vermont,503985,352567,337934,14633
01/03/2008,Virginia,5905631,4106722,3952938,153784
01/03/2008,Washington,5064189,3456754,3294563,162191
01/03/2008,Wisconsin,4379735,3091763,2957863,133900
01/03/2008,Wyoming,408662,295041,287354,7687
01/04/2008,Alabama,3584693,2180544,2070085,110459
01/04/2008,Alaska,499825,354642,332225,22417
01/04/2008,Arizona,4848008,3070618,2921370,149248
01/04/2008,Arkansas,2182082,1354740,1287626,67114
01/04/2008,California,27532092,18102490,16940096,1162394
01/04/2008,Colorado,3751342,2732182,2612373,119809
01/04/2008,Connecticut,2722664,1874146,1778038,96108
01/04/2008,Delaware,676171,450833,431703,19130
01/04/2008,Florida,14449961,9168749,8720582,448167
01/04/2008,Georgia,7173457,4902145,4609997,292148
01/04/2008,Hawaii,973900,643304,621515,21789
01/04/2008,Idaho,1130104,756944,725740,31204
01/04/2008,Illinois,9796390,6694126,6297079,397047
01/04/2008,Indiana,4866256,3234611,3070463,164148
01/04/2008,Iowa,2316272,1675641,1612124,63517
01/04/2008,Kansas,2107403,1489101,1425930,63171
01/04/2008,Kentucky,3301623,2028938,1914843,114095
01/04/2008,Louisiana,3342530,2053498,1967590,85908
01/04/2008,Maine,1061310,702403,669018,33385
01/04/2008,Maryland,4349192,3019372,2903305,116067
01/04/2008,Massachusetts,5172601,3451857,3287651,164206
01/04/2008,Michigan,7771825,4936116,4568466,367650
01/04/2008,Minnesota,4042105,2901263,2757878,143385
01/04/2008,Mississippi,2183705,1300119,1218522,81597
01/04/2008,Missouri,4567221,3063138,2891182,171956
01/04/2008,Montana,758116,511411,490311,21100
01/04/2008,Nebraska,1349702,986716,956899,29817
01/04/2008,Nevada,1970300,1370126,1289063,81063
01/04/2008,Ohio,8922741,6007620,5652710,354910
01/04/2008,Oklahoma,2736623,1731478,1675777,55701
01/04/2008,Oregon,2961357,1930010,1829951,100059
01/04/2008,Pennsylvania,9875143,6419243,6103469,315774
01/04/2008,Tennessee,4809741,3053781,2875899,177882
01/04/2008,Texas,17664569,11609646,11098012,511634
01/04/2008,Utah,1925126,1389475,1347866,41609
01/04/2008,Vermont,504134,352841,337854,14987
01/04/2008,Virginia,5910973,4116032,3957470,158562
01/04/2008,Washington,5070675,3463341,3296358,166983
01/04/2008,Wisconsin,4381983,3091788,2957241,134547
01/04/2008,Wyoming,409212,295452,287625,7827
01/05/2008,Alabama,3587446,2179601,2063894,115707
01/05/2008,Alaska,500225,355376,332635,22741
01/05/2008,Arizona,4856783,3080677,2921270,159407
01/05/2008,Arkansas,2183726,1355970,1287961,68009
01/05/2008,California,27559044,18131133,16917726,1213407
01/05/2008,Colorado,3757482,2733114,2609574,123540
01/05/2008,Connecticut,2724259,1875861,1776383,99478
01/05/2008,Delaware,677046,450971,430805,20166
01/05/2008,Florida,14460689,9169161,8694289,474872
01/05/2008,Georgia,7183238,4915122,4611993,303129
01/05/2008,Hawaii,974398,643618,620551,23067
01/05/2008,Idaho,1131924,760351,724589,35762
01/05/2008,Illinois,9801672,6681135,6270759,410376
01/05/2008,Indiana,4869426,3241131,3069326,171805
01/05/2008,Iowa,2317378,1678567,1612887,65680
01/05/2008,Kansas,2108535,1490277,1425962,64315
01/05/2008,Kentucky,3304688,2032389,1913311,119078
01/05/2008,Louisiana,3347495,2057291,1969706,87585
01/05/2008,Maine,1061827,703056,668592,34464
01/05/2008,Maryland,4351442,3024091,2902061,122030
01/05/2008,Massachusetts,5176718,3457054,3287296,169758
01/05/2008,Michigan,7771115,4929420,4552402,377018
01/05/2008,Minnesota,4045132,2905299,2756987,148312
01/05/2008,Mississippi,2184868,1298265,1214621,83644
01/05/2008,Missouri,4570847,3063984,2886999,176985
01/05/2008,Montana,758910,511776,489740,22036
01/05/2008,Nebraska,1350512,987230,956699,30531
01/05/2008,Nevada,1973333,1371914,1286907,85007
01/05/2008,Ohio,8924889,6009324,5639316,370008
01/05/2008,Oklahoma,2738669,1734689,1677856,56833
01/05/2008,Oregon,2965016,1935049,1830610,104439
01/05/2008,Pennsylvania,9879825,6428978,6106957,322021
01/05/2008,Tennessee,4814888,3056689,2870663,186026
01/05/2008,Texas,17692809,11635536,11109993,525543
01/05/2008,Utah,1928810,1388638,1345995,42643
01/05/2008,Vermont,504303,353179,337781,15398
01/05/2008,Virginia,5916469,4125461,3960901,164560
01/05/2008,Washington,5077412,3470993,3297939,173054
01/05/2008,Wisconsin,4384483,3092342,2955027,137315
01/05/2008,Wyoming,409806,295913,287868,8045
01/06/2008,Alabama,3590424,2178622,2057140,121482
01/06/2008,Alaska,500654,355922,332865,23057
01/06/2008,Arizona,4865847,3092028,2921092,170936
01/06/2008,Arkansas,2185440,1357843,1288251,69592
01/06/2008,California,27587706,18164654,16894388,1270266
01/06/2008,Colorado,3763867,2734443,2606433,128010
01/06/2008,Connecticut,2726025,1877881,1774721,103160
01/06/2008,Delaware,677885,451055,429649,21406
01/06/2008,Florida,14472206,9171233,8667892,503341
01/06/2008,Georgia,7193494,4928114,4612997,315117
01/06/2008,Hawaii,974980,643567,619036,24531
01/06/2008,Idaho,1133789,762381,723505,38876
01/06/2008,Illinois,9807583,6665433,6241078,424355
01/06/2008,Indiana,4872865,3248295,3068270,180025
01/06/2008,Iowa,2318576,1682183,1614205,67978
01/06/2008,Kansas,2109796,1491760,1425746,66014
01/06/2008,Kentucky,3307933,2036392,1911585,124807
01/06/2008,Louisiana,3352675,2062672,1971996,90676
01/06/2008,Maine,1062361,703584,667838,35746
01/06/2008,Maryland,4354007,3028390,2899785,128605
01/06/2008,Massachusetts,5181107,3463575,3287364,176211
01/06/2008,Michigan,7770857,4923379,4535828,387551
01/06/2008,Minnesota,4048438,2910820,2757296,153524
01/06/2008,Mississippi,2186207,1296313,1210483,85830
01/06/2008,Missouri,4574724,3064984,2882201,182783
01/06/2008,Montana,759760,512294,489229,23065
01/06/2008,Nebraska,1351414,987667,956407,31260
01/06/2008,Nevada,1976466,1373585,1284291,89294
01/06/2008,Ohio,8927562,6012507,5625793,386714
01/06/2008,Oklahoma,2740965,1738601,1679997,58604
01/06/2008,Oregon,2968804,1942229,1831696,110533
01/06/2008,Pennsylvania,9885062,6439771,6110512,329259
01/06/2008,Tennessee,4820351,3060667,2866212,194455
01/06/2008,Texas,17722244,11666163,11121171,544992
01/06/2008,Utah,1932599,1387616,1343861,43755
01/06/2008,Vermont,504558,353581,337764,15817
01/06/2008,Virginia,5922288,4134305,3963346,170959
01/06/2008,Washington,5084384,3478758,3299349,179409
01/06/2008,Wisconsin,4387249,3093969,2952277,141692
01/06/2008,Wyoming,410427,296475,288145,8330
01/07/2008,Alabama,3593293,2177334,2049897,127437
01/07/2008,Alaska,501082,356199,332941,23258
01/07/2008,Arizona,4874841,3103708,2920905,182803
01/07/2008,Arkansas,2187167,1359733,1288132,71601
01/07/2008,California,27615732,18198631,16869967,1328664
01/07/2008,Colorado,3770226,2735689,2603060,132629
01/07/2008,Connecticut,2727747,1879919,1773119,106800
01/07/2008,Delaware,678769,451063,428337,22726
01/07/2008,Florida,14483564,9172784,8640817,531967
01/07/2008,Georgia,7203540,4940633,4612633,328000
01/07/2008,Hawaii,975546,643139,617129,26010
01/07/2008,Idaho,1135675,763509,722338,41171
01/07/2008,Illinois,9813237,6647982,6211153,436829
01/07/2008,Indiana,4876173,3254256,3066171,188085
01/07/2008,Iowa,2319771,1685651,1615698,69953
01/07/2008,Kansas,2110980,1493312,1425477,67835
01/07/2008,Kentucky,3311128,2040031,1909387,130644
01/07/2008,Louisiana,3357744,2068708,1973844,94864
01/07/2008,Maine,1062884,703689,666608,37081
01/07/2008,Maryland,4356418,3031959,2896505,135454
01/07/2008,Massachusetts,5185422,3470637,3287628,183009
01/07/2008,Michigan,7770438,4916694,4517863,398831
01/07/2008,Minnesota,4051642,2916961,2758679,158282
01/07/2008,Mississippi,2187453,1293981,1206270,87711
01/07/2008,Missouri,4578539,3065820,2876896,188924
01/07/2008,Montana,760598,512944,488842,24102
01/07/2008,Nebraska,1352261,988067,956138,31929
01/07/2008,Nevada,1979594,1375054,1281173,93881
01/07/2008,Ohio,8930028,6014218,5612464,401754
01/07/2008,Oklahoma,2743144,1742674,1682136,60538
01/07/2008,Oregon,2972578,1950173,1832417,117756
01/07/2008,Pennsylvania,9890101,6450249,6112981,337268
01/07/2008,Tennessee,4825694,3064883,2862683,202200
01/07/2008,Texas,17751353,11698046,11131376,566670
01/07/2008,Utah,1936350,1386267,1341399,44868
01/07/2008,Vermont,504770,353970,337768,16202
01/07/2008,Virginia,5927975,4141385,3964430,176955
01/07/2008,Washington,5091309,3485255,3300237,185018
01/07/2008,Wisconsin,4389936,3096523,2949524,146999
01/07/2008,Wyoming,411048,297099,288449,8650
01/08/2008,Alabama,3596204,2175532,2041980,133552
01/08/2008,Alaska,502170,356256,332935,23321
01/08/2008,Arizona,4882204,3114501,2920241,194260
01/08/2008,Arkansas,2188840,1360944,1287008,73936
01/08/2008,California,27647757,18229614,16841893,1387721
01/08/2008,Colorado,3776709,2736631,2599477,137154
01/08/2008,Connecticut,2729782,1881524,1771270,110254
01/08/2008,Delaware,679481,450915,426883,24032
01/08/2008,Florida,14494359,9170735,8610848,559887
01/08/2008,Georgia,7212743,4952285,4610521,341764
01/08/2008,Hawaii,976125,642316,614884,27432
01/08/2008,Idaho,1137065,763961,720883,43078
01/08/2008,Illinois,9820037,6630290,6183599,446691
01/08/2008,Indiana,4879459,3257956,3061005,196951
01/08/2008,Iowa,2321258,1688328,1616614,71714
01/08/2008,Kansas,2112793,1494865,1425260,69605
01/08/2008,Kentucky,3312948,2042938,1906189,136749
01/08/2008,Louisiana,3360884,2074146,1974665,99481
01/08/2008,Maine,1063209,703231,664756,38475
01/08/2008,Maryland,4360469,3034819,2892074,142745
01/08/2008,Massachusetts,5190727,3477120,3287107,190013
01/08/2008,Michigan,7771436,4908296,4496904,411392
01/08/2008,Minnesota,4054892,2922523,2760026,162497
01/08/2008,Mississippi,2188782,1291079,1201959,89120
01/08/2008,Missouri,4581836,3066259,2870988,195271
01/08/2008,Montana,761268,513563,488397,25166
01/08/2008,Nebraska,1353373,988463,955768,32695
01/08/2008,Nevada,1981608,1376217,1277347,98870
01/08/2008,Ohio,8933289,6011816,5598120,413696
01/08/2008,Oklahoma,2746239,1746499,1683945,62554
01/08/2008,Oregon,2976099,1957311,1831635,125676
01/08/2008,Pennsylvania,9895782,6458730,6112327,346403
01/08/2008,Tennessee,4829913,3068290,2859187,209103
01/08/2008,Texas,17783166,11727305,11139202,588103
01/08/2008,Utah,1939685,1384255,1338357,45898
01/08/2008,Vermont,505023,354246,337699,16547
01/08/2008,Virginia,5934957,4145890,3963418,182472
01/08/2008,Washington,5099238,3489319,3299643,189676
01/08/2008,Wisconsin,4392873,3099708,2946571,153137
01/08/2008,Wyoming,411744,297673,288702,8971
01/09/2008,Alabama,3598993,2173629,2033141,140488
01/09/2008,Alaska,503222,356278,332909,23369
01/09/2008,Arizona,4889372,3123387,2917994,205393
01/09/2008,Arkansas,2190470,1361416,1284515,76901
01/09/2008,California,27679019,18257580,16805122,1452458
01/09/2008,Colorado,3783064,2737389,2595132,142257
01/09/2008,Connecticut,2731705,1882648,1768820,113828
01/09/2008,Delaware,680178,450618,425254,25364
01/09/2008,Florida,14504739,9162508,8574307,588201
01/09/2008,Georgia,7221664,4800201,4442850,357351
01/09/2008,Hawaii,976705,641210,612280,28930
01/09/2008,Idaho,1138405,764150,718961,45189
01/09/2008,Illinois,9826546,6614614,6158416,456198
01/09/2008,Indiana,4882575,3259403,3050821,208582
01/09/2008,Iowa,2322671,1689996,1616033,73963
01/09/2008,Kansas,2114526,1496707,1424974,71733
01/09/2008,Kentucky,3314652,2045566,1901351,144215
01/09/2008,Louisiana,3363894,2078215,1974007,104208
01/09/2008,Maine,1063497,702387,662212,40175
01/09/2008,Maryland,4364380,3037478,2886085,151393
01/09/2008,Massachusetts,5195775,3481923,3284012,197911
01/09/2008,Michigan,7772172,4898438,4471729,426709
01/09/2008,Minnesota,4058030,2926961,2759427,167534
01/09/2008,Mississippi,2190044,1287989,1197500,90489
01/09/2008,Missouri,4584996,3066669,2864204,202465
01/09/2008,Montana,761925,513902,487527,26375
01/09/2008,Nebraska,1354435,988765,955119,33646
01/09/2008,Nevada,1983560,1377125,1272537,104588
01/09/2008,Ohio,8936246,6004979,5579973,425006
01/09/2008,Oklahoma,2749269,1749749,1684673,65076
01/09/2008,Oregon,2979483,1962925,1828177,134748
01/09/2008,Pennsylvania,9901160,6465072,6106294,358778
01/09/2008,Tennessee,4834013,3070328,2854164,216164
01/09/2008,Texas,17814485,11751993,11141801,610192
01/09/2008,Utah,1942966,1381301,1334384,46917
01/09/2008,Vermont,505257,354355,337442,16913
01/09/2008,Virginia,5941756,4147911,3959244,188667
01/09/2008,Washington,5106981,3490731,3296178,194553
01/09/2008,Wisconsin,4395671,3103711,2942506,161205
01/09/2008,Wyoming,412444,298023,288770,9253
01/10/2008,Alabama,3601896,2172322,2023364,148958
01/10/2008,Alaska,504284,356381,332820,23561
01/10/2008,Arizona,4896695,3129730,2912892,216838
01/10/2008,Arkansas,2192094,1361363,1280596,80767
01/10/2008,California,27710666,18283764,16755408,1528356
01/10/2008,Colorado,3789510,2738037,2589291,148746
01/10/2008,Connecticut,2733733,1883668,1765753,117915
01/10/2008,Delaware,680882,450134,423297,26837
01/10/2008,Florida,14515421,9143874,8528323,615551
01/10/2008,Georgia,7230835,4763216,4387423,375793
01/10/2008,Hawaii,977292,639971,609289,30682
01/10/2008,Idaho,1139803,764450,716492,47958
01/10/2008,Illinois,9833265,6602533,6133051,469482
01/10/2008,Indiana,4885822,3259393,3034749,224644
01/10/2008,Iowa,2324167,1690958,1613479,77479
01/10/2008,Kansas,2116326,1498893,1424409,74484
01/10/2008,Kentucky,3316457,2048791,1894862,153929
01/10/2008,Louisiana,3366976,2080286,1971443,108843
01/10/2008,Maine,1063777,701476,659005,42471
01/10/2008,Maryland,4368415,3040575,2878435,162140
01/10/2008,Massachusetts,5200987,3484355,3276874,207481
01/10/2008,Michigan,7773056,4887718,4442055,445663
01/10/2008,Minnesota,4061267,2930202,2755312,174890
01/10/2008,Mississippi,2191391,1285225,1192839,92386
01/10/2008,Missouri,4588232,3067640,2856334,211306
01/10/2008,Montana,762562,513700,485834,27866
01/10/2008,Nebraska,1355531,988947,954101,34846
01/10/2008,Nevada,1985545,1377911,1266591,111320
01/10/2008,Ohio,8939361,5995207,5556150,439057
01/10/2008,Oklahoma,2752323,1752645,1683793,68852
01/10/2008,Oregon,2982987,1966958,1821021,145937
01/10/2008,Pennsylvania,9906713,6469954,6093486,376468
01/10/2008,Tennessee,4838191,3070955,2846010,224945
01/10/2008,Texas,17846170,11771507,11136874,634633
01/10/2008,Utah,1946306,1377244,1329258,47986
01/10/2008,Vermont,505508,355352,337955,17397
01/10/2008,Virginia,5948680,4148057,3951093,196964
01/10/2008,Washington,5114846,3490210,3288871,201339
01/10/2008,Wisconsin,4398555,3108572,2935774,172798
01/10/2008,Wyoming,413128,298085,288534,9551
01/11/2008,Alabama,3604408,2171630,2012593,159037
01/11/2008,Alaska,505353,356617,332618,23999
01/11/2008,Arizona,4903496,3133420,2904315,229105
01/11/2008,Arkansas,2193563,1361045,1275604,85441
01/11/2008,California,27740241,18307599,16691191,1616408
01/11/2008,Colorado,3795646,2738762,2581484,157278
01/11/2008,Connecticut,2735434,1884613,1761893,122720
01/11/2008,Delaware,681538,449376,420891,28485
01/11/2008,Florida,14524347,9117676,8472472,645204
01/11/2008,Georgia,7239404,4761050,4364135,396915
01/11/2008,Hawaii,977913,638587,605845,32742
01/11/2008,Idaho,1141084,764784,713504,51280
01/11/2008,Illinois,9839056,6594077,6104242,489835
01/11/2008,Indiana,4888584,3258489,3013159,245330
01/11/2008,Iowa,2325378,1691223,1608748,82475
01/11/2008,Kansas,2117869,1501360,1423372,77988
01/11/2008,Kentucky,3317952,2052892,1886996,165896
01/11/2008,Louisiana,3369760,2080055,1966607,113448
01/11/2008,Maine,1063982,700719,655292,45427
01/11/2008,Maryland,4372021,3044184,2869411,174773
01/11/2008,Massachusetts,5205636,3484329,3265439,218890
01/11/2008,Michigan,7773150,4876390,4409115,467275
01/11/2008,Minnesota,4064091,2932497,2747372,185125
01/11/2008,Mississippi,2192508,1282861,1187659,95202
01/11/2008,Missouri,4591041,3069076,2847323,221753
01/11/2008,Montana,763186,512832,483179,29653
01/11/2008,Nebraska,1356466,988981,952612,36369
01/11/2008,Nevada,1987408,1378359,1259504,118855
01/11/2008,Ohio,8941524,5983594,5525376,458218
01/11/2008,Oklahoma,2755121,1755374,1680966,74408
01/11/2008,Oregon,2986162,1969619,1809879,159740
01/11/2008,Pennsylvania,9911055,6472379,6072949,399430
01/11/2008,Tennessee,4841978,3069508,2832943,236565
01/11/2008,Texas,17876599,11784834,11123092,661742
01/11/2008,Utah,1949504,1371962,1322915,49047
01/11/2008,Vermont,505734,356228,338176,18052
01/11/2008,Virginia,5955076,4146700,3938595,208105
01/11/2008,Washington,5122196,3488288,3277136,211152
01/11/2008,Wisconsin,4401027,3113762,2924909,188853
01/11/2008,Wyoming,413791,298010,287926,10084
01/12/2008,Alabama,3606592,2171169,2001037,170132
01/12/2008,Alaska,506307,357004,332312,24692
01/12/2008,Arizona,4909739,3135110,2892889,242221
01/12/2008,Arkansas,2194791,1360662,1270115,90547
01/12/2008,California,27766504,18327303,16614367,1712936
01/12/2008,Colorado,3801345,2739993,2572099,167894
01/12/2008,Connecticut,2736850,1885195,1757045,128150
01/12/2008,Delaware,682121,448368,418100,30268
01/12/2008,Florida,14531697,9086029,8409554,676475
01/12/2008,Georgia,7247260,4768790,4349635,419155
01/12/2008,Hawaii,978390,637096,602094,35002
01/12/2008,Idaho,1142231,764905,710176,54729
01/12/2008,Illinois,9843756,6589361,6071369,517992
01/12/2008,Indiana,4890861,3257127,2987719,269408
01/12/2008,Iowa,2326326,1690582,1602026,88556
01/12/2008,Kansas,2119222,1504198,1421825,82373
01/12/2008,Kentucky,3319100,2057610,1878114,179496
01/12/2008,Louisiana,3372245,2078009,1959715,118294
01/12/2008,Maine,1064068,700292,651465,48827
01/12/2008,Maryland,4375176,3047840,2859476,188364
01/12/2008,Massachusetts,5209753,3482788,3251176,231612
01/12/2008,Michigan,7772501,4864371,4375398,488973
01/12/2008,Minnesota,4066483,2934202,2736774,197428
01/12/2008,Mississippi,2193422,1280995,1181857,99138
01/12/2008,Missouri,4593380,3070614,2837411,233203
01/12/2008,Montana,763677,511355,479767,31588
01/12/2008,Nebraska,1357295,988919,950668,38251
01/12/2008,Nevada,1989039,1378215,1251597,126618
01/12/2008,Ohio,8942768,5970422,5487378,483044
01/12/2008,Oklahoma,2757591,1758229,1676316,81913
01/12/2008,Oregon,2988988,1971578,1795993,175585
01/12/2008,Pennsylvania,9914426,6471599,6045617,425982
01/12/2008,Tennessee,4845237,3065036,2814331,250705
01/12/2008,Texas,17904835,11791925,11101977,689948
01/12/2008,Utah,1952476,1388245,1315656,72589
01/12/2008,Vermont,505873,357013,338155,18858
01/12/2008,Virginia,5960915,4144520,3922612,221908
01/12/2008,Washington,5129048,3485137,3261532,223605
01/12/2008,Wisconsin,4402985,3118667,2909875,208792
01/12/2008,Wyoming,414409,298049,287005,11044
01/01/2009,Alabama,3608960,2170615,1989308,181307
01/01/2009,Alaska,507364,357527,331939,25588
01/01/2009,Arizona,4916200,3135245,2879700,255545
01/01/2009,Arkansas,2196134,1360180,1264593,95587
01/01/2009,California,27794667,18341252,16530013,1811239
01/01/2009,Colorado,3807212,2741783,2561844,179939
01/01/2009,Connecticut,2738401,1885168,1751324,133844
01/01/2009,Delaware,682762,447205,415103,32102
01/01/2009,Florida,14539769,9052178,8343928,708250
01/01/2009,Georgia,7255557,4778508,4337640,440868
01/01/2009,Hawaii,978992,635569,598286,37283
01/01/2009,Idaho,1143426,764671,706733,57938
01/01/2009,Illinois,9849030,6588346,6037014,551332
01/01/2009,Indiana,4893292,3256297,2961664,294633
01/01/2009,Iowa,2327391,1689096,1594063,95033
01/01/2009,Kansas,2120640,1507169,1419811,87358
01/01/2009,Kentucky,3320357,2062601,1868875,193726
01/01/2009,Louisiana,3374902,2075125,1951613,123512
01/01/2009,Maine,1064171,700203,647898,52305
01/01/2009,Maryland,4378599,3051111,2849401,201710
01/01/2009,Massachusetts,5214072,3480717,3236069,244648
01/01/2009,Michigan,7772160,4875359,4342294,533065
01/01/2009,Minnesota,4068989,2935506,2725000,210506
01/01/2009,Mississippi,2194462,1279561,1175741,103820
01/01/2009,Missouri,4595874,3072024,2827112,244912
01/01/2009,Montana,764203,509478,476051,33427
01/01/2009,Nebraska,1358167,988763,948435,40328
01/01/2009,Nevada,1990788,1377435,1243320,134115
01/01/2009,Ohio,8944394,5956344,5444780,511564
01/01/2009,Oklahoma,2760215,1761587,1670671,90916
01/01/2009,Oregon,2991928,1973386,1781451,191935
01/01/2009,Pennsylvania,9918169,6467790,6014392,453398
01/01/2009,Tennessee,4848693,3057747,2791562,266185
01/01/2009,Texas,17934287,11794357,11077513,716844
01/01/2009,Utah,1955576,1392634,1307934,84700
01/01/2009,Vermont,506066,357735,337995,19740
01/01/2009,Virginia,5967043,4142432,3905221,237211
01/01/2009,Washington,5136093,3480693,3243615,237078
01/01/2009,Wisconsin,4405116,3122945,2892187,230758
01/01/2009,Wyoming,415020,298360,285891,12469
01/02/2009,Alabama,3611025,2169888,1978083,191805
01/02/2009,Alaska,508336,358159,331565,26594
01/02/2009,Arizona,4922302,3134718,2866239,268479
01/02/2009,Arkansas,2197249,1359814,1259658,100156
01/02/2009,California,27820364,18350557,16445664,1904893
01/02/2009,Colorado,3812882,2743809,2551450,192359
01/02/2009,Connecticut,2739720,1885022,1745553,139469
01/02/2009,Delaware,683309,445924,412069,33855
01/02/2009,Florida,14546500,9020030,8280792,739238
01/02/2009,Georgia,7263209,4787926,4326851,461075
01/02/2009,Hawaii,979422,634151,594807,39344
01/02/2009,Idaho,1144528,764044,703500,60544
01/02/2009,Illinois,9853542,6591950,6005570,586380
01/02/2009,Indiana,4895465,3255885,2937994,317891
01/02/2009,Iowa,2328279,1687015,1585947,101068
01/02/2009,Kansas,2121939,1510355,1417552,92803
01/02/2009,Kentucky,3321451,2067583,1860303,207280
01/02/2009,Louisiana,3377231,2072767,1943568,129199
01/02/2009,Maine,1064193,700270,644828,55442
01/02/2009,Maryland,4381626,3053799,2840168,213631
01/02/2009,Massachusetts,5218090,3478984,3221939,257045
01/02/2009,Michigan,7771192,4885037,4310659,574378
01/02/2009,Minnesota,4071329,2936857,2714157,222700
01/02/2009,Mississippi,2195299,1278354,1169822,108532
01/02/2009,Missouri,4598092,3073323,2817179,256144
01/02/2009,Montana,764676,507574,472644,34930
01/02/2009,Nebraska,1358954,988607,946270,42337
01/02/2009,Nevada,1992370,1376206,1235176,141030
01/02/2009,Ohio,8945406,5942920,5402230,540690
01/02/2009,Oklahoma,2762668,1765678,1665415,100263
01/02/2009,Oregon,2994706,1975379,1768747,206632
01/02/2009,Pennsylvania,9921186,6462229,5983557,478672
01/02/2009,Tennessee,4851827,3049266,2767661,281605
01/02/2009,Texas,17962241,11795821,11055073,740748
01/02/2009,Utah,1958558,1391346,1300274,91072
01/02/2009,Vermont,506207,358464,337853,20611
01/02/2009,Virginia,5972693,4141054,3888770,252284
01/02/2009,Washington,5142825,3474872,3225423,249449
01/02/2009,Wisconsin,4407013,3126622,2874456,252166
01/02/2009,Wyoming,415658,298950,284717,14233
01/03/2009,Alabama,3613034,2168962,1968035,200927
01/03/2009,Alaska,509304,358815,331287,27528
01/03/2009,Arizona,4928269,3134761,2854602,280159
01/03/2009,Arkansas,2198385,1359655,1255912,103743
01/03/2009,California,27845224,18357115,16370975,1986140
01/03/2009,Colorado,3818492,2745639,2541992,203647
01/03/2009,Connecticut,2741025,1885758,1741164,144594
01/03/2009,Delaware,683851,444546,409245,35301
01/03/2009,Florida,14553015,8993087,8226093,766994
01/03/2009,Georgia,7270704,4796410,4318122,478288
01/03/2009,Hawaii,979839,633015,592076,40939
01/03/2009,Idaho,1145653,763045,700851,62194
01/03/2009,Illinois,9857938,6599816,5981260,618556
01/03/2009,Indiana,4897589,3254065,2918351,335714
01/03/2009,Iowa,2329173,1684717,1578852,105865
01/03/2009,Kansas,2123219,1513752,1415542,98210
01/03/2009,Kentucky,3322520,2071976,1853366,218610
01/03/2009,Louisiana,3379507,2072027,1936935,135092
01/03/2009,Maine,1064236,700301,642493,57808
01/03/2009,Maryland,4384547,3055887,2832928,222959
01/03/2009,Massachusetts,5222100,3478298,3210588,267710
01/03/2009,Michigan,7770196,4893566,4282346,611220
01/03/2009,Minnesota,4073662,2938667,2706532,232135
01/03/2009,Mississippi,2196101,1277088,1164570,112518
01/03/2009,Missouri,4600232,3074303,2808736,265567
01/03/2009,Montana,765161,505944,470036,35908
01/03/2009,Nebraska,1359717,988641,944615,44026
01/03/2009,Nevada,1993918,1374816,1227786,147030
01/03/2009,Ohio,8946406,5931002,5364822,566180
01/03/2009,Oklahoma,2765042,1770364,1661702,108662
01/03/2009,Oregon,2997399,1977117,1759644,217473
01/03/2009,Pennsylvania,9924198,6455797,5956881,498916
01/03/2009,Tennessee,4854945,3041270,2746230,295040
01/03/2009,Texas,17989636,11799261,11040416,758845
01/03/2009,Utah,1961510,1387931,1293342,94589
01/03/2009,Vermont,506354,359307,337951,21356
01/03/2009,Virginia,5978215,4140763,3875758,265005
01/03/2009,Washington,5149512,3467544,3209014,258530
01/03/2009,Wisconsin,4408918,3129930,2859606,270324
01/03/2009,Wyoming,416274,299720,283647,16073
01/04/2009,Alabama,3615107,2167672,1959272,208400
01/04/2009,Alaska,510314,359404,331163,28241
01/04/2009,Arizona,4934381,3135697,2845709,289988
01/04/2009,Arkansas,2199548,1359293,1253369,105924
01/04/2009,California,27871138,18360253,16310052,2050201
01/04/2009,Colorado,3824191,2746627,2534133,212494
01/04/2009,Connecticut,2742384,1887457,1738492,148965
01/04/2009,Delaware,684422,443075,406789,36286
01/04/2009,Florida,14559741,8974062,8182726,791336
01/04/2009,Georgia,7278430,4803528,4311940,491588
01/04/2009,Hawaii,980298,632282,590308,41974
01/04/2009,Idaho,1146825,761716,698919,62797
01/04/2009,Illinois,9862551,6609226,5964724,644502
01/04/2009,Indiana,4899811,3249511,2903308,346203
01/04/2009,Iowa,2330117,1682539,1573692,108847
01/04/2009,Kansas,2124509,1517037,1414106,102931
01/04/2009,Kentucky,3323639,2074923,1848460,226463
01/04/2009,Louisiana,3381899,2072391,1932168,140223
01/04/2009,Maine,1064283,700192,640979,59213
01/04/2009,Maryland,4387555,3057218,2828165,229053
01/04/2009,Massachusetts,5226156,3478483,3202508,275975
01/04/2009,Michigan,7769346,4900321,4257967,642354
01/04/2009,Minnesota,4076031,2940298,2702508,237790
01/04/2009,Mississippi,2196932,1275427,1160113,115314
01/04/2009,Missouri,4602491,3074803,2802257,272546
01/04/2009,Montana,765637,504683,468374,36309
01/04/2009,Nebraska,1360520,989011,943699,45312
01/04/2009,Nevada,1995501,1373429,1221385,152044
01/04/2009,Ohio,8947541,5920506,5335602,584904
01/04/2009,Oklahoma,2767495,1774985,1659766,115219
01/04/2009,Oregon,3000182,1977826,1754553,223273
01/04/2009,Pennsylvania,9927312,6448142,5935194,512948
01/04/2009,Tennessee,4858086,3034647,2729517,305130
01/04/2009,Texas,18017597,11805364,11035746,769618
01/04/2009,Utah,1964512,1384192,1287412,96780
01/04/2009,Vermont,506480,359755,337870,21885
01/04/2009,Virginia,5983942,4141347,3867062,274285
01/04/2009,Washington,5156239,3467492,3195574,271918
01/04/2009,Wisconsin,4410843,3132217,2848985,283232
01/04/2009,Wyoming,416861,300461,282792,17669
01/05/2009,Alabama,3617361,2165514,1950906,214608
01/05/2009,Alaska,511330,359892,331161,28731
01/05/2009,Arizona,4940746,3136601,2838286,298315
01/05/2009,Arkansas,2200846,1358162,1251338,106824
01/05/2009,California,27897359,18356368,16257221,2099147
01/05/2009,Colorado,3830099,2745488,2527186,218302
01/05/2009,Connecticut,2743885,1889319,1736551,152768
01/05/2009,Delaware,684993,441440,404596,36844
01/05/2009,Florida,14567324,8990744,8148166,842578
01/05/2009,Georgia,7286426,4807998,4306652,501346
01/05/2009,Hawaii,980763,631952,589386,42566
01/05/2009,Idaho,1148040,765242,697495,67747
01/05/2009,Illinois,9867563,6616824,5952614,664210
01/05/2009,Indiana,4902376,3241440,2891493,349947
01/05/2009,Iowa,2331259,1680503,1570351,110152
01/05/2009,Kansas,2125995,1519576,1412960,106616
01/05/2009,Kentucky,3325013,2075708,1844941,230767
01/05/2009,Louisiana,3384370,2072526,1928778,143748
01/05/2009,Maine,1064444,699741,639964,59777
01/05/2009,Maryland,4390739,3057191,2824833,232358
01/05/2009,Massachusetts,5230561,3478354,3196305,282049
01/05/2009,Michigan,7768973,4904363,4236418,667945
01/05/2009,Minnesota,4078760,2940428,2700525,239903
01/05/2009,Mississippi,2197842,1272969,1155919,117050
01/05/2009,Missouri,4605119,3074117,2796764,277353
01/05/2009,Montana,766208,503645,467389,36256
01/05/2009,Nebraska,1361436,989500,943261,46239
01/05/2009,Nevada,1997181,1371955,1215496,156459
01/05/2009,Ohio,8949202,5910747,5313941,596806
01/05/2009,Oklahoma,2770103,1778265,1658576,119689
01/05/2009,Oregon,3003209,1976717,1752493,224224
01/05/2009,Pennsylvania,9931122,6437627,5916119,521508
01/05/2009,Tennessee,4861579,3029350,2717680,311670
01/05/2009,Texas,18046180,11933809,11037541,896268
01/05/2009,Utah,1967728,1380535,1282005,98530
01/05/2009,Vermont,506662,361124,338923,22201
01/05/2009,Virginia,5989932,4141603,3861057,280546
01/05/2009,Washington,5163366,3466388,3185132,281256
01/05/2009,Wisconsin,4413190,3131940,2841498,290442
01/05/2009,Wyoming,417505,300897,282070,18827
01/06/2009,Alabama,3619629,2162128,1942142,219986
01/06/2009,Alaska,512325,360268,331193,29075
01/06/2009,Arizona,4947208,3136757,2831102,305655
01/06/2009,Arkansas,2202154,1356219,1249384,106835
01/06/2009,California,27924313,18344271,16206712,2137559
01/06/2009,Colorado,3836067,2741685,2520583,221102
01/06/2009,Connecticut,2745421,1890959,1734700,156259
01/06/2009,Delaware,685612,439569,402469,37100
01/06/2009,Florida,14575145,8991320,8119224,872096
01/06/2009,Georgia,7294421,4809047,4300595,508452
01/06/2009,Hawaii,981229,631868,588993,42875
01/06/2009,Idaho,1149304,765973,696379,69594
01/06/2009,Illinois,9872670,6620584,5941437,679147
01/06/2009,Indiana,4904977,3229982,2881080,348902
01/06/2009,Iowa,2332447,1678718,1568344,110374
01/06/2009,Kansas,2127510,1520649,1411631,109018
01/06/2009,Kentucky,3326417,2074132,1841907,232225
01/06/2009,Louisiana,3386911,2071821,1926334,145487
01/06/2009,Maine,1064612,698904,639123,59781
01/06/2009,Maryland,4393922,3055637,2821735,233902
01/06/2009,Massachusetts,5235023,3477099,3190727,286372
01/06/2009,Michigan,7768604,4905950,4216979,688971
01/06/2009,Minnesota,4081532,2938602,2699072,239530
01/06/2009,Mississippi,2198782,1269700,1151486,118214
01/06/2009,Missouri,4607694,3071762,2791064,280698
01/06/2009,Montana,766762,502704,466739,35965
01/06/2009,Nebraska,1362376,989738,942897,46841
01/06/2009,Nevada,1998890,1370321,1209700,160621
01/06/2009,Ohio,8950933,5902027,5297717,604310
01/06/2009,Oklahoma,2772778,1779326,1657117,122209
01/06/2009,Oregon,3006279,1973627,1752128,221499
01/06/2009,Pennsylvania,9935005,6423159,5897683,525476
01/06/2009,Tennessee,4865073,3025629,2710361,315268
01/06/2009,Texas,18075211,11998393,11041350,957043
01/06/2009,Utah,1970908,1376948,1276697,100251
01/06/2009,Vermont,506890,360821,338444,22377
01/06/2009,Virginia,5995931,4140712,3855929,284783
01/06/2009,Washington,5170538,3464827,3176939,287888
01/06/2009,Wisconsin,4415500,3128053,2835423,292630
01/06/2009,Wyoming,418196,300868,281384,19484
01/07/2009,Alabama,3622181,2157556,1932774,224782
01/07/2009,Alaska,513402,360424,331095,29329
01/07/2009,Arizona,4953939,3135266,2823229,312037
01/07/2009,Arkansas,2203656,1353772,1247347,106425
01/07/2009,California,27952375,18323390,16154640,2168750
01/07/2009,Colorado,3842322,2735370,2513522,221848
01/07/2009,Connecticut,2747122,1891930,1732321,159609
01/07/2009,Delaware,686254,437522,400274,37248
01/07/2009,Florida,14583822,8985929,8092905,893024
01/07/2009,Georgia,7302994,4806283,4292715,513568
01/07/2009,Hawaii,981756,631704,588669,43035
01/07/2009,Idaho,1150638,765397,695387,70010
01/07/2009,Illinois,9878410,6618475,5927060,691415
01/07/2009,Indiana,4907917,3216060,2870731,345329
01/07/2009,Iowa,2333773,1676953,1566823,110130
01/07/2009,Kansas,2129150,1519761,1409610,110151
01/07/2009,Kentucky,3328074,2070370,1838771,231599
01/07/2009,Louisiana,3389686,2069984,1924210,145774
01/07/2009,Maine,1064870,697805,638257,59548
01/07/2009,Maryland,4397413,3052760,2818008,234752
01/07/2009,Massachusetts,5239849,3474026,3184659,289367
01/07/2009,Michigan,7768829,4881546,4199503,682043
01/07/2009,Minnesota,4084586,2935063,2697239,237824
01/07/2009,Mississippi,2199851,1266095,1146754,119341
01/07/2009,Missouri,4610651,3067274,2784144,283130
01/07/2009,Montana,767393,501734,466047,35687
01/07/2009,Nebraska,1363415,989444,942248,47196
01/07/2009,Nevada,2000720,1368177,1203710,164467
01/07/2009,Ohio,8953337,5894470,5283917,610553
01/07/2009,Oklahoma,2775621,1777772,1654657,123115
01/07/2009,Oregon,3009552,1969041,1752029,217012
01/07/2009,Pennsylvania,9939596,6403921,5878278,525643
01/07/2009,Tennessee,4868936,3023463,2706513,316950
01/07/2009,Texas,18105139,12027290,11042872,984418
01/07/2009,Utah,1974253,1373141,1271180,101961
01/07/2009,Vermont,507115,360377,337862,22515
01/07/2009,Virginia,6002403,4138354,3850155,288199
01/07/2009,Washington,5178070,3463333,3169356,293977
01/07/2009,Wisconsin,4418188,3120387,2828900,291487
01/07/2009,Wyoming,418865,300467,280658,19809
01/08/2009,Alabama,3624837,2152222,1923196,229026
01/08/2009,Alaska,513656,360299,330803,29496
01/08/2009,Arizona,4961060,3131513,2814158,317355
01/08/2009,Arkansas,2205479,1351081,1245167,105914
01/08/2009,California,27986270,18295071,16100602,2194469
01/08/2009,Colorado,3847562,2727247,2505320,221927
01/08/2009,Connecticut,2749085,1891764,1728836,162928
01/08/2009,Delaware,686972,435435,398014,37421
01/08/2009,Florida,14599431,8978345,8067438,910907
01/08/2009,Georgia,7312496,4799902,4282945,516957
01/08/2009,Hawaii,982384,631317,588153,43164
01/08/2009,Idaho,1151866,764334,694403,69931
01/08/2009,Illinois,9884709,6610820,5907507,703313
01/08/2009,Indiana,4911180,3201118,2860122,340996
01/08/2009,Iowa,2335284,1674750,1565031,109719
01/08/2009,Kansas,2130871,1516989,1406736,110253
01/08/2009,Kentucky,3330802,2064926,1835411,229515
01/08/2009,Louisiana,3392730,2067196,1921831,145365
01/08/2009,Maine,1065143,696562,637239,59323
01/08/2009,Maryland,4401975,3048938,2813403,235535
01/08/2009,Massachusetts,5244207,3469286,3177920,291366
01/08/2009,Michigan,7770891,4856487,4184303,672184
01/08/2009,Minnesota,4087541,2930548,2694937,235611
01/08/2009,Mississippi,2201059,1262789,1141924,120865
01/08/2009,Missouri,4613947,3060731,2775832,284899
01/08/2009,Montana,767959,500707,465128,35579
01/08/2009,Nebraska,1364635,988595,941206,47389
01/08/2009,Nevada,2002267,1365329,1197462,167867
01/08/2009,Ohio,8956374,5888132,5270650,617482
01/08/2009,Oklahoma,2778180,1773942,1650963,122979
01/08/2009,Oregon,3012625,1963985,1751276,212709
01/08/2009,Pennsylvania,9945029,6380840,5857656,523184
01/08/2009,Tennessee,4873515,3022770,2705032,317738
01/08/2009,Texas,18134768,12035941,11040880,995061
01/08/2009,Utah,1977352,1368895,1265371,103524
01/08/2009,Vermont,507430,359802,337117,22685
01/08/2009,Virginia,6009725,4134913,3843174,291739
01/08/2009,Washington,5185004,3462571,3161327,301244
01/08/2009,Wisconsin,4420667,3110072,2820936,289136
01/08/2009,Wyoming,419192,299950,279871,20079
01/09/2009,Alabama,3627477,2146808,1914421,232387
01/09/2009,Alaska,513872,360018,330431,29587
01/09/2009,Arizona,4968072,3126346,2804614,321732
01/09/2009,Arkansas,2207281,1348368,1242864,105504
01/09/2009,California,28019194,18266064,16049842,2216222
01/09/2009,Colorado,3852743,2718739,2496342,222397
01/09/2009,Connecticut,2751032,1890575,1724297,166278
01/09/2009,Delaware,687690,433494,395820,37674
01/09/2009,Florida,14615000,8971805,8044442,927363
01/09/2009,Georgia,7321947,4791624,4272839,518785
01/09/2009,Hawaii,982979,630905,587593,43312
01/09/2009,Idaho,1153087,763191,693446,69745
01/09/2009,Illinois,9890904,6601019,5885181,715838
01/09/2009,Indiana,4914475,3187111,2849830,337281
01/09/2009,Iowa,2336799,1671946,1562768,109178
01/09/2009,Kansas,2132592,1513022,1403365,109657
01/09/2009,Kentucky,3333496,2059145,1832168,226977
01/09/2009,Louisiana,3395772,2064076,1919181,144895
01/09/2009,Maine,1065440,695385,636129,59256
01/09/2009,Maryland,4406548,3044831,2808298,236533
01/09/2009,Massachusetts,5248524,3464412,3171810,292602
01/09/2009,Michigan,7772966,4832672,4171972,660700
01/09/2009,Minnesota,4090504,2926112,2692908,233204
01/09/2009,Mississippi,2202315,1260410,1137403,123007
01/09/2009,Missouri,4617243,3053430,2767093,286337
01/09/2009,Montana,768524,499791,464097,35694
01/09/2009,Nebraska,1365808,987507,939966,47541
01/09/2009,Nevada,2003771,1362186,1191275,170911
01/09/2009,Ohio,8959495,5883486,5257988,625498
01/09/2009,Oklahoma,2780669,1769326,1646669,122657
01/09/2009,Oregon,3015664,1959776,1750074,209702
01/09/2009,Pennsylvania,9950472,6357890,5837681,520209
01/09/2009,Tennessee,4878100,3023659,2705490,318169
01/09/2009,Texas,18163851,12036191,11038831,997360
01/09/2009,Utah,1980374,1364462,1259612,104850
01/09/2009,Vermont,507724,359182,336279,22903
01/09/2009,Virginia,6017014,4131421,3835560,295861
01/09/2009,Washington,5191902,3463071,3152726,310345
01/09/2009,Wisconsin,4423136,3099185,2812227,286958
01/09/2009,Wyoming,419500,299610,279101,20509
01/10/2009,Alabama,3630337,2142208,1907643,234565
01/10/2009,Alaska,514133,359711,330034,29677
01/10/2009,Arizona,4975352,3120895,2795851,325044
01/10/2009,Arkansas,2209199,1345775,1240400,105375
01/10/2009,California,28053709,18243355,16007637,2235718
01/10/2009,Colorado,3858144,2711692,2487400,224292
01/10/2009,Connecticut,2753149,1888815,1719152,169663
01/10/2009,Delaware,688459,431859,393847,38012
01/10/2009,Florida,14631311,8968645,8026138,942507
01/10/2009,Georgia,7331829,4783230,4264115,519115
01/10/2009,Hawaii,983622,630679,587205,43474
01/10/2009,Idaho,1154366,762147,692584,69563
01/10/2009,Illinois,9897655,6593339,5864865,728474
01/10/2009,Indiana,4918039,3175581,2840309,335272
01/10/2009,Iowa,2338466,1668747,1560093,108654
01/10/2009,Kansas,2134462,1508787,1399911,108876
01/10/2009,Kentucky,3336401,2054515,1829565,224950
01/10/2009,Louisiana,3398961,2061211,1916572,144639
01/10/2009,Maine,1065788,694561,635139,59422
01/10/2009,Maryland,4411347,3041386,2803176,238210
01/10/2009,Massachusetts,5253091,3460868,3167575,293293
01/10/2009,Michigan,7775455,4811810,4162184,649626
01/10/2009,Minnesota,4093670,2922698,2691628,231070
01/10/2009,Mississippi,2203668,1259466,1133784,125682
01/10/2009,Missouri,4620808,3046720,2759008,287712
01/10/2009,Montana,769146,499149,463140,36009
01/10/2009,Nebraska,1367090,986531,938727,47804
01/10/2009,Nevada,2005462,1359279,1185525,173754
01/10/2009,Ohio,8963041,5880324,5245920,634404
01/10/2009,Oklahoma,2783333,1765197,1642579,122618
01/10/2009,Oregon,3018895,1957509,1749082,208427
01/10/2009,Pennsylvania,9956445,6339102,5820126,518976
01/10/2009,Tennessee,4882981,3025771,2707285,318486
01/10/2009,Texas,18194118,12036269,11040270,995999
01/10/2009,Utah,1983529,1360205,1254310,105895
01/10/2009,Vermont,508094,358651,335482,23169
01/10/2009,Virginia,6024651,4128934,3828154,300780
01/10/2009,Washington,5199075,3456236,3143906,312330
01/10/2009,Wisconsin,4425882,3089933,2804121,285812
01/10/2009,Wyoming,419851,299628,278438,21190
01/11/2009,Alabama,3632553,2139947,1904011,235936
01/11/2009,Alaska,514325,359647,329798,29849
01/11/2009,Arizona,4981854,3116842,2789383,327459
01/11/2009,Arkansas,2210757,1343857,1238191,105666
01/11/2009,California,28084234,18237262,15981193,2256069
01/11/2009,Colorado,3862938,2708033,2479744,228289
01/11/2009,Connecticut,2754731,1887858,1714686,173172
01/11/2009,Delaware,689092,430762,392346,38416
01/11/2009,Florida,14645036,8973003,8016095,956908
01/11/2009,Georgia,7340523,4777540,4258854,518686
01/11/2009,Hawaii,984262,631046,587373,43673
01/11/2009,Idaho,1155469,761632,692099,69533
01/11/2009,Illinois,9902704,6592973,5852392,740581
01/11/2009,Indiana,4920671,3168554,2833101,335453
01/11/2009,Iowa,2339640,1666336,1558033,108303
01/11/2009,Kansas,2135884,1505314,1396912,108402
01/11/2009,Kentucky,3338735,2052571,1828591,223980
01/11/2009,Louisiana,3401585,2059990,1915071,144919
01/11/2009,Maine,1065945,694427,634580,59847
01/11/2009,Maryland,4415406,3040505,2799603,240902
01/11/2009,Massachusetts,5256717,3460102,3166227,293875
01/11/2009,Michigan,7776472,4796531,4155159,641372
01/11/2009,Minnesota,4096104,2921699,2692020,229679
01/11/2009,Mississippi,2204638,1260322,1131805,128517
01/11/2009,Missouri,4623522,3042320,2752712,289608
01/11/2009,Montana,769618,498984,462518,36466
01/11/2009,Nebraska,1368134,986060,937863,48197
01/11/2009,Nevada,2006744,1357494,1180770,176724
01/11/2009,Ohio,8964826,5880807,5236980,643827
01/11/2009,Oklahoma,2785467,1762634,1639789,122845
01/11/2009,Oregon,3021588,1958343,1749369,208974
01/11/2009,Pennsylvania,9960433,6328965,5807933,521032
01/11/2009,Tennessee,4886991,3030297,2711254,319043
01/11/2009,Texas,18221759,12045372,11050184,995188
01/11/2009,Utah,1986362,1356818,1250061,106757
01/11/2009,Vermont,508329,358407,334938,23469
01/11/2009,Virginia,6031267,4129176,3822838,306338
01/11/2009,Washington,5205382,3451994,3136631,315363
01/11/2009,Wisconsin,4427819,3084461,2798737,285724
01/11/2009,Wyoming,420108,300001,278031,21970
01/12/2009,Alabama,3634419,2140674,1903811,236863
01/12/2009,Alaska,514467,359932,329829,30103
01/12/2009,Arizona,4987853,3115241,2785895,329346
01/12/2009,Arkansas,2212101,1343147,1236853,106294
01/12/2009,California,28111925,18254035,15975922,2278113
01/12/2009,Colorado,3867378,2708249,2474419,233830
01/12/2009,Connecticut,2756043,1889075,1712315,176760
01/12/2009,Delaware,689720,430322,391519,38803
01/12/2009,Florida,14657213,8987807,8017476,970331
01/12/2009,Georgia,7348529,4776286,4258241,518045
01/12/2009,Hawaii,984741,632327,588446,43881
01/12/2009,Idaho,1156479,761927,692251,69676
01/12/2009,Illinois,9906794,6601820,5851687,750133
01/12/2009,Indiana,4922905,3167003,2829818,337185
01/12/2009,Iowa,2340638,1666046,1557898,108148
01/12/2009,Kansas,2137157,1503151,1394859,108292
01/12/2009,Kentucky,3340801,2053885,1829926,223959
01/12/2009,Louisiana,3403890,2061538,1915554,145984
01/12/2009,Maine,1066053,695077,634656,60421
01/12/2009,Maryland,4419022,3043485,2799405,244080
01/12/2009,Massachusetts,5259886,3462787,3168295,294492
01/12/2009,Michigan,7776809,4788182,4151879,636303
01/12/2009,Minnesota,4098214,2923951,2694944,229007
01/12/2009,Mississippi,2205398,1262711,1131753,130958
01/12/2009,Missouri,4625852,3041155,2749112,292043
01/12/2009,Montana,770036,499358,462376,36982
01/12/2009,Nebraska,1369023,986333,937752,48581
01/12/2009,Nevada,2007872,1357344,1177391,179953
01/12/2009,Ohio,8965878,5886389,5234320,652069
01/12/2009,Oklahoma,2787381,1762250,1639144,123106
01/12/2009,Oregon,3023994,1962640,1751681,210959
01/12/2009,Pennsylvania,9963526,6329739,5803095,526644
01/12/2009,Tennessee,4890561,3038713,2718884,319829
01/12/2009,Texas,18247563,12070223,11072620,997603
01/12/2009,Utah,1989021,1354784,1247251,107533
01/12/2009,Vermont,508622,358555,334803,23752
01/12/2009,Virginia,6037319,4132983,3821237,311746
01/12/2009,Washington,5211219,3451532,3132862,318670
01/12/2009,Wisconsin,4429332,3083749,2797682,286067
01/12/2009,Wyoming,420366,300619,277989,22630
01/01/2010,Alabama,3636380,2143297,1906185,237112
01/01/2010,Alaska,514628,360431,330113,30318
01/01/2010,Arizona,4994110,3115797,2785351,330446
01/01/2010,Arkansas,2213503,1343957,1237151,106806
01/01/2010,California,28141513,18288466,15991766,2296700
01/01/2010,Colorado,3871967,2711291,2471793,239498
01/01/2010,Connecticut,2757497,1892594,1712632,179962
01/01/2010,Delaware,690331,430527,391523,39004
01/01/2010,Florida,14670087,9011633,8031055,980578
01/01/2010,Georgia,7356794,4778162,4261834,516328
01/01/2010,Hawaii,985330,634566,590573,43993
01/01/2010,Idaho,1157503,762726,693074,69652
01/01/2010,Illinois,9911282,6616172,5862132,754040
01/01/2010,Indiana,4925217,3169128,2830634,338494
01/01/2010,Iowa,2341680,1668161,1560395,107766
01/01/2010,Kansas,2138455,1502302,1394052,108250
01/01/2010,Kentucky,3342861,2057265,1833428,223837
01/01/2010,Louisiana,3406282,2065893,1918232,147661
01/01/2010,Maine,1066138,696250,635414,60836
01/01/2010,Maryland,4422798,3049772,2803421,246351
01/01/2010,Massachusetts,5263246,3468119,3173610,294509
01/01/2010,Michigan,7777357,4785142,4153410,631732
01/01/2010,Minnesota,4100422,2928681,2700412,228269
01/01/2010,Mississippi,2206254,1265805,1133350,132455
01/01/2010,Missouri,4628246,3042296,2748478,293818
01/01/2010,Montana,770491,500111,462743,37368
01/01/2010,Nebraska,1370014,987372,938545,48827
01/01/2010,Nevada,2009168,1358406,1175465,182941
01/01/2010,Ohio,8967104,5895027,5238928,656099
01/01/2010,Oklahoma,2789349,1763483,1640540,122943
01/01/2010,Oregon,3026512,1969690,1756262,213428
01/01/2010,Pennsylvania,9966890,6338833,5805453,533380
01/01/2010,Tennessee,4894242,3050578,2730789,319789
01/01/2010,Texas,18274485,12108919,11106882,1002037
01/01/2010,Utah,1991747,1354098,1245935,108163
01/01/2010,Vermont,508821,359006,335086,23920
01/01/2010,Virginia,6043575,4139523,3823909,315614
01/01/2010,Washington,5217186,3454420,3133335,321085
01/01/2010,Wisconsin,4430954,3086454,2800945,285509
01/01/2010,Wyoming,420608,301350,278343,23007
01/02/2010,Alabama,3637985,2145780,1909481,236299
01/02/2010,Alaska,514760,360957,330579,30378
01/02/2010,Arizona,4999841,3116749,2786396,330353
01/02/2010,Arkansas,2214703,1345947,1239114,106833
01/02/2010,California,28168472,18327194,16020128,2307066
01/02/2010,Colorado,3876247,2714852,2471124,243728
01/02/2010,Connecticut,2758668,1897276,1714982,182294
01/02/2010,Delaware,690834,431248,392300,38948
01/02/2010,Florida,14681071,9039135,8052755,986380
01/02/2010,Georgia,7364379,4725950,4213413,512537
01/02/2010,Hawaii,985714,637461,593468,43993
01/02/2010,Idaho,1158417,763525,694203,69322
01/02/2010,Illinois,9914870,6628765,5878039,750726
01/02/2010,Indiana,4927158,3172852,2834812,338040
01/02/2010,Iowa,2342488,1671781,1564951,106830
01/02/2010,Kansas,2139596,1502043,1394188,107855
01/02/2010,Kentucky,3344688,2060696,1838044,222652
01/02/2010,Louisiana,3408339,2071784,1922452,149332
01/02/2010,Maine,1066067,697409,636533,60876
01/02/2010,Maryland,4426148,3057423,2810540,246883
01/02/2010,Massachusetts,5266159,3473982,3180656,293326
01/02/2010,Michigan,7777182,4784327,4158820,625507
01/02/2010,Minnesota,4102269,2933933,2707327,226606
01/02/2010,Mississippi,2206814,1268874,1135839,133035
01/02/2010,Missouri,4630244,3043869,2749657,294212
01/02/2010,Montana,770816,500923,463419,37504
01/02/2010,Nebraska,1370817,988776,939919,48857
01/02/2010,Nevada,2010225,1359771,1174541,185230
01/02/2010,Ohio,8967563,5902220,5248612,653608
01/02/2010,Oklahoma,2791092,1765258,1643105,122153
01/02/2010,Oregon,3028729,1977638,1762239,215399
01/02/2010,Pennsylvania,9969289,6350528,5812330,538198
01/02/2010,Tennessee,4897491,3063620,2745903,317717
01/02/2010,Texas,18299762,12151988,11146453,1005535
01/02/2010,Utah,1994390,1354151,1245598,108553
01/02/2010,Vermont,509023,359539,335633,23906
01/02/2010,Virginia,6049306,4146809,3829743,317066
01/02/2010,Washington,5222744,3458632,3136999,321633
01/02/2010,Wisconsin,4432255,3089495,2806625,282870
01/02/2010,Wyoming,420826,301933,278975,22958
01/03/2010,Alabama,3639724,2146904,1912541,234363
01/03/2010,Alaska,514896,361357,331099,30258
01/03/2010,Arizona,5005603,3116147,2787165,328982
01/03/2010,Arkansas,2215934,1348707,1242264,106443
01/03/2010,California,28195088,18359589,16050996,2308593
01/03/2010,Colorado,3880636,2717321,2471367,245954
01/03/2010,Connecticut,2759910,1902002,1718400,183602
01/03/2010,Delaware,691403,432340,393640,38700
01/03/2010,Florida,14692208,9065533,8076970,988563
01/03/2010,Georgia,7372287,4708859,4201580,507279
01/03/2010,Hawaii,986160,640630,596671,43959
01/03/2010,Idaho,1159426,763983,695240,68743
01/03/2010,Illinois,9918785,6634842,5894031,740811
01/03/2010,Indiana,4929346,3177346,2841624,335722
01/03/2010,Iowa,2343400,1675368,1570007,105361
01/03/2010,Kansas,2140798,1501694,1394805,106889
01/03/2010,Kentucky,3346711,2062897,1842725,220172
01/03/2010,Louisiana,3410594,2077866,1927051,150815
01/03/2010,Maine,1066137,698109,637570,60539
01/03/2010,Maryland,4429620,3064844,2818977,245867
01/03/2010,Massachusetts,5269256,3478448,3187591,290857
01/03/2010,Michigan,7777301,4783504,4165926,617578
01/03/2010,Minnesota,4104281,2938371,2714349,224022
01/03/2010,Mississippi,2207537,1271407,1138614,132793
01/03/2010,Missouri,4632421,3044587,2751280,293307
01/03/2010,Montana,771187,501546,464199,37347
01/03/2010,Nebraska,1371688,990060,941517,48543
01/03/2010,Nevada,2011335,1360604,1173988,186616
01/03/2010,Ohio,8968417,5904597,5259913,644684
01/03/2010,Oklahoma,2792911,1766675,1645979,120696
01/03/2010,Oregon,3031074,1984778,1768457,216321
01/03/2010,Pennsylvania,9972037,6359683,5820638,539045
01/03/2010,Tennessee,4900953,3076129,2762469,313660
01/03/2010,Texas,18325113,12191275,11184615,1006660
01/03/2010,Utah,1997075,1354198,1245524,108674
01/03/2010,Vermont,509216,359952,336236,23716
01/03/2010,Virginia,6055213,4153490,3837310,316180
01/03/2010,Washington,5228475,3462164,3141865,320299
01/03/2010,Wisconsin,4433668,3090610,2812648,277962
01/03/2010,Wyoming,421067,302202,279686,22516
01/04/2010,Alabama,3696845,2197720,1966202,231518
01/04/2010,Alaska,515851,361538,331564,29974
01/04/2010,Arizona,4838466,3113354,2786810,326544
01/04/2010,Arkansas,2231366,1351964,1246062,105902
01/04/2010,California,28538466,18381603,16078778,2302825
01/04/2010,Colorado,3848295,2718188,2471781,246407
01/04/2010,Connecticut,2802329,1906595,1722636,183959
01/04/2010,Delaware,701527,433690,395333,38357
01/04/2010,Florida,14959822,9099777,8111208,988569
01/04/2010,Georgia,7276848,4701086,4199284,501802
01/04/2010,Hawaii,1039195,643754,599835,43919
01/04/2010,Idaho,1163327,764012,696013,67999
01/04/2010,Illinois,9881090,6634091,5907874,726217
01/04/2010,Indiana,4962744,3181319,2849394,331925
01/04/2010,Iowa,2358250,1677557,1573836,103721
01/04/2010,Kansas,2147765,1501224,1395682,105542
01/04/2010,Kentucky,3340225,2063774,1847055,216719
01/04/2010,Louisiana,3434434,2083571,1931260,152311
01/04/2010,Maine,1074471,698248,638356,59892
01/04/2010,Maryland,4490945,3071526,2827499,244027
01/04/2010,Massachusetts,5224455,3480846,3193516,287330
01/04/2010,Michigan,7718784,4781950,4173309,608641
01/04/2010,Minnesota,4108452,2941579,2720784,220795
01/04/2010,Mississippi,2228901,1273382,1141411,131971
01/04/2010,Missouri,4618728,3044286,2752890,291396
01/04/2010,Montana,777438,501897,464966,36931
01/04/2010,Nebraska,1388012,991039,943174,47865
01/04/2010,Nevada,2073299,1360595,1173507,187088
01/04/2010,Ohio,8958283,5901230,5269891,631339
01/04/2010,Oklahoma,2836218,1767216,1648598,118618
01/04/2010,Oregon,3024399,1990068,1773965,216103
01/04/2010,Pennsylvania,10056682,6364141,5829048,535093
01/04/2010,Tennessee,4916740,3087199,2778857,308342
01/04/2010,Texas,18541655,12222661,11218075,1004586
01/04/2010,Utah,1952084,1353881,1245364,108517
01/04/2010,Vermont,506421,360198,336797,23401
01/04/2010,Virginia,6149198,4159068,3845699,313369
01/04/2010,Washington,5233189,3463843,3146041,317802
01/04/2010,Wisconsin,4428585,3089354,2817875,271479
01/04/2010,Wyoming,433003,302183,280341,21842
01/05/2010,Alabama,3700013,2211777,1983756,228021
01/05/2010,Alaska,516810,361511,331982,29529
01/05/2010,Arizona,4843931,3108504,2785501,323003
01/05/2010,Arkansas,2233214,1355055,1249752,105303
01/05/2010,California,28564851,18391244,16101040,2290204
01/05/2010,Colorado,3852091,2717428,2471774,245654
01/05/2010,Connecticut,2804758,1910818,1727354,183464
01/05/2010,Delaware,702130,435187,397214,37973
01/05/2010,Florida,14974268,9128507,8141742,986765
01/05/2010,Georgia,7285144,4695916,4199284,496632
01/05/2010,Hawaii,1040697,646474,602624,43850
01/05/2010,Idaho,1164326,763624,696473,67151
01/05/2010,Illinois,9885775,6627042,5918616,708426
01/05/2010,Indiana,4965541,3183430,2856480,326950
01/05/2010,Iowa,2359389,1677764,1575622,102142
01/05/2010,Kansas,2148511,1500581,1396641,103940
01/05/2010,Kentucky,3343644,2063716,1851019,212697
01/05/2010,Louisiana,3437625,2088368,1934470,153898
01/05/2010,Maine,1074480,697946,638921,59025
01/05/2010,Maryland,4495161,3077202,2835458,241744
01/05/2010,Massachusetts,5230789,3481152,3198192,282960
01/05/2010,Michigan,7719607,4779667,4179998,599669
01/05/2010,Minnesota,4111034,2943440,2726065,217375
01/05/2010,Mississippi,2230751,1274962,1144100,130862
01/05/2010,Missouri,4621534,3043234,2754497,288737
01/05/2010,Montana,777863,501975,465645,36330
01/05/2010,Nebraska,1388844,991699,944751,46948
01/05/2010,Nevada,2074378,1359713,1173032,186681
01/05/2010,Ohio,8961281,5892307,5276565,615742
01/05/2010,Oklahoma,2838991,1766844,1650772,116072
01/05/2010,Oregon,3027045,1992953,1778073,214880
01/05/2010,Pennsylvania,10060817,6363851,5836971,526880
01/05/2010,Tennessee,4921391,3096008,2793510,302498
01/05/2010,Texas,18567698,12244873,11246029,998844
01/05/2010,Utah,1954737,1353095,1245042,108053
01/05/2010,Vermont,506599,360279,337283,22996
01/05/2010,Virginia,6155076,4163253,3854150,309103
01/05/2010,Washington,5237362,3463335,3148394,314941
01/05/2010,Wisconsin,4430315,3086350,2821846,264504
01/05/2010,Wyoming,433341,301985,280897,21088
01/06/2010,Alabama,3703287,2214822,1990063,224759
01/06/2010,Alaska,517816,361350,332315,29035
01/06/2010,Arizona,4849422,3102036,2782917,319119
01/06/2010,Arkansas,2235014,1357180,1252284,104896
01/06/2010,California,28591878,18389824,16113195,2276629
01/06/2010,Colorado,3855998,2715479,2470389,245090
01/06/2010,Connecticut,2807133,1914097,1731412,182685
01/06/2010,Delaware,702750,436637,398992,37645
01/06/2010,Florida,14988894,9150806,8165455,985351
01/06/2010,Georgia,7293730,4692273,4199144,493129
01/06/2010,Hawaii,1042459,648687,604821,43866
01/06/2010,Idaho,1165402,762884,696497,66387
01/06/2010,Illinois,9890376,6615981,5925185,690796
01/06/2010,Indiana,4968191,3183185,2861326,321859
01/06/2010,Iowa,2360458,1676132,1575290,100842
01/06/2010,Kansas,2149335,1499954,1397316,102638
01/06/2010,Kentucky,3347186,2063356,1854264,209092
01/06/2010,Louisiana,3440859,2091461,1935671,155790
01/06/2010,Maine,1074478,697428,639223,58205
01/06/2010,Maryland,4499403,3081487,2841759,239728
01/06/2010,Massachusetts,5237003,3479736,3201063,278673
01/06/2010,Michigan,7720262,4776679,4184137,592542
01/06/2010,Minnesota,4113576,2943802,2729228,214574
01/06/2010,Mississippi,2232572,1309109,1179145,129964
01/06/2010,Missouri,4624402,3041931,2755633,286298
01/06/2010,Montana,778260,501750,466046,35704
01/06/2010,Nebraska,1389679,992091,945979,46112
01/06/2010,Nevada,2075511,1358272,1172324,185948
01/06/2010,Ohio,8964153,5879456,5278705,600751
01/06/2010,Oklahoma,2841937,1765862,1652192,113670
01/06/2010,Oregon,3029692,1994048,1780620,213428
01/06/2010,Pennsylvania,10064783,6360595,5842888,517707
01/06/2010,Tennessee,4926066,3101945,2804364,297581
01/06/2010,Texas,18594205,12259778,11267141,992637
01/06/2010,Utah,1957360,1351732,1244308,107424
01/06/2010,Vermont,506795,360157,337576,22581
01/06/2010,Virginia,6161486,4165768,3861060,304708
01/06/2010,Washington,5241659,3461303,3148334,312969
01/06/2010,Wisconsin,4432000,3082609,2824115,258494
01/06/2010,Wyoming,433698,301753,281308,20445
01/07/2010,Alabama,3706618,2215237,1992482,222755
01/07/2010,Alaska,518874,361237,332532,28705
01/07/2010,Arizona,4855271,3094880,2779038,315842
01/07/2010,Arkansas,2237003,1358003,1253026,104977
01/07/2010,California,28619823,18384037,16113653,2270384
01/07/2010,Colorado,3860150,2713677,2467557,246120
01/07/2010,Connecticut,2809705,1916460,1734133,182327
01/07/2010,Delaware,703370,437815,400363,37452
01/07/2010,Florida,15004298,9169009,8181978,987031
01/07/2010,Georgia,7301868,4691252,4198521,492731
01/07/2010,Hawaii,1044210,650583,606535,44048
01/07/2010,Idaho,1166472,761967,696118,65849
01/07/2010,Illinois,9895347,6605960,5929180,676780
01/07/2010,Indiana,4971237,3180859,2863150,317709
01/07/2010,Iowa,2361712,1673866,1573698,100168
01/07/2010,Kansas,2150262,1499521,1397499,102022
01/07/2010,Kentucky,3350635,2063585,1856614,206971
01/07/2010,Louisiana,3444273,2092507,1934492,158015
01/07/2010,Maine,1074529,697027,639323,57704
01/07/2010,Maryland,4504017,3084531,2845807,238724
01/07/2010,Massachusetts,5243644,3478152,3202585,275567
01/07/2010,Michigan,7721434,4773819,4184857,588962
01/07/2010,Minnesota,4116358,2943204,2729891,213313
01/07/2010,Mississippi,2234489,1326873,1196962,129911
01/07/2010,Missouri,4627241,3041121,2756025,285096
01/07/2010,Montana,778719,501304,466066,35238
01/07/2010,Nebraska,1390608,992335,946748,45587
01/07/2010,Nevada,2076775,1357070,1171332,185738
01/07/2010,Ohio,8967602,5866162,5277025,589137
01/07/2010,Oklahoma,2844698,1764974,1652848,112126
01/07/2010,Oregon,3032496,1994552,1781970,212582
01/07/2010,Pennsylvania,10069471,6357444,5846188,511256
01/07/2010,Tennessee,4931020,3105034,2810185,294849
01/07/2010,Texas,18621263,12272590,11282344,990246
01/07/2010,Utah,1960150,1350000,1243121,106879
01/07/2010,Vermont,506980,359881,337624,22257
01/07/2010,Virginia,6168295,4167097,3865710,301387
01/07/2010,Washington,5246398,3458973,3146426,312547
01/07/2010,Wisconsin,4433927,3079417,2824935,254482
01/07/2010,Wyoming,434045,301585,281564,20021
01/08/2010,Alabama,3708665,2215825,1993456,222369
01/08/2010,Alaska,519938,361349,332690,28659
01/08/2010,Arizona,4862034,3088178,2774664,313514
01/08/2010,Arkansas,2238891,1357870,1252260,105610
01/08/2010,California,28651165,18380281,16106916,2273365
01/08/2010,Colorado,3866394,2713080,2464356,248724
01/08/2010,Connecticut,2811743,1918237,1735650,182587
01/08/2010,Delaware,704160,438620,401248,37372
01/08/2010,Florida,15024207,9186214,8194731,991483
01/08/2010,Georgia,7309203,4693766,4198504,495262
01/08/2010,Hawaii,1045500,652315,607978,44337
01/08/2010,Idaho,1167725,761137,695586,65551
01/08/2010,Illinois,9901550,6600053,5933099,666954
01/08/2010,Indiana,4974530,3177460,2862980,314480
01/08/2010,Iowa,2363261,1672341,1572218,100123
01/08/2010,Kansas,2151610,1499329,1397291,102038
01/08/2010,Kentucky,3352851,2064904,1858381,206523
01/08/2010,Louisiana,3447819,2091887,1931705,160182
01/08/2010,Maine,1075061,697050,639483,57567
01/08/2010,Maryland,4508940,3087064,2848274,238790
01/08/2010,Massachusetts,5248732,3477864,3203993,273871
01/08/2010,Michigan,7725162,4754004,4183007,570997
01/08/2010,Minnesota,4119761,2942522,2728897,213625
01/08/2010,Mississippi,2235801,1336480,1205884,130596
01/08/2010,Missouri,4629639,3041423,2755882,285541
01/08/2010,Montana,779335,500825,465795,35030
01/08/2010,Nebraska,1391584,992637,947230,45407
01/08/2010,Nevada,2078269,1356662,1170347,186315
01/08/2010,Ohio,8971266,5855186,5273622,581564
01/08/2010,Oklahoma,2847076,1764631,1653189,111442
01/08/2010,Oregon,3035865,1995295,1782838,212457
01/08/2010,Pennsylvania,10075228,6356859,5848142,508717
01/08/2010,Tennessee,4935322,3105998,2811416,294582
01/08/2010,Texas,18653451,12287949,11294712,993237
01/08/2010,Utah,1963071,1348321,1241798,106523
01/08/2010,Vermont,507341,359635,337553,22082
01/08/2010,Virginia,6175954,4168162,3868904,299258
01/08/2010,Washington,5252718,3457191,3143795,313396
01/08/2010,Wisconsin,4436495,3077502,2825260,252242
01/08/2010,Wyoming,434340,301540,281736,19804
01/09/2010,Alabama,3710620,2216902,1993580,223322
01/09/2010,Alaska,520706,361682,332846,28836
01/09/2010,Arizona,4868640,3082127,2770279,311848
01/09/2010,Arkansas,2240717,1357262,1250630,106632
01/09/2010,California,28682473,18378828,16097746,2281082
01/09/2010,Colorado,3872252,2713611,2461710,251901
01/09/2010,Connecticut,2813819,1919267,1736057,183210
01/09/2010,Delaware,704947,439101,401788,37313
01/09/2010,Florida,15043725,9203325,8206908,996417
01/09/2010,Georgia,7316156,4698525,4199495,499030
01/09/2010,Hawaii,1046297,653928,609279,44649
01/09/2010,Idaho,1168906,760571,695155,65416
01/09/2010,Illinois,9907377,6596284,5936658,659626
01/09/2010,Indiana,4977966,3173755,2862333,311422
01/09/2010,Iowa,2364850,1672191,1571768,100423
01/09/2010,Kansas,2152775,1499286,1396809,102477
01/09/2010,Kentucky,3354938,2066702,1859754,206948
01/09/2010,Louisiana,3451131,2090381,1928355,162026
01/09/2010,Maine,1075651,697492,639857,57635
01/09/2010,Maryland,4513628,3089416,2850163,239253
01/09/2010,Massachusetts,5253897,3478753,3205662,273091
01/09/2010,Michigan,7729079,4735269,4179731,555538
01/09/2010,Minnesota,4123243,2942201,2727753,214448
01/09/2010,Mississippi,2236920,1341711,1210162,131549
01/09/2010,Missouri,4632006,3042363,2755310,287053
01/09/2010,Montana,779928,500372,465321,35051
01/09/2010,Nebraska,1392543,993061,947558,45503
01/09/2010,Nevada,2079628,1356846,1169573,187273
01/09/2010,Ohio,8975063,5846806,5270258,576548
01/09/2010,Oklahoma,2849245,1764391,1653363,111028
01/09/2010,Oregon,3039325,1996450,1783866,212584
01/09/2010,Pennsylvania,10081106,6358506,5850062,508444
01/09/2010,Tennessee,4939470,3105987,2809706,296281
01/09/2010,Texas,18684832,12306687,11306167,1000520
01/09/2010,Utah,1965965,1346821,1240547,106274
01/09/2010,Vermont,507719,359493,337459,22034
01/09/2010,Virginia,6182352,4169589,3871974,297615
01/09/2010,Washington,5258655,3456058,3141316,314742
01/09/2010,Wisconsin,4439156,3076543,2825612,250931
01/09/2010,Wyoming,434583,301652,281862,19790
01/10/2010,Alabama,3712775,2217869,1993177,224692
01/10/2010,Alaska,521665,362226,333152,29074
01/10/2010,Arizona,4875453,3076852,2766599,310253
01/10/2010,Arkansas,2242644,1356803,1249134,107669
01/10/2010,California,28715259,18378713,16092500,2286213
01/10/2010,Colorado,3878447,2714795,2460636,254159
01/10/2010,Connecticut,2815960,1919649,1735952,183697
01/10/2010,Delaware,705737,439480,402336,37144
01/10/2010,Florida,15063974,9215892,8216792,999100
01/10/2010,Georgia,7323865,4703944,4202054,501890
01/10/2010,Hawaii,1047433,655653,610770,44883
01/10/2010,Idaho,1170177,760364,695058,65306
01/10/2010,Illinois,9913651,6592116,5939556,652560
01/10/2010,Indiana,4981455,3170742,2863424,307318
01/10/2010,Iowa,2366432,1673392,1572819,100573
01/10/2010,Kansas,2154068,1499560,1396563,102997
01/10/2010,Kentucky,3357264,2068269,1861137,207132
01/10/2010,Louisiana,3454715,2089083,1925719,163364
01/10/2010,Maine,1076239,698162,640515,57647
01/10/2010,Maryland,4518646,3091736,2852813,238923
01/10/2010,Massachusetts,5259094,3480429,3208079,272350
01/10/2010,Michigan,7733095,4717673,4177199,540474
01/10/2010,Minnesota,4126763,2942469,2728215,214254
01/10/2010,Mississippi,2238228,1344467,1212089,132378
01/10/2010,Missouri,4634573,3043450,2755173,288277
01/10/2010,Montana,780526,500038,464869,35169
01/10/2010,Nebraska,1393532,993816,948117,45699
01/10/2010,Nevada,2081102,1357352,1169345,188007
01/10/2010,Ohio,8978933,5840618,5269337,571281
01/10/2010,Oklahoma,2851655,1764070,1653719,110351
01/10/2010,Oregon,3042809,1998014,1786006,212008
01/10/2010,Pennsylvania,10087177,6362019,5854037,507982
01/10/2010,Tennessee,4943817,3106786,2808210,298576
01/10/2010,Texas,18717463,12329159,11320132,1009027
01/10/2010,Utah,1968852,1345724,1239726,105998
01/10/2010,Vermont,508111,359468,337452,22016
01/10/2010,Virginia,6190036,4172079,3876726,295353
01/10/2010,Washington,5264988,3455291,3139893,315398
01/10/2010,Wisconsin,4441858,3076209,2826902,249307
01/10/2010,Wyoming,434866,301921,282034,19887
01/11/2010,Alabama,3714308,2217791,1992440,225351
01/11/2010,Alaska,522685,362765,333546,29219
01/11/2010,Arizona,4881581,3072209,2763909,308300
01/11/2010,Arkansas,2244183,1356630,1248235,108395
01/11/2010,California,28745035,18376501,16093722,2282779
01/11/2010,Colorado,3884216,2715531,2461626,253905
01/11/2010,Connecticut,2817651,1919392,1735829,183563
01/11/2010,Delaware,706439,439945,403158,36787
01/11/2010,Florida,15081696,9239476,8241889,997587
01/11/2010,Georgia,7330672,4708019,4205813,502206
01/11/2010,Hawaii,1048818,657494,612571,44923
01/11/2010,Idaho,1171219,760441,695300,65141
01/11/2010,Illinois,9918371,6584845,5940621,644224
01/11/2010,Indiana,4984018,3168580,2867137,301443
01/11/2010,Iowa,2367571,1675189,1574964,100225
01/11/2010,Kansas,2155106,1499951,1396803,103148
01/11/2010,Kentucky,3359139,2069007,1862657,206350
01/11/2010,Louisiana,3457717,2088150,1924248,163902
01/11/2010,Maine,1076699,698775,641355,57420
01/11/2010,Maryland,4522968,3093338,2856158,237180
01/11/2010,Massachusetts,5263454,3482203,3211354,270849
01/11/2010,Michigan,7735723,4700743,4176364,524379
01/11/2010,Minnesota,4129555,2942990,2730889,212101
01/11/2010,Mississippi,2239207,1345720,1212871,132849
01/11/2010,Missouri,4636373,3043917,2755917,288000
01/11/2010,Montana,781026,499828,464588,35240
01/11/2010,Nebraska,1394320,994951,949114,45837
01/11/2010,Nevada,2082333,1357786,1169711,188075
01/11/2010,Ohio,8981177,5834361,5271037,563324
01/11/2010,Oklahoma,2853727,1763618,1654525,109093
01/11/2010,Oregon,3045757,1999456,1789598,209858
01/11/2010,Pennsylvania,10091215,6365866,5860034,505832
01/11/2010,Tennessee,4947403,3109113,2809060,300053
01/11/2010,Texas,18748043,12352386,11337423,1014963
01/11/2010,Utah,1971498,1345016,1239409,105607
01/11/2010,Vermont,508419,359473,337528,21945
01/11/2010,Virginia,6197094,4175447,3883599,291848
01/11/2010,Washington,5270758,3453762,3139343,314419
01/11/2010,Wisconsin,4443782,3075716,2829157,246559
01/11/2010,Wyoming,435098,302247,282256,19991
01/12/2010,Alabama,3715741,2216409,1991718,224691
01/12/2010,Alaska,523689,363140,333936,29204
01/12/2010,Arizona,4887492,3067605,2762374,305231
01/12/2010,Arkansas,2245614,1356570,1247898,108672
01/12/2010,California,28773773,18370136,16100812,2269324
01/12/2010,Colorado,3889801,2715890,2464572,251318
01/12/2010,Connecticut,2819242,1918366,1735774,182592
01/12/2010,Delaware,707142,440553,404310,36243
01/12/2010,Florida,15098874,9245364,8253492,991872
01/12/2010,Georgia,7337313,4709976,4210339,499637
01/12/2010,Hawaii,1050130,659209,614428,44781
01/12/2010,Idaho,1172254,760670,695790,64880
01/12/2010,Illinois,9922695,6573920,5938573,635347
01/12/2010,Indiana,4986382,3167428,2873191,294237
01/12/2010,Iowa,2368633,1676546,1577238,99308
01/12/2010,Kansas,2156053,1500190,1397503,102687
01/12/2010,Kentucky,3360884,2068709,1864297,204412
01/12/2010,Louisiana,3460659,2087244,1923828,163416
01/12/2010,Maine,1077041,699099,642145,56954
01/12/2010,Maryland,4527177,3093874,2859411,234463
01/12/2010,Massachusetts,5267534,3483339,3215075,268264
01/12/2010,Michigan,7738064,4684248,4176837,507411
01/12/2010,Minnesota,4132148,2943772,2735520,208252
01/12/2010,Mississippi,2240112,1346211,1213311,132900
01/12/2010,Missouri,4637996,3043280,2757397,285883
01/12/2010,Montana,781473,499719,464553,35166
01/12/2010,Nebraska,1395040,996345,950496,45849
01/12/2010,Nevada,2083488,1357880,1170535,187345
01/12/2010,Ohio,8983084,5826065,5273672,552393
01/12/2010,Oklahoma,2855615,1762867,1655823,107044
01/12/2010,Oregon,3048548,2000082,1794045,206037
01/12/2010,Pennsylvania,10094881,6367685,5866464,501221
01/12/2010,Tennessee,4950759,3112714,2812682,300032
01/12/2010,Texas,18777822,12372836,11356570,1016266
01/12/2010,Utah,1974065,1344606,1239497,105109
01/12/2010,Vermont,508692,359459,337650,21809
01/12/2010,Virginia,6203808,4179321,3892116,287205
01/12/2010,Washington,5276239,3450811,3139125,311686
01/12/2010,Wisconsin,4445481,3074471,2831638,242833
01/12/2010,Wyoming,435291,302487,282475,20012
01/01/2011,Alabama,3717148,2214624,1991574,223050
01/01/2011,Alaska,524423,363404,334356,29048
01/01/2011,Arizona,4893368,3063471,2761928,301543
01/01/2011,Arkansas,2247108,1356376,1247709,108667
01/01/2011,California,28802283,18363805,16113386,2250419
01/01/2011,Colorado,3895089,2716453,2469040,247413
01/01/2011,Connecticut,2820871,1917092,1736022,181070
01/01/2011,Delaware,707838,441299,405681,35618
01/01/2011,Florida,15115903,9251721,8267299,984422
01/01/2011,Georgia,7343837,4711595,4216168,495427
01/01/2011,Hawaii,1050960,660636,616041,44595
01/01/2011,Idaho,1173278,761044,696460,64584
01/01/2011,Illinois,9927281,6562937,5934625,628312
01/01/2011,Indiana,4988952,3168166,2881081,287085
01/01/2011,Iowa,2369761,1676887,1578751,98136
01/01/2011,Kansas,2156803,1500267,1398503,101764
01/01/2011,Kentucky,3362512,2067917,1866158,201759
01/01/2011,Louisiana,3463488,2086142,1924090,162052
01/01/2011,Maine,1077430,699101,642726,56375
01/01/2011,Maryland,4531264,3094091,2862372,231719
01/01/2011,Massachusetts,5271792,3483533,3218531,265002
01/01/2011,Michigan,7740726,4669483,4178511,490972
01/01/2011,Minnesota,4134872,2945255,2741797,203458
01/01/2011,Mississippi,2240917,1346725,1213959,132766
01/01/2011,Missouri,4639686,3042146,2759423,282723
01/01/2011,Montana,781908,499721,464781,34940
01/01/2011,Nebraska,1395701,997896,952121,45775
01/01/2011,Nevada,2084614,1357776,1171682,186094
01/01/2011,Ohio,8985195,5816035,5275424,540611
01/01/2011,Oklahoma,2857438,1761984,1657557,104427
01/01/2011,Oregon,3051463,1999833,1798493,201340
01/01/2011,Pennsylvania,10098875,6367786,5872521,495265
01/01/2011,Tennessee,4954125,3117268,2818458,298810
01/01/2011,Texas,18807299,12391831,11377422,1014409
01/01/2011,Utah,1976608,1344519,1239913,104606
01/01/2011,Vermont,509005,359441,337829,21612
01/01/2011,Virginia,6209446,4183595,3901342,282253
01/01/2011,Washington,5281394,3447125,3139152,307973
01/01/2011,Wisconsin,4447290,3072930,2834013,238917
01/01/2011,Wyoming,435435,302548,282676,19872
01/02/2011,Alabama,3718178,2212917,1991849,221068
01/02/2011,Alaska,525057,363514,334711,28803
01/02/2011,Arizona,4898622,3060176,2761805,298371
01/02/2011,Arkansas,2248324,1355709,1247149,108560
01/02/2011,California,28826883,18359121,16127796,2231325
01/02/2011,Colorado,3900018,2717045,2474007,243038
01/02/2011,Connecticut,2822128,1915799,1736443,179356
01/02/2011,Delaware,708429,442047,407022,35025
01/02/2011,Florida,15130726,9252149,8280635,971514
01/02/2011,Georgia,7349349,4713939,4222918,491021
01/02/2011,Hawaii,1051535,661609,617144,44465
01/02/2011,Idaho,1174126,761435,697172,64263
01/02/2011,Illinois,9930629,6554409,5929766,624643
01/02/2011,Indiana,4991071,3170670,2889335,281335
01/02/2011,Iowa,2370604,1676002,1579056,96946
01/02/2011,Kansas,2157303,1499954,1399506,100448
01/02/2011,Kentucky,3363785,2066889,1867770,199119
01/02/2011,Louisiana,3465991,2084405,1924223,160182
01/02/2011,Maine,1077709,698816,643048,55768
01/02/2011,Maryland,4534863,3094149,2864621,229528
01/02/2011,Massachusetts,5275498,3482261,3220677,261584
01/02/2011,Michigan,7742608,4665113,4180564,484549
01/02/2011,Minnesota,4137246,2947224,2747825,199399
01/02/2011,Mississippi,2241481,1347354,1214734,132620
01/02/2011,Missouri,4640819,3040520,2761650,278870
01/02/2011,Montana,782278,499700,465116,34584
01/02/2011,Nebraska,1396240,999312,953729,45583
01/02/2011,Nevada,2085509,1357524,1172858,184666
01/02/2011,Ohio,8986497,5804853,5274342,530511
01/02/2011,Oklahoma,2858912,1760853,1659149,101704
01/02/2011,Oregon,3054102,1998756,1801913,196843
01/02/2011,Pennsylvania,10101882,6366806,5876807,489999
01/02/2011,Tennessee,4956991,3121614,2824825,296789
01/02/2011,Texas,18834479,12409993,11398153,1011840
01/02/2011,Utah,1979059,1344597,1240415,104182
01/02/2011,Vermont,509200,359320,337959,21361
01/02/2011,Virginia,6214418,4187549,3909662,277887
01/02/2011,Washington,5286052,3443437,3139149,304288
01/02/2011,Wisconsin,4448743,3071357,2835627,235730
01/02/2011,Wyoming,435625,302436,282854,19582
01/03/2011,Alabama,3719329,2210958,1991840,219118
01/03/2011,Alaska,525998,363451,334935,28516
01/03/2011,Arizona,4903936,3057262,2761339,295923
01/03/2011,Arkansas,2249580,1354508,1246167,108341
01/03/2011,California,28851906,18354669,16139805,2214864
01/03/2011,Colorado,3905335,2717265,2478257,239008
01/03/2011,Connecticut,2823420,1914283,1736677,177606
01/03/2011,Delaware,709022,442611,408089,34522
01/03/2011,Florida,15145898,9250847,8290918,959929
01/03/2011,Georgia,7355534,4716845,4229650,487195
01/03/2011,Hawaii,1052652,662006,617560,44446
01/03/2011,Idaho,1175062,761692,697768,63924
01/03/2011,Illinois,9934177,6548847,5923813,625034
01/03/2011,Indiana,4993128,3173805,2895813,277992
01/03/2011,Iowa,2371487,1674053,1578220,95833
01/03/2011,Kansas,2158094,1499072,1400245,98827
01/03/2011,Kentucky,3365375,2065391,1868492,196899
01/03/2011,Louisiana,3468626,2081558,1923559,157999
01/03/2011,Maine,1077980,698343,643153,55190
01/03/2011,Maryland,4538624,3093519,2865617,227902
01/03/2011,Massachusetts,5279236,3479416,3221128,258288
01/03/2011,Michigan,7744339,4643729,4182090,461639
01/03/2011,Minnesota,4139617,2948872,2751699,197173
01/03/2011,Mississippi,2242215,1347717,1215162,132555
01/03/2011,Missouri,4642214,3038234,2763601,274633
01/03/2011,Montana,782660,499536,465377,34159
01/03/2011,Nebraska,1396850,1000380,955070,45310
01/03/2011,Nevada,2086463,1357202,1173836,183366
01/03/2011,Ohio,8987798,5793724,5270128,523596
01/03/2011,Oklahoma,2860602,1759425,1660147,99278
01/03/2011,Oregon,3056622,1997052,1803636,193416
01/03/2011,Pennsylvania,10104727,6364495,5877895,486600
01/03/2011,Tennessee,4960063,3124286,2830057,294229
01/03/2011,Texas,18862126,12426745,11416366,1010379
01/03/2011,Utah,1981579,1344706,1240829,103877
01/03/2011,Vermont,509462,358981,337921,21060
01/03/2011,Virginia,6220972,4189997,3915249,274748
01/03/2011,Washington,5291169,3440138,3139014,301124
01/03/2011,Wisconsin,4450178,3069439,2835861,233578
01/03/2011,Wyoming,435792,302188,283016,19172
01/04/2011,Alabama,3720594,2208488,1990933,217555
01/04/2011,Alaska,526677,363367,335095,28272
01/04/2011,Arizona,4909573,3054212,2760059,294153
01/04/2011,Arkansas,2250956,1353056,1244909,108147
01/04/2011,California,28878193,18352428,16147585,2204843
01/04/2011,Colorado,3910501,2717501,2481268,236233
01/04/2011,Connecticut,2824880,1912529,1736438,176091
01/04/2011,Delaware,709653,442904,408731,34173
01/04/2011,Florida,15161610,9247888,8297312,950576
01/04/2011,Georgia,7361501,4720314,4235488,484826
01/04/2011,Hawaii,1053281,661862,617235,44627
01/04/2011,Idaho,1176067,761780,698168,63612
01/04/2011,Illinois,9938364,6547150,5917025,630125
01/04/2011,Indiana,4995709,3177281,2899609,277672
01/04/2011,Iowa,2372558,1671639,1576628,95011
01/04/2011,Kansas,2158718,1497707,1400475,97232
01/04/2011,Kentucky,3366900,2063457,1867982,195475
01/04/2011,Louisiana,3471308,2077821,1922007,155814
01/04/2011,Maine,1078360,697858,643097,54761
01/04/2011,Maryland,4542385,3092166,2865055,227111
01/04/2011,Massachusetts,5283400,3476255,3220663,255592
01/04/2011,Michigan,7746818,4649446,4182815,466631
01/04/2011,Minnesota,4142356,2950303,2753517,196786
01/04/2011,Mississippi,2242874,1347672,1214885,132787
01/04/2011,Missouri,4643748,3035428,2764617,270811
01/04/2011,Montana,783082,499306,465514,33792
01/04/2011,Nebraska,1397510,1000982,955970,45012
01/04/2011,Nevada,2087465,1357102,1174492,182610
01/04/2011,Ohio,8989863,5784616,5264185,520431
01/04/2011,Oklahoma,2862265,1758254,1660641,97613
01/04/2011,Oregon,3059486,1995371,1803756,191615
01/04/2011,Pennsylvania,10108542,6362143,5875646,486497
01/04/2011,Tennessee,4963320,3124721,2832937,291784
01/04/2011,Texas,18890272,12444275,11431447,1012828
01/04/2011,Utah,1984210,1344845,1241064,103781
01/04/2011,Vermont,509732,358434,337692,20742
01/04/2011,Virginia,6226145,4191359,3917774,273585
01/04/2011,Washington,5296088,3437612,3138956,298656
01/04/2011,Wisconsin,4452042,3067488,2834768,232720
01/04/2011,Wyoming,435951,301888,283155,18733
01/05/2011,Alabama,3721955,2205934,1989359,216575
01/05/2011,Alaska,527433,363406,335267,28139
01/05/2011,Arizona,4915290,3051429,2758301,293128
01/05/2011,Arkansas,2252425,1352224,1244047,108177
01/05/2011,California,28904789,18358639,16155067,2203572
01/05/2011,Colorado,3915913,2719021,2483775,235246
01/05/2011,Connecticut,2826494,1911140,1736109,175031
01/05/2011,Delaware,710295,443006,408994,34012
01/05/2011,Florida,15177934,9246195,8302264,943931
01/05/2011,Georgia,7367896,4725451,4240831,484620
01/05/2011,Hawaii,1054070,661495,616453,45042
01/05/2011,Idaho,1177152,761901,698553,63348
01/05/2011,Illinois,9942921,6550817,5911356,639461
01/05/2011,Indiana,4998403,3181683,2901364,280319
01/05/2011,Iowa,2373762,1669479,1574841,94638
01/05/2011,Kansas,2159579,1496444,1400405,96039
01/05/2011,Kentucky,3368682,2061619,1866520,195099
01/05/2011,Louisiana,3474088,2074388,1920250,154138
01/05/2011,Maine,1078807,697593,643030,54563
01/05/2011,Maryland,4546292,3091054,2863648,227406
01/05/2011,Massachusetts,5287766,3474604,3220732,253872
01/05/2011,Michigan,7749462,4655295,4183535,471760
01/05/2011,Minnesota,4145265,2952020,2754433,197587
01/05/2011,Mississippi,2243657,1347406,1214100,133306
01/05/2011,Missouri,4645581,3032973,2764945,268028
01/05/2011,Montana,783539,499226,465635,33591
01/05/2011,Nebraska,1398234,1001373,956621,44752
01/05/2011,Nevada,2088489,1357610,1175043,182567
01/05/2011,Ohio,8992219,5778681,5258057,520624
01/05/2011,Oklahoma,2864136,1758164,1661115,97049
01/05/2011,Oregon,3062462,1994438,1802840,191598
01/05/2011,Pennsylvania,10112630,6362257,5872236,490021
01/05/2011,Tennessee,4966716,3123434,2833384,290050
01/05/2011,Texas,18918815,12467134,11445785,1021349
01/05/2011,Utah,1986941,1345294,1241349,103945
01/05/2011,Vermont,510055,357830,337364,20466
01/05/2011,Virginia,6231923,4193417,3918828,274589
01/05/2011,Washington,5301308,3436211,3139194,297017
01/05/2011,Wisconsin,4454088,3066514,2833324,233190
01/05/2011,Wyoming,436185,301719,283312,18407
01/06/2011,Alabama,3723324,2203524,1987938,215586
01/06/2011,Alaska,528424,363679,335579,28100
01/06/2011,Arizona,4921061,3049264,2757097,292167
01/06/2011,Arkansas,2253923,1352740,1244430,108310
01/06/2011,California,28932601,18375161,16169321,2205840
01/06/2011,Colorado,3921602,2722599,2487089,235510
01/06/2011,Connecticut,2828103,1910692,1736564,174128
01/06/2011,Delaware,710947,443112,409159,33953
01/06/2011,Florida,15194605,9247380,8309731,937649
01/06/2011,Georgia,7374731,4732626,4247308,485318
01/06/2011,Hawaii,1055250,661170,615617,45553
01/06/2011,Idaho,1178222,762271,699223,63048
01/06/2011,Illinois,9947621,6558897,5908670,650227
01/06/2011,Indiana,5000969,3186877,2902198,284679
01/06/2011,Iowa,2374926,1668016,1573438,94578
01/06/2011,Kansas,2160579,1495824,1400534,95290
01/06/2011,Kentucky,3370550,2060245,1865052,195193
01/06/2011,Louisiana,3476941,2072589,1919502,153087
01/06/2011,Maine,1079234,697688,643236,54452
01/06/2011,Maryland,4550304,3091103,2862954,228149
01/06/2011,Massachusetts,5292032,3475347,3222636,252711
01/06/2011,Michigan,7751914,4661368,4186322,475046
01/06/2011,Minnesota,4148114,2953753,2755639,198114
01/06/2011,Mississippi,2244505,1347132,1213310,133822
01/06/2011,Missouri,4647502,3031540,2765678,265862
01/06/2011,Montana,784030,499502,465976,33526
01/06/2011,Nebraska,1399025,1001954,957429,44525
01/06/2011,Nevada,2089613,1358808,1175945,182863
01/06/2011,Ohio,8994387,5774881,5253336,521545
01/06/2011,Oklahoma,2866167,1759602,1662261,97341
01/06/2011,Oregon,3065386,1994170,1801687,192483
01/06/2011,Pennsylvania,10116545,6366245,5870872,495373
01/06/2011,Tennessee,4970183,3121176,2832604,288572
01/06/2011,Texas,18948373,12497108,11463413,1033695
01/06/2011,Utah,1989686,1346394,1242153,104241
01/06/2011,Vermont,510359,357343,337129,20214
01/06/2011,Virginia,6238757,4197326,3920664,276662
01/06/2011,Washington,5306985,3435558,3139899,295659
01/06/2011,Wisconsin,4456029,3067022,2832807,234215
01/06/2011,Wyoming,436390,301800,283564,18236
01/07/2011,Alabama,3725094,2201393,1987565,213828
01/07/2011,Alaska,529293,364268,336147,28121
01/07/2011,Arizona,4927327,3047928,2757526,290402
01/07/2011,Arkansas,2255622,1354815,1246487,108328
01/07/2011,California,28961854,18400252,16196030,2204222
01/07/2011,Colorado,3927503,2728230,2492162,236068
01/07/2011,Connecticut,2829939,1911543,1738579,172964
01/07/2011,Delaware,711649,443468,409601,33867
01/07/2011,Florida,15212690,9251715,8322847,928868
01/07/2011,Georgia,7381294,4741366,4256369,484997
01/07/2011,Hawaii,1056275,660995,615010,45985
01/07/2011,Idaho,1179418,763074,700436,62638
01/07/2011,Illinois,9952918,6568779,5909893,658886
01/07/2011,Indiana,5004175,3192548,2903557,288991
01/07/2011,Iowa,2376369,1667412,1572853,94559
01/07/2011,Kansas,2161702,1496109,1401222,94887
01/07/2011,Kentucky,3372658,2059549,1864549,195000
01/07/2011,Louisiana,3480139,2073250,1920667,152583
01/07/2011,Maine,1079736,698174,643935,54239
01/07/2011,Maryland,4554788,3092882,2864451,228431
01/07/2011,Massachusetts,5296946,3478517,3227066,251451
01/07/2011,Michigan,7755325,4667917,4192853,475064
01/07/2011,Minnesota,4151463,2955400,2758359,197041
01/07/2011,Mississippi,2245527,1346784,1212959,133825
01/07/2011,Missouri,4649586,3031325,2767805,263520
01/07/2011,Montana,784578,500212,466749,33463
01/07/2011,Nebraska,1399924,1003040,958709,44331
01/07/2011,Nevada,2090907,1360553,1177623,182930
01/07/2011,Ohio,8997660,5771503,5251468,520035
01/07/2011,Oklahoma,2868176,1762735,1664718,98017
01/07/2011,Oregon,3068628,1994525,1801501,193024
01/07/2011,Pennsylvania,10121700,6374425,5874119,500306
01/07/2011,Tennessee,4974165,3118930,2832382,286548
01/07/2011,Texas,18978851,12534220,11487969,1046251
01/07/2011,Utah,1992633,1342776,1243911,98865
01/07/2011,Vermont,510702,357058,337145,19913
01/07/2011,Virginia,6245595,4203699,3925109,278590
01/07/2011,Washington,5312903,3434917,3141096,293821
01/07/2011,Wisconsin,4458463,3069100,2834342,234758
01/07/2011,Wyoming,436630,302182,283980,18202
01/08/2011,Alabama,3727077,2199378,1988543,210835
01/08/2011,Alaska,529932,365018,336857,28161
01/08/2011,Arizona,4934665,3047345,2759876,287469
01/08/2011,Arkansas,2256748,1357919,1249882,108037
01/08/2011,California,28992652,18428801,16234039,2194762
01/08/2011,Colorado,3933549,2735039,2498664,236375
01/08/2011,Connecticut,2831528,1913385,1742023,171362
01/08/2011,Delaware,712334,444138,410471,33667
01/08/2011,Florida,15233573,9261107,8341528,919579
01/08/2011,Georgia,7389941,4750409,4267651,482758
01/08/2011,Hawaii,1057360,660874,614669,46205
01/08/2011,Idaho,1180641,764301,702187,62114
01/08/2011,Illinois,9956696,6577947,5914841,663106
01/08/2011,Indiana,5006739,3197873,2906147,291726
01/08/2011,Iowa,2377594,1667469,1573169,94300
01/08/2011,Kansas,2163057,1497076,1402453,94623
01/08/2011,Kentucky,3374290,2059402,1865360,194042
01/08/2011,Louisiana,3482300,2076019,1923582,152437
01/08/2011,Maine,1080008,698915,645058,53857
01/08/2011,Maryland,4559232,3096098,2868279,227819
01/08/2011,Massachusetts,5301948,3483335,3233573,249762
01/08/2011,Michigan,7758849,4674626,4202912,471714
01/08/2011,Minnesota,4154458,2956624,2762729,193895
01/08/2011,Mississippi,2246385,1346413,1213238,133175
01/08/2011,Missouri,4651535,3031636,2771395,260241
01/08/2011,Montana,785191,501247,467977,33270
01/08/2011,Nebraska,1400978,1004575,960475,44100
01/08/2011,Nevada,2093893,1362462,1180132,182330
01/08/2011,Ohio,9000165,5767102,5252818,514284
01/08/2011,Oklahoma,2870614,1767198,1668501,98697
01/08/2011,Oregon,3071373,1995328,1802792,192536
01/08/2011,Pennsylvania,10125377,6385122,5881816,503306
01/08/2011,Tennessee,4978538,3116910,2833535,283375
01/08/2011,Texas,19010408,12546014,11519770,1026244
01/08/2011,Utah,1995505,1340068,1246666,93402
01/08/2011,Vermont,510779,356927,337389,19538
01/08/2011,Virginia,6252917,4211579,3932076,279503
01/08/2011,Washington,5319387,3434295,3143050,291245
01/08/2011,Wisconsin,4460535,3072085,2838003,234082
01/08/2011,Wyoming,437302,302814,284545,18269
01/09/2011,Alabama,3729221,2197051,1990625,206426
01/09/2011,Alaska,530484,365643,337487,28156
01/09/2011,Arizona,4942294,3047212,2763942,283270
01/09/2011,Arkansas,2258033,1361072,1253820,107252
01/09/2011,California,29024770,18453635,16277760,2175875
01/09/2011,Colorado,3939619,2741753,2505623,236130
01/09/2011,Connecticut,2833192,1915535,1746278,169257
01/09/2011,Delaware,713095,444928,411634,33294
01/09/2011,Florida,15255186,9265057,8363923,901134
01/09/2011,Georgia,7398785,4758203,4279885,478318
01/09/2011,Hawaii,1058144,660501,614430,46071
01/09/2011,Idaho,1181963,765783,704282,61501
01/09/2011,Illinois,9961151,6585180,5924042,661138
01/09/2011,Indiana,5009696,3201966,2910302,291664
01/09/2011,Iowa,2379045,1667811,1574205,93606
01/09/2011,Kansas,2164394,1498090,1403990,94100
01/09/2011,Kentucky,3375991,2059397,1867511,191886
01/09/2011,Louisiana,3484631,2079673,1927408,152265
01/09/2011,Maine,1080363,699670,646382,53288
01/09/2011,Maryland,4563796,3099892,2873749,226143
01/09/2011,Massachusetts,5307262,3488645,3241226,247419
01/09/2011,Michigan,7762898,4680596,4215213,465383
01/09/2011,Minnesota,4157759,2956803,2767696,189107
01/09/2011,Mississippi,2247302,1346047,1214189,131858
01/09/2011,Missouri,4653762,3031257,2775879,255378
01/09/2011,Montana,785840,502388,469513,32875
01/09/2011,Nebraska,1402092,1006289,962554,43735
01/09/2011,Nevada,2096935,1364043,1183282,180761
01/09/2011,Ohio,9003266,5760793,5256975,503818
01/09/2011,Oklahoma,2873141,1772359,1673387,98972
01/09/2011,Oregon,3074353,1995988,1805189,190799
01/09/2011,Pennsylvania,10129765,6395422,5892027,503395
01/09/2011,Tennessee,4983075,3114511,2835806,278705
01/09/2011,Texas,19042812,12559256,11556548,1002708
01/09/2011,Utah,1998526,1338091,1250211,87880
01/09/2011,Vermont,510881,356866,337751,19115
01/09/2011,Virginia,6259719,4219107,3940336,278771
01/09/2011,Washington,5325852,3434445,3146622,287823
01/09/2011,Wisconsin,4462951,3074803,2842921,231882
01/09/2011,Wyoming,438037,303525,285193,18332
01/10/2011,Alabama,3731395,2194108,1992980,201128
01/10/2011,Alaska,531239,365963,337901,28062
01/10/2011,Arizona,4949772,3047502,2769137,278365
01/10/2011,Arkansas,2259197,1363485,1257461,106024
01/10/2011,California,29057308,18470587,16320810,2149777
01/10/2011,Colorado,3945966,2747237,2511976,235261
01/10/2011,Connecticut,2834869,1917084,1750252,166832
01/10/2011,Delaware,713826,445636,412856,32780
01/10/2011,Florida,15276781,9276833,8387525,889308
01/10/2011,Georgia,7408384,4764049,4291750,472299
01/10/2011,Hawaii,1059477,659648,614041,45607
01/10/2011,Idaho,1183280,767335,706484,60851
01/10/2011,Illinois,9965604,6589604,5936827,652777
01/10/2011,Indiana,5012382,3204480,2915887,288593
01/10/2011,Iowa,2380345,1668085,1575631,92454
01/10/2011,Kansas,2165921,1498563,1405412,93151
01/10/2011,Kentucky,3377830,2058960,1870409,188551
01/10/2011,Louisiana,3486935,2083093,1931181,151912
01/10/2011,Maine,1080688,700205,647591,52614
01/10/2011,Maryland,4568504,3103611,2879948,223663
01/10/2011,Massachusetts,5312353,3493484,3248942,244542
01/10/2011,Michigan,7766568,4684885,4227863,457022
01/10/2011,Minnesota,4160868,2955882,2772119,183763
01/10/2011,Mississippi,2248307,1345330,1215492,129838
01/10/2011,Missouri,4656052,3029495,2780269,249226
01/10/2011,Montana,786491,503378,471088,32290
01/10/2011,Nebraska,1403237,1007812,964612,43200
01/10/2011,Nevada,2099973,1364991,1186737,178254
01/10/2011,Ohio,9005983,5753316,5263328,489988
01/10/2011,Oklahoma,2875894,1777478,1678931,98547
01/10/2011,Oregon,3077143,1996000,1807834,188166
01/10/2011,Pennsylvania,10133621,6403565,5903108,500457
01/10/2011,Tennessee,4987636,3111419,2838553,272866
01/10/2011,Texas,19075801,12570673,11594803,975870
01/10/2011,Utah,2001502,1336631,1254196,82435
01/10/2011,Vermont,510996,356776,338090,18686
01/10/2011,Virginia,6268025,4224836,3948490,276346
01/10/2011,Washington,5332729,3436373,3152344,284029
01/10/2011,Wisconsin,4465132,3076325,2847838,228487
01/10/2011,Wyoming,438779,304140,285821,18319
01/11/2011,Alabama,3733018,2190069,1994495,195574
01/11/2011,Alaska,531683,365959,338096,27863
01/11/2011,Arizona,4956614,3047623,2774329,273294
01/11/2011,Arkansas,2260105,1364537,1260075,104462
01/11/2011,California,29086234,18475806,16356584,2119222
01/11/2011,Colorado,3951498,2750166,2516276,233890
01/11/2011,Connecticut,2836156,1917061,1752728,164333
01/11/2011,Delaware,714415,446063,413853,32210
01/11/2011,Florida,15295953,9285382,8409108,876274
01/11/2011,Georgia,7416536,4767256,4301696,465560
01/11/2011,Hawaii,1060261,658261,613338,44923
01/11/2011,Idaho,1184380,768639,708451,60188
01/11/2011,Illinois,9968779,6590025,5950626,639399
01/11/2011,Indiana,5014631,3204528,2921443,283085
01/11/2011,Iowa,2381354,1667807,1576906,90901
01/11/2011,Kansas,2166958,1498063,1406203,91860
01/11/2011,Kentucky,3379079,2057306,1873049,184257
01/11/2011,Louisiana,3488699,2085470,1934241,151229
01/11/2011,Maine,1080869,700345,648450,51895
01/11/2011,Maryland,4572406,3106452,2885725,220727
01/11/2011,Massachusetts,5316976,3496743,3255358,241385
01/11/2011,Michigan,7769497,4686341,4238754,447587
01/11/2011,Minnesota,4163536,2953876,2775177,178699
01/11/2011,Mississippi,2248891,1343817,1216515,127302
01/11/2011,Missouri,4657686,3025832,2783434,242398
01/11/2011,Montana,787015,503969,472384,31585
01/11/2011,Nebraska,1404152,1008729,966232,42497
01/11/2011,Nevada,2102736,1365040,1190017,175023
01/11/2011,Ohio,9007712,5745836,5270678,475158
01/11/2011,Oklahoma,2877986,1781679,1684282,97397
01/11/2011,Oregon,3079645,1994860,1809617,185243
01/11/2011,Pennsylvania,10136404,6408612,5913540,495072
01/11/2011,Tennessee,4991472,3107219,2840913,266306
01/11/2011,Texas,19105904,12576962,11630243,946719
01/11/2011,Utah,2004296,1335333,1258132,77201
01/11/2011,Vermont,511024,356508,338251,18257
01/11/2011,Virginia,6274099,4227390,3954876,272514
01/11/2011,Washington,5338490,3440275,3159925,280350
01/11/2011,Wisconsin,4466891,3075869,2851587,224282
01/11/2011,Wyoming,439418,304504,286325,18179
01/12/2011,Alabama,3734683,2185010,1994618,190392
01/12/2011,Alaska,532076,365671,338095,27576
01/12/2011,Arizona,4963381,3047727,2778825,268902
01/12/2011,Arkansas,2261056,1364056,1261291,102765
01/12/2011,California,29114664,18469241,16381644,2087597
01/12/2011,Colorado,3956931,2749769,2517876,231893
01/12/2011,Connecticut,2837493,1915340,1753314,162026
01/12/2011,Delaware,715053,446201,414510,31691
01/12/2011,Florida,15315092,9289835,8426736,863099
01/12/2011,Georgia,7424650,4767599,4308707,458892
01/12/2011,Hawaii,1060869,656523,612414,44109
01/12/2011,Idaho,1185520,769548,709965,59583
01/12/2011,Illinois,9972047,6586549,5962923,623626
01/12/2011,Indiana,5016897,3201486,2925295,276191
01/12/2011,Iowa,2382411,1666736,1577591,89145
01/12/2011,Kansas,2167913,1496515,1406144,90371
01/12/2011,Kentucky,3380258,2054336,1874902,179434
01/12/2011,Louisiana,3490514,2086631,1936543,150088
01/12/2011,Maine,1081085,700108,648912,51196
01/12/2011,Maryland,4576360,3107880,2890142,217738
01/12/2011,Massachusetts,5321573,3497899,3259580,238319
01/12/2011,Michigan,7772459,4684886,4246482,438404
01/12/2011,Minnesota,4166245,2950830,2776403,174427
01/12/2011,Mississippi,2249476,1341351,1216791,124560
01/12/2011,Missouri,4659337,3020372,2784865,235507
01/12/2011,Montana,787517,504138,473258,30880
01/12/2011,Nebraska,1405024,1008982,967276,41706
01/12/2011,Nevada,2105492,1364376,1192847,171529
01/12/2011,Ohio,9009541,5739218,5277947,461271
01/12/2011,Oklahoma,2880077,1784491,1688775,95716
01/12/2011,Oregon,3082145,1992429,1809926,182503
01/12/2011,Pennsylvania,10139206,6411019,5922406,488613
01/12/2011,Tennessee,4995309,3101996,2842262,259734
01/12/2011,Texas,19135673,12576704,11659891,916813
01/12/2011,Utah,2007032,1333971,1261754,72217
01/12/2011,Vermont,511064,356006,338170,17836
01/12/2011,Virginia,6280095,4226121,3958263,267858
01/12/2011,Washington,5344052,3445721,3168491,277230
01/12/2011,Wisconsin,4468666,3073596,2853852,219744
01/12/2011,Wyoming,440037,304580,286683,17897
01/01/2012,Alabama,3736437,2179750,1993523,186227
01/01/2012,Alaska,532472,365200,337946,27254
01/01/2012,Arizona,4970220,3048161,2782738,265423
01/01/2012,Arkansas,2262001,1362428,1261262,101166
01/01/2012,California,29143906,18456650,16397835,2058815
01/01/2012,Colorado,3962382,2747283,2517729,229554
01/01/2012,Connecticut,2838829,1912351,1752189,160162
01/01/2012,Delaware,715709,446183,414872,31311
01/01/2012,Florida,15334438,9292160,8441097,851063
01/01/2012,Georgia,7433130,4765809,4312847,452962
01/01/2012,Hawaii,1061464,654711,611452,43259
01/01/2012,Idaho,1186669,770197,711077,59120
01/01/2012,Illinois,9975600,6580816,5972028,608788
01/01/2012,Indiana,5019202,3195782,2926439,269343
01/01/2012,Iowa,2383466,1665187,1577773,87414
01/01/2012,Kansas,2168823,1494362,1405492,88870
01/01/2012,Kentucky,3381405,2050998,1876189,174809
01/01/2012,Louisiana,3492387,2087233,1938549,148684
01/01/2012,Maine,1081268,699764,649142,50622
01/01/2012,Maryland,4580372,3108021,2892744,215277
01/01/2012,Massachusetts,5326196,3498166,3262377,235789
01/01/2012,Michigan,7775523,4681300,4250546,430754
01/01/2012,Minnesota,4168954,2947490,2776132,171358
01/01/2012,Mississippi,2250158,1338147,1216211,121936
01/01/2012,Missouri,4661081,3013958,2784819,229139
01/01/2012,Montana,788035,504102,473787,30315
01/01/2012,Nebraska,1405885,1008839,967953,40886
01/01/2012,Nevada,2108162,1363603,1195245,168358
01/01/2012,Ohio,9011434,5734275,5284949,449326
01/01/2012,Oklahoma,2882186,1786242,1692448,93794
01/01/2012,Oregon,3084630,1988854,1808723,180131
01/01/2012,Pennsylvania,10142177,6412680,5929453,483227
01/01/2012,Tennessee,4999080,3097157,2843050,254107
01/01/2012,Texas,19165965,12571937,11683759,888178
01/01/2012,Utah,2009736,1335279,1265082,70197
01/01/2012,Vermont,511126,355362,337888,17474
01/01/2012,Virginia,6285701,4222321,3959095,263226
01/01/2012,Washington,5349660,3452355,3177413,274942
01/01/2012,Wisconsin,4470446,3070628,2854971,215657
01/01/2012,Wyoming,440634,304445,286913,17532
01/02/2012,Alabama,3737775,2175635,1992089,183546
01/02/2012,Alaska,533089,364748,337774,26974
01/02/2012,Arizona,4976397,3048882,2786310,262572
01/02/2012,Arkansas,2262688,1360339,1260404,99935
01/02/2012,California,29169798,18447162,16411184,2035978
01/02/2012,Colorado,3967744,2744941,2517116,227825
01/02/2012,Connecticut,2839834,1908624,1749642,158982
01/02/2012,Delaware,716266,446164,415034,31130
01/02/2012,Florida,15351863,9296328,8454837,841491
01/02/2012,Georgia,7441106,4764273,4315884,448389
01/02/2012,Hawaii,1062469,653076,610580,42496
01/02/2012,Idaho,1187686,770719,711923,58796
01/02/2012,Illinois,9977857,6576290,5978214,598076
01/02/2012,Indiana,5020887,3188573,2924640,263933
01/02/2012,Iowa,2384208,1663580,1577533,86047
01/02/2012,Kansas,2169771,1492333,1404669,87664
01/02/2012,Kentucky,3382463,2048659,1877591,171068
01/02/2012,Louisiana,3494007,2088242,1940786,147456
01/02/2012,Maine,1081314,699615,649301,50314
01/02/2012,Maryland,4584142,3108088,2894197,213891
01/02/2012,Massachusetts,5330155,3498974,3264746,234228
01/02/2012,Michigan,7777560,4677505,4251976,425529
01/02/2012,Minnesota,4171190,2944994,2775710,169284
01/02/2012,Mississippi,2250749,1334895,1215042,119853
01/02/2012,Missouri,4662219,3008235,2784077,224158
01/02/2012,Montana,788463,504157,474178,29979
01/02/2012,Nebraska,1406707,1008717,968546,40171
01/02/2012,Nevada,2110764,1363319,1197373,165946
01/02/2012,Ohio,9012201,5731180,5291278,439902
01/02/2012,Oklahoma,2884156,1787662,1695613,92049
01/02/2012,Oregon,3086730,1984596,1806253,178343
01/02/2012,Pennsylvania,10143682,6416137,5935248,480889
01/02/2012,Tennessee,5002582,3094096,2843731,250365
01/02/2012,Texas,19194543,12581835,11704383,877452
01/02/2012,Utah,2012392,1331198,1268263,62935
01/02/2012,Vermont,511107,354783,337552,17231
01/02/2012,Virginia,6292490,4218049,3958507,259542
01/02/2012,Washington,5355254,3459848,3185999,273849
01/02/2012,Wisconsin,4471727,3068522,2855567,212955
01/02/2012,Wyoming,441268,304220,287031,17189
01/03/2012,Alabama,3739321,2173644,1991104,182540
01/03/2012,Alaska,533381,364426,337625,26801
01/03/2012,Arizona,4982803,3050044,2789251,260793
01/03/2012,Arkansas,2263565,1358109,1258810,99299
01/03/2012,California,29195443,18445792,16424830,2020962
01/03/2012,Colorado,3972960,2743601,2516649,226952
01/03/2012,Connecticut,2841002,1904314,1745620,158694
01/03/2012,Delaware,716829,446185,414992,31193
01/03/2012,Florida,15369634,9303773,8468399,835374
01/03/2012,Georgia,7449017,4764404,4318945,445459
01/03/2012,Hawaii,1062816,651755,609893,41862
01/03/2012,Idaho,1188795,771103,712536,58567
01/03/2012,Illinois,9980816,6574536,5981261,593275
01/03/2012,Indiana,5023170,3180618,2919810,260808
01/03/2012,Iowa,2385211,1662015,1576690,85325
01/03/2012,Kansas,2170593,1490738,1403751,86987
01/03/2012,Kentucky,3383526,2048252,1879434,168818
01/03/2012,Louisiana,3495696,2089768,1943114,146654
01/03/2012,Maine,1081497,699718,649374,50344
01/03/2012,Maryland,4587822,3108973,2895102,213871
01/03/2012,Massachusetts,5334673,3500416,3266409,234007
01/03/2012,Michigan,7780449,4674978,4251685,423293
01/03/2012,Minnesota,4173907,2943537,2775538,167999
01/03/2012,Mississippi,2251220,1332365,1213667,118698
01/03/2012,Missouri,4663809,3004112,2783008,221104
01/03/2012,Montana,788963,504449,474559,29890
01/03/2012,Nebraska,1407566,1008820,969077,39743
01/03/2012,Nevada,2113359,1363757,1199248,164509
01/03/2012,Ohio,9013965,5727867,5294585,433282
01/03/2012,Oklahoma,2886108,1789039,1698086,90953
01/03/2012,Oregon,3089178,1980071,1802745,177326
01/03/2012,Pennsylvania,10146344,6422861,5939931,482930
01/03/2012,Tennessee,5006319,3092834,2843922,248912
01/03/2012,Texas,19222731,12563758,11722322,841436
01/03/2012,Utah,2015192,1335297,1271263,64034
01/03/2012,Vermont,511158,354381,337236,17145
01/03/2012,Virginia,6297993,4214269,3956965,257304
01/03/2012,Washington,5360596,3466956,3192664,274292
01/03/2012,Wisconsin,4473499,3067746,2855416,212330
01/03/2012,Wyoming,441895,303990,287027,16963
01/04/2012,Alabama,3740838,2173494,1991037,182457
01/04/2012,Alaska,533893,364174,337455,26719
01/04/2012,Arizona,4989316,3051345,2791656,259689
01/04/2012,Arkansas,2264414,1355831,1256764,99067
01/04/2012,California,29222479,18449665,16440520,2009145
01/04/2012,Colorado,3978413,2743294,2516847,226447
01/04/2012,Connecticut,2842175,1899200,1740242,158958
01/04/2012,Delaware,717434,446181,414769,31412
01/04/2012,Florida,15387537,9312582,8481558,831024
01/04/2012,Georgia,7457330,4765619,4322617,443002
01/04/2012,Hawaii,1063591,650783,609546,41237
01/04/2012,Idaho,1189917,771346,713010,58336
01/04/2012,Illinois,9983758,6574291,5981264,593027
01/04/2012,Indiana,5025264,3172844,2913076,259768
01/04/2012,Iowa,2386148,1660230,1575227,85003
01/04/2012,Kansas,2171582,1489485,1402934,86551
01/04/2012,Kentucky,3384772,2049721,1881638,168083
01/04/2012,Louisiana,3497367,2090997,1945016,145981
01/04/2012,Maine,1081643,699864,649294,50570
01/04/2012,Maryland,4591610,3110612,2895918,214694
01/04/2012,Massachusetts,5339050,3501752,3267063,234689
01/04/2012,Michigan,7783072,4673683,4250642,423041
01/04/2012,Minnesota,4176493,2942677,2775106,167571
01/04/2012,Mississippi,2251754,1330658,1212323,118335
01/04/2012,Missouri,4665382,3001221,2782139,219082
01/04/2012,Montana,789449,504942,474995,29947
01/04/2012,Nebraska,1408411,1009179,969646,39533
01/04/2012,Nevada,2116001,1364616,1200986,163630
01/04/2012,Ohio,9015464,5721910,5293517,428393
01/04/2012,Oklahoma,2888262,1790363,1699795,90568
01/04/2012,Oregon,3091529,1975219,1798555,176664
01/04/2012,Pennsylvania,10148660,6431482,5943284,488198
01/04/2012,Tennessee,5010012,3092229,2843514,248715
01/04/2012,Texas,19251790,12588954,11737849,851105
01/04/2012,Utah,2017934,1338994,1274152,64842
01/04/2012,Vermont,511169,354130,336947,17183
01/04/2012,Virginia,6304108,4210876,3954894,255982
01/04/2012,Washington,5366242,3472271,3196410,275861
01/04/2012,Wisconsin,4475073,3067471,2854173,213298
01/04/2012,Wyoming,442538,303802,286933,16869
01/05/2012,Alabama,3742396,2174754,1992484,182270
01/05/2012,Alaska,534483,364032,337365,26667
01/05/2012,Arizona,4995794,3052719,2794227,258492
01/05/2012,Arkansas,2265279,1353594,1254657,98937
01/05/2012,California,29249074,18457489,16462781,1994708
01/05/2012,Colorado,3984038,2744233,2518570,225663
01/05/2012,Connecticut,2843391,1893644,1734363,159281
01/05/2012,Delaware,717996,446177,414524,31653
01/05/2012,Florida,15405602,9322199,8496177,826022
01/05/2012,Georgia,7465750,4767757,4327976,439781
01/05/2012,Hawaii,1064477,650165,609679,40486
01/05/2012,Idaho,1191067,771563,713524,58039
01/05/2012,Illinois,9986723,6576078,5981247,594831
01/05/2012,Indiana,5027375,3166824,2906905,259919
01/05/2012,Iowa,2387179,1658427,1573642,84785
01/05/2012,Kansas,2172714,1488736,1402661,86075
01/05/2012,Kentucky,3386098,2052837,1884530,168307
01/05/2012,Louisiana,3499054,2091414,1946434,144980
01/05/2012,Maine,1081842,700078,649263,50815
01/05/2012,Maryland,4595395,3113280,2897677,215603
01/05/2012,Massachusetts,5343485,3503312,3267718,235594
01/05/2012,Michigan,7785658,4674360,4250834,423526
01/05/2012,Minnesota,4179146,2942728,2775088,167640
01/05/2012,Mississippi,2252365,1329787,1211394,118393
01/05/2012,Missouri,4667067,2999746,2782417,217329
01/05/2012,Montana,789993,505634,475624,30010
01/05/2012,Nebraska,1409361,1009977,970546,39431
01/05/2012,Nevada,2118612,1365728,1202977,162751
01/05/2012,Ohio,9016980,5714684,5290887,423797
01/05/2012,Oklahoma,2890509,1791951,1701275,90676
01/05/2012,Oregon,3093887,1970481,1794592,175889
01/05/2012,Pennsylvania,10151079,6440986,5946445,494541
01/05/2012,Tennessee,5013814,3092082,2843398,248684
01/05/2012,Texas,19280899,12611625,11754758,856867
01/05/2012,Utah,2020773,1342475,1277306,65169
01/05/2012,Vermont,511223,354020,336755,17265
01/05/2012,Virginia,6310753,4208645,3953818,254827
01/05/2012,Washington,5372135,3475950,3198232,277718
01/05/2012,Wisconsin,4476792,3067402,2852787,214615
01/05/2012,Wyoming,443188,303711,286848,16863
01/06/2012,Alabama,3744108,2176818,1995546,181272
01/06/2012,Alaska,535035,363960,337406,26554
01/06/2012,Arizona,5002599,3054066,2797416,256650
01/06/2012,Arkansas,2266248,1351226,1252563,98663
01/06/2012,California,29277450,18468110,16494261,1973849
01/06/2012,Colorado,3989781,2746042,2521989,224053
01/06/2012,Connecticut,2844747,1887999,1728720,159279
01/06/2012,Delaware,718652,446176,414378,31798
01/06/2012,Florida,15424547,9332286,8513758,818528
01/06/2012,Georgia,7474404,4770468,4335207,435261
01/06/2012,Hawaii,1065305,649786,610269,39517
01/06/2012,Idaho,1192291,771845,714218,57627
01/06/2012,Illinois,9990366,6579685,5983696,595989
01/06/2012,Indiana,5029844,3163404,2903332,260072
01/06/2012,Iowa,2388331,1657167,1572697,84470
01/06/2012,Kansas,2173881,1488524,1403130,85394
01/06/2012,Kentucky,3387548,2057041,1888219,168822
01/06/2012,Louisiana,3500949,2090759,1947689,143070
01/06/2012,Maine,1082090,700348,649429,50919
01/06/2012,Maryland,4599386,3116975,2900940,216035
01/06/2012,Massachusetts,5348291,3505430,3269278,236152
01/06/2012,Michigan,7788775,4676951,4253239,423712
01/06/2012,Minnesota,4182116,2944302,2776517,167785
01/06/2012,Mississippi,2253035,1329476,1211194,118282
01/06/2012,Missouri,4668979,2999577,2784194,215383
01/06/2012,Montana,790548,506446,476486,29960
01/06/2012,Nebraska,1410340,1011216,971883,39333
01/06/2012,Nevada,2121395,1366798,1205447,161351
01/06/2012,Ohio,9019108,5708474,5289595,418879
01/06/2012,Oklahoma,2892866,1793879,1702959,90920
01/06/2012,Oregon,3096538,1966171,1791433,174738
01/06/2012,Pennsylvania,10154135,6450474,5950829,499645
01/06/2012,Tennessee,5017869,3092371,2844370,248001
01/06/2012,Texas,19311048,12632078,11776105,855973
01/06/2012,Utah,2023694,1345980,1280955,65025
01/06/2012,Vermont,511282,353999,336688,17311
01/06/2012,Virginia,6317350,4208558,3955368,253190
01/06/2012,Washington,5378257,3478835,3199945,278890
01/06/2012,Wisconsin,4478791,3067586,2852421,215165
01/06/2012,Wyoming,443886,303733,286852,16881
01/07/2012,Alabama,3745940,2178985,1999860,179125
01/07/2012,Alaska,535584,363887,337576,26311
01/07/2012,Arizona,5009540,3055366,2801303,254063
01/07/2012,Arkansas,2267294,1348643,1250599,98044
01/07/2012,California,29305807,18479876,16534689,1945187
01/07/2012,Colorado,3995677,2748077,2526809,221268
01/07/2012,Connecticut,2846179,1882615,1723907,158708
01/07/2012,Delaware,719282,446132,414347,31785
01/07/2012,Florida,15443876,9342026,8534305,807721
01/07/2012,Georgia,7482739,4773009,4343500,429509
01/07/2012,Hawaii,1066084,649583,611262,38321
01/07/2012,Idaho,1193509,772210,715144,57066
01/07/2012,Illinois,9993695,6583994,5989315,594679
01/07/2012,Indiana,5032436,3162320,2902854,259466
01/07/2012,Iowa,2389557,1656736,1572880,83856
01/07/2012,Kansas,2175109,1488847,1404335,84512
01/07/2012,Kentucky,3389137,2061588,1892555,169033
01/07/2012,Louisiana,3502948,2089201,1949077,140124
01/07/2012,Maine,1082354,700592,649809,50783
01/07/2012,Maryland,4603555,3121317,2905634,215683
01/07/2012,Massachusetts,5353276,3507770,3271778,235992
01/07/2012,Michigan,7792111,4680759,4257873,422886
01/07/2012,Minnesota,4185165,2947024,2779521,167503
01/07/2012,Mississippi,2253714,1329451,1211838,117613
01/07/2012,Missouri,4670914,3000439,2787304,213135
01/07/2012,Montana,791138,507185,477470,29715
01/07/2012,Nebraska,1411388,1012787,973628,39159
01/07/2012,Nevada,2124233,1367483,1208382,159101
01/07/2012,Ohio,9021458,5703982,5290271,413711
01/07/2012,Oklahoma,2895161,1795981,1705012,90969
01/07/2012,Oregon,3099215,1962128,1789026,173102
01/07/2012,Pennsylvania,10157546,6458986,5957166,501820
01/07/2012,Tennessee,5022071,3093294,2847096,246198
01/07/2012,Texas,19341277,12649825,11802014,847811
01/07/2012,Utah,2026680,1349636,1285107,64529
01/07/2012,Vermont,511355,353993,336722,17271
01/07/2012,Virginia,6324085,4210712,3960179,250533
01/07/2012,Washington,5384419,3475293,3203044,272249
01/07/2012,Wisconsin,4480877,3068026,2853712,214314
01/07/2012,Wyoming,444553,303794,286966,16828
01/08/2012,Alabama,3748082,2180942,2004716,176226
01/08/2012,Alaska,535878,363879,337853,26026
01/08/2012,Arizona,5016602,3056822,2805561,251261
01/08/2012,Arkansas,2268387,1346157,1248907,97250
01/08/2012,California,29335993,18494681,16581684,1912997
01/08/2012,Colorado,4001980,2750560,2532901,217659
01/08/2012,Connecticut,2847427,1878205,1720408,157797
01/08/2012,Delaware,720044,446071,414386,31685
01/08/2012,Florida,15465332,9352027,8556664,795363
01/08/2012,Georgia,7489471,4775669,4351928,423741
01/08/2012,Hawaii,1066807,649534,612513,37021
01/08/2012,Idaho,1194918,772638,716202,56436
01/08/2012,Illinois,9997508,6588983,5997041,591942
01/08/2012,Indiana,5035833,3163313,2904676,258637
01/08/2012,Iowa,2391195,1657235,1574109,83126
01/08/2012,Kansas,2176025,1489743,1405991,83752
01/08/2012,Kentucky,3391439,2065968,1897095,168873
01/08/2012,Louisiana,3505274,2087894,1950819,137075
01/08/2012,Maine,1082712,700906,650411,50495
01/08/2012,Maryland,4607139,3126121,2911289,214832
01/08/2012,Massachusetts,5358546,3510235,3274743,235492
01/08/2012,Michigan,7796014,4685915,4264274,421641
01/08/2012,Minnesota,4188566,2950631,2783832,166799
01/08/2012,Mississippi,2254835,1329468,1212890,116578
01/08/2012,Missouri,4673088,3002370,2791175,211195
01/08/2012,Montana,791933,507764,478438,29326
01/08/2012,Nebraska,1412373,1014558,975571,38987
01/08/2012,Nevada,2127048,1367955,1211574,156381
01/08/2012,Ohio,9025886,5701818,5292044,409774
01/08/2012,Oklahoma,2897653,1798319,1707423,90896
01/08/2012,Oregon,3101836,1958250,1786947,171303
01/08/2012,Pennsylvania,10160869,6466612,5964896,501716
01/08/2012,Tennessee,5026242,3095301,2851322,243979
01/08/2012,Texas,19372177,12666216,11830108,836108
01/08/2012,Utah,2030026,1353555,1289584,63971
01/08/2012,Vermont,511540,353956,336820,17136
01/08/2012,Virginia,6329538,4215085,3967765,247320
01/08/2012,Washington,5389609,3472450,3207615,264835
01/08/2012,Wisconsin,4483459,3068963,2856403,212560
01/08/2012,Wyoming,444980,303836,287159,16677
01/09/2012,Alabama,3750371,2182771,2009352,173419
01/09/2012,Alaska,536044,364057,338216,25841
01/09/2012,Arizona,5023844,3058702,2809750,248952
01/09/2012,Arkansas,2269551,1344172,1247567,96605
01/09/2012,California,29367307,18515366,16631825,1883541
01/09/2012,Colorado,4008367,2753956,2539967,213989
01/09/2012,Connecticut,2848760,1875209,1718236,156973
01/09/2012,Delaware,720904,446070,414465,31605
01/09/2012,Florida,15487278,9363037,8578931,784106
01/09/2012,Georgia,7496368,4778749,4359383,419366
01/09/2012,Hawaii,1067398,649620,613823,35797
01/09/2012,Idaho,1196379,773091,717238,55853
01/09/2012,Illinois,10001763,6594683,6003932,590751
01/09/2012,Indiana,5039417,3166249,2907739,258510
01/09/2012,Iowa,2393002,1658681,1576085,82596
01/09/2012,Kansas,2176962,1491050,1407653,83397
01/09/2012,Kentucky,3393813,2069786,1901222,168564
01/09/2012,Louisiana,3507678,2088122,1953077,135045
01/09/2012,Maine,1083081,701441,651204,50237
01/09/2012,Maryland,4610857,3131152,2917104,214048
01/09/2012,Massachusetts,5364133,3512915,3277612,235303
01/09/2012,Michigan,7800273,4692724,4271479,421245
01/09/2012,Minnesota,4192145,2955118,2789269,165849
01/09/2012,Mississippi,2255957,1329339,1213704,115635
01/09/2012,Missouri,4675357,3005264,2795016,210248
01/09/2012,Montana,792794,508244,479327,28917
01/09/2012,Nebraska,1413365,1016381,977411,38970
01/09/2012,Nevada,2129876,1368573,1214739,153834
01/09/2012,Ohio,9030686,5702365,5293329,409036
01/09/2012,Oklahoma,2900237,1800762,1709795,90967
01/09/2012,Oregon,3104634,1954589,1784773,169816
01/09/2012,Pennsylvania,10164609,6473455,5972618,500837
01/09/2012,Tennessee,5030564,3098402,2855937,242465
01/09/2012,Texas,19403718,12683588,11857386,826202
01/09/2012,Utah,2033498,1357700,1294133,63567
01/09/2012,Vermont,511749,353835,336908,16927
01/09/2012,Virginia,6334899,4221076,3976567,244509
01/09/2012,Washington,5394909,3470187,3212569,257618
01/09/2012,Wisconsin,4486283,3070787,2859838,210949
01/09/2012,Wyoming,445436,303842,287381,16461
01/10/2012,Alabama,3752500,2184006,2012918,171088
01/10/2012,Alaska,536291,364283,338526,25757
01/10/2012,Arizona,5030865,3060209,2812844,247365
01/10/2012,Arkansas,2270630,1342472,1246289,96183
01/10/2012,California,29397331,18536565,16678616,1857949
01/10/2012,Colorado,4014667,2757466,2546891,210575
01/10/2012,Connecticut,2849989,1873204,1716902,156302
01/10/2012,Delaware,721681,446007,414443,31564
01/10/2012,Florida,15508601,9372631,8597972,774659
01/10/2012,Georgia,7503210,4780398,4364003,416395
01/10/2012,Hawaii,1068094,649565,614838,34727
01/10/2012,Idaho,1197771,773385,718040,55345
01/10/2012,Illinois,10005658,6598498,6006076,592422
01/10/2012,Indiana,5042788,3169729,2910539,259190
01/10/2012,Iowa,2394680,1660482,1578228,82254
01/10/2012,Kansas,2177847,1492122,1408760,83362
01/10/2012,Kentucky,3396151,2072317,1904250,168067
01/10/2012,Louisiana,3510000,2089992,1955491,134501
01/10/2012,Maine,1083447,702058,652017,50041
01/10/2012,Maryland,4614496,3135207,2921744,213463
01/10/2012,Massachusetts,5369430,3514788,3279317,235471
01/10/2012,Michigan,7804152,4699999,4278209,421790
01/10/2012,Minnesota,4195557,2959485,2795149,164336
01/10/2012,Mississippi,2257102,1328815,1213839,114976
01/10/2012,Missouri,4677466,3007710,2797738,209972
01/10/2012,Montana,793568,508604,480064,28540
01/10/2012,Nebraska,1414318,1017762,978737,39025
01/10/2012,Nevada,2132662,1369063,1217434,151629
01/10/2012,Ohio,9035065,5703549,5291979,411570
01/10/2012,Oklahoma,2902708,1802490,1711251,91239
01/10/2012,Oregon,3107259,1950570,1782030,168540
01/10/2012,Pennsylvania,10167893,6477053,5977594,499459
01/10/2012,Tennessee,5034781,3101365,2859257,242108
01/10/2012,Texas,19434632,12700534,11879763,820771
01/10/2012,Utah,2036856,1361555,1298314,63241
01/10/2012,Vermont,511935,353543,336872,16671
01/10/2012,Virginia,6340613,4226595,3984368,242227
01/10/2012,Washington,5400070,3467617,3216647,250970
01/10/2012,Wisconsin,4488898,3072854,2862941,209913
01/10/2012,Wyoming,445861,303715,287540,16175
01/11/2012,Alabama,3754422,2184400,2015057,169343
01/11/2012,Alaska,536679,364384,338657,25727
01/11/2012,Arizona,5037642,3060910,2814217,246693
01/11/2012,Arkansas,2271525,1340897,1244873,96024
01/11/2012,California,29427545,18553309,16717341,1835968
01/11/2012,Colorado,4020894,2760368,2552987,207381
01/11/2012,Connecticut,2851060,1871522,1715773,155749
01/11/2012,Delaware,722434,445776,414226,31550
01/11/2012,Florida,15529025,9379264,8612023,767241
01/11/2012,Georgia,7510285,4779443,4365109,414334
01/11/2012,Hawaii,1069163,649173,615327,33846
01/11/2012,Idaho,1199143,773460,718524,54936
01/11/2012,Illinois,10009289,6598094,6001684,596410
01/11/2012,Indiana,5045719,3172886,2912626,260260
01/11/2012,Iowa,2396074,1661913,1579766,82147
01/11/2012,Kansas,2178728,1492672,1409248,83424
01/11/2012,Kentucky,3398358,2073384,1905934,167450
01/11/2012,Louisiana,3512113,2092996,1957453,135543
01/11/2012,Maine,1083716,702606,652681,49925
01/11/2012,Maryland,4617887,3137652,2924538,213114
01/11/2012,Massachusetts,5374322,3515318,3279422,235896
01/11/2012,Michigan,7807358,4706523,4283628,422895
01/11/2012,Minnesota,4198575,2962759,2800283,162476
01/11/2012,Mississippi,2258163,1327884,1213261,114623
01/11/2012,Missouri,4679343,3008994,2799168,209826
01/11/2012,Montana,794361,508875,480628,28247
01/11/2012,Nebraska,1415169,1018499,979433,39066
01/11/2012,Nevada,2135395,1369310,1219490,149820
01/11/2012,Ohio,9038657,5703304,5287084,416220
01/11/2012,Oklahoma,2905208,1802927,1711235,91692
01/11/2012,Oregon,3109580,1945807,1778641,167166
01/11/2012,Pennsylvania,10170070,6475700,5977993,497707
01/11/2012,Tennessee,5038650,3103321,2860286,243035
01/11/2012,Texas,19465766,12716045,11895325,820720
01/11/2012,Utah,2040092,1364818,1301946,62872
01/11/2012,Vermont,512079,353111,336683,16428
01/11/2012,Virginia,6346515,4230245,3989727,240518
01/11/2012,Washington,5405191,3464221,3219140,245081
01/11/2012,Wisconsin,4491084,3074792,2864732,210060
01/11/2012,Wyoming,446255,303456,287578,15878
01/12/2012,Alabama,3756121,2183700,2015725,167975
01/12/2012,Alaska,537018,364287,338581,25706
01/12/2012,Arizona,5044028,3060362,2813704,246658
01/12/2012,Arkansas,2272297,1339452,1243386,96066
01/12/2012,California,29455494,18562700,16747321,1815379
01/12/2012,Colorado,4026842,2762211,2558031,204180
01/12/2012,Connecticut,2851914,1869431,1714212,155219
01/12/2012,Delaware,723135,445343,413820,31523
01/12/2012,Florida,15548277,9382701,8621568,761133
01/12/2012,Georgia,7516903,4776076,4363590,412486
01/12/2012,Hawaii,1070064,648487,615337,33150
01/12/2012,Idaho,1200386,773323,718703,54620
01/12/2012,Illinois,10012126,6592899,5991770,601129
01/12/2012,Indiana,5048319,3175152,2914128,261024
01/12/2012,Iowa,2397326,1662647,1580457,82190
01/12/2012,Kansas,2179407,1492648,1409265,83383
01/12/2012,Kentucky,3400281,2072953,1906182,166771
01/12/2012,Louisiana,3514047,2096245,1958519,137726
01/12/2012,Maine,1083895,703024,653171,49853
01/12/2012,Maryland,4621036,3138497,2925667,212830
01/12/2012,Massachusetts,5378843,3514801,3278423,236378
01/12/2012,Michigan,7810081,4711644,4287975,423669
01/12/2012,Minnesota,4201294,2964526,2803934,160592
01/12/2012,Mississippi,2259083,1326506,1212063,114443
01/12/2012,Missouri,4680944,3009177,2799741,209436
01/12/2012,Montana,795056,509103,481061,28042
01/12/2012,Nebraska,1415931,1018587,979573,39014
01/12/2012,Nevada,2137941,1369233,1220968,148265
01/12/2012,Ohio,9041658,5701489,5279998,421491
01/12/2012,Oklahoma,2907466,1802218,1709988,92230
01/12/2012,Oregon,3111712,1940426,1775016,165410
01/12/2012,Pennsylvania,10171681,6469454,5974427,495027
01/12/2012,Tennessee,5042229,3103871,2859008,244863
01/12/2012,Texas,19495239,12730458,11905455,825003
01/12/2012,Utah,2043202,1367434,1305067,62367
01/12/2012,Vermont,512177,352575,336348,16227
01/12/2012,Virginia,6351838,4231663,3992299,239364
01/12/2012,Washington,5409915,3459702,3219911,239791
01/12/2012,Wisconsin,4493010,3076106,2864807,211299
01/12/2012,Wyoming,446641,303094,287479,15615
01/01/2013,Alabama,3757648,2181651,2015043,166608
01/01/2013,Alaska,537343,364023,338344,25679
01/01/2013,Arizona,5050211,3058620,2811785,246835
01/01/2013,Arkansas,2272945,1338053,1241811,96242
01/01/2013,California,29482749,18564212,16769858,1794354
01/01/2013,Colorado,4032567,2762675,2561687,200988
01/01/2013,Connecticut,2852640,1866718,1712022,154696
01/01/2013,Delaware,723860,444691,413236,31455
01/01/2013,Florida,15566837,9383321,8628007,755314
01/01/2013,Georgia,7523422,4771071,4360605,410466
01/01/2013,Hawaii,1070910,647730,615167,32563
01/01/2013,Idaho,1201563,773064,718684,54380
01/01/2013,Illinois,10014774,6584280,5978819,605461
01/01/2013,Indiana,5050615,3176337,2915330,261007
01/01/2013,Iowa,2398438,1662643,1580382,82261
01/01/2013,Kansas,2179995,1492010,1408859,83151
01/01/2013,Kentucky,3402047,2071047,1904810,166237
01/01/2013,Louisiana,3515759,2098900,1958670,140230
01/01/2013,Maine,1084015,703233,653477,49756
01/01/2013,Maryland,4623925,3138015,2925435,212580
01/01/2013,Massachusetts,5383100,3513585,3276681,236904
01/01/2013,Michigan,7812340,4715747,4292124,423623
01/01/2013,Minnesota,4203761,2964871,2806119,158752
01/01/2013,Mississippi,2259916,1316549,1202216,114333
01/01/2013,Missouri,4682302,3008594,2799781,208813
01/01/2013,Montana,795706,509349,481423,27926
01/01/2013,Nebraska,1416648,1018110,979223,38887
01/01/2013,Nevada,2140368,1368931,1222071,146860
01/01/2013,Ohio,9044122,5699301,5272736,426565
01/01/2013,Oklahoma,2909622,1800908,1708092,92816
01/01/2013,Oregon,3113662,1934879,1771649,163230
01/01/2013,Pennsylvania,10172653,6459448,5968637,490811
01/01/2013,Tennessee,5045479,3102423,2855543,246880
01/01/2013,Texas,19524317,12743658,11912520,831138
01/01/2013,Utah,2046163,1369579,1307839,61740
01/01/2013,Vermont,512268,351969,335874,16095
01/01/2013,Virginia,6356655,4230986,3992211,238775
01/01/2013,Washington,5414242,3457127,3219092,238035
01/01/2013,Wisconsin,4494635,3076445,2863647,212798
01/01/2013,Wyoming,446965,302668,287303,15365
01/02/2013,Alabama,3758678,2178756,2013876,164880
01/02/2013,Alaska,537489,363684,338057,25627
01/02/2013,Arizona,5055713,3056893,2810201,246692
01/02/2013,Arkansas,2273256,1336764,1240366,96398
01/02/2013,California,29506019,18561589,16789624,1771965
01/02/2013,Colorado,4037908,2762415,2564483,197932
01/02/2013,Connecticut,2852925,1864254,1710153,154101
01/02/2013,Delaware,724430,443906,412611,31295
01/02/2013,Florida,15582898,9383328,8634844,748484
01/02/2013,Georgia,7528788,4765817,4357909,407908
01/02/2013,Hawaii,1071588,647257,615252,32005
01/02/2013,Idaho,1202567,773031,718812,54219
01/02/2013,Illinois,10015870,6574749,5966349,608400
01/02/2013,Indiana,5052297,3177057,2917239,259818
01/02/2013,Iowa,2399210,1662690,1580469,82221
01/02/2013,Kansas,2180283,1491109,1408465,82644
01/02/2013,Kentucky,3403390,2068320,1902317,166003
01/02/2013,Louisiana,3517123,2100577,1958498,142079
01/02/2013,Maine,1083932,703337,653775,49562
01/02/2013,Maryland,4626344,3136770,2924605,212165
01/02/2013,Massachusetts,5386735,3512599,3275220,237379
01/02/2013,Michigan,7813604,4719805,4297093,422712
01/02/2013,Minnesota,4205765,2964112,2807168,156944
01/02/2013,Mississippi,2260438,1306538,1192627,113911
01/02/2013,Missouri,4682883,3008137,2800121,208016
01/02/2013,Montana,796277,509687,481801,27886
01/02/2013,Nebraska,1417132,1017500,978771,38729
01/02/2013,Nevada,2142588,1368771,1223325,145446
01/02/2013,Ohio,9045438,5698685,5268265,430420
01/02/2013,Oklahoma,2911344,1799714,1706445,93269
01/02/2013,Oregon,3115248,1929899,1769268,160631
01/02/2013,Pennsylvania,10172294,6448317,5963576,484741
01/02/2013,Tennessee,5048169,3099418,2851148,248270
01/02/2013,Texas,19550750,12757010,11921233,835777
01/02/2013,Utah,2048975,1371797,1310766,61031
01/02/2013,Vermont,512289,351387,335357,16030
01/02/2013,Virginia,6360904,4229626,3991100,238526
01/02/2013,Washington,5418035,3447914,3217874,230040
01/02/2013,Wisconsin,4495713,3076554,2862894,213660
01/02/2013,Wyoming,447276,302300,287193,15107
01/03/2013,Alabama,3759971,2175993,2013323,162670
01/03/2013,Alaska,537668,363411,337876,25535
01/03/2013,Arizona,5061297,3056334,2810619,245715
01/03/2013,Arkansas,2273760,1335682,1239345,96337
01/03/2013,California,29528672,18560032,16812502,1747530
01/03/2013,Colorado,4043296,2762705,2567602,195103
01/03/2013,Connecticut,2853432,1863120,1709824,153296
01/03/2013,Delaware,725014,443158,412171,30987
01/03/2013,Florida,15599379,9385906,8646346,739560
01/03/2013,Georgia,7534514,4761620,4357295,404325
01/03/2013,Hawaii,1071995,647266,615831,31435
01/03/2013,Idaho,1203694,773507,719407,54100
01/03/2013,Illinois,10017644,6567333,5958222,609111
01/03/2013,Indiana,5054512,3178518,2921428,257090
01/03/2013,Iowa,2400220,1664171,1582269,81902
01/03/2013,Kansas,2180605,1490526,1408599,81927
01/03/2013,Kentucky,3404973,2065701,1899808,165893
01/03/2013,Louisiana,3518645,2101504,1958880,142624
01/03/2013,Maine,1084035,703516,654325,49191
01/03/2013,Maryland,4628785,3135411,2924180,211231
01/03/2013,Massachusetts,5390711,3513023,3275474,237549
01/03/2013,Michigan,7815609,4724478,4303586,420892
01/03/2013,Minnesota,4208174,2962646,2807616,155030
01/03/2013,Mississippi,2261049,1296897,1183985,112912
01/03/2013,Missouri,4683981,3008816,2801682,207134
01/03/2013,Montana,796883,510119,482245,27874
01/03/2013,Nebraska,1417718,1017147,978654,38493
01/03/2013,Nevada,2144822,1368999,1225232,143767
01/03/2013,Ohio,9047646,5701127,5269020,432107
01/03/2013,Oklahoma,2913218,1799353,1706007,93346
01/03/2013,Oregon,3117028,1926144,1768464,157680
01/03/2013,Pennsylvania,10172856,6439008,5961886,477122
01/03/2013,Tennessee,5051173,3095898,2847593,248305
01/03/2013,Texas,19577084,12772688,11936855,835833
01/03/2013,Utah,2051950,1374623,1314333,60290
01/03/2013,Vermont,512344,350931,334949,15982
01/03/2013,Virginia,6364931,4229584,3991308,238276
01/03/2013,Washington,5421904,3449293,3218064,231229
01/03/2013,Wisconsin,4497218,3077411,2864201,213210
01/03/2013,Wyoming,447597,302083,287262,14821
01/04/2013,Alabama,3761425,2174613,2014210,160403
01/04/2013,Alaska,537746,363341,337923,25418
01/04/2013,Arizona,5067183,3057784,2813639,244145
01/04/2013,Arkansas,2274396,1334874,1238821,96053
01/04/2013,California,29553252,18565682,16842626,1723056
01/04/2013,Colorado,4048786,2764238,2571622,192616
01/04/2013,Connecticut,2854082,1863931,1711614,152317
01/04/2013,Delaware,725670,442681,412135,30546
01/04/2013,Florida,15616676,9394008,8664776,729232
01/04/2013,Georgia,7540542,4759649,4359853,399796
01/04/2013,Hawaii,1072314,647794,616903,30891
01/04/2013,Idaho,1204876,774575,720581,53994
01/04/2013,Illinois,10020076,6564365,5956555,607810
01/04/2013,Indiana,5056968,3181648,2928625,253023
01/04/2013,Iowa,2401380,1668153,1586806,81347
01/04/2013,Kansas,2180991,1490653,1409461,81192
01/04/2013,Kentucky,3406648,2064135,1898417,165718
01/04/2013,Louisiana,3520231,2102390,1960578,141812
01/04/2013,Maine,1084137,704005,655326,48679
01/04/2013,Maryland,4631489,3134729,2925125,209604
01/04/2013,Massachusetts,5395058,3515403,3278014,237389
01/04/2013,Michigan,7818028,4730864,4311970,418894
01/04/2013,Minnesota,4210788,2961290,2808242,153048
01/04/2013,Mississippi,2261758,1288199,1176746,111453
01/04/2013,Missouri,4685292,3011278,2804770,206508
01/04/2013,Montana,797508,510594,482766,27828
01/04/2013,Nebraska,1418345,1017223,978991,38232
01/04/2013,Nevada,2147154,1369806,1227979,141827
01/04/2013,Ohio,9050334,5706929,5274989,431940
01/04/2013,Oklahoma,2915228,1800235,1707161,93074
01/04/2013,Oregon,3119039,1924158,1769494,154664
01/04/2013,Pennsylvania,10173942,6433901,5964767,469134
01/04/2013,Tennessee,5054403,3092912,2845925,246987
01/04/2013,Texas,19604472,12793456,11962083,831373
01/04/2013,Utah,2055016,1378344,1318709,59635
01/04/2013,Vermont,512436,350684,334772,15912
01/04/2013,Virginia,6368944,4232119,3994223,237896
01/04/2013,Washington,5425892,3452380,3220670,231710
01/04/2013,Wisconsin,4499003,3079639,2868180,211459
01/04/2013,Wyoming,447925,302063,287539,14524
01/05/2013,Alabama,3763029,2174482,2015808,158674
01/05/2013,Alaska,538284,363431,338083,25348
01/05/2013,Arizona,5073301,3060694,2818192,242502
01/05/2013,Arkansas,2275077,1334104,1238431,95673
01/05/2013,California,29579760,18576563,16874399,1702164
01/05/2013,Colorado,4054895,2766305,2575647,190658
01/05/2013,Connecticut,2854892,1866153,1714775,151378
01/05/2013,Delaware,726339,442526,412480,30046
01/05/2013,Florida,15635293,9405649,8686257,719392
01/05/2013,Georgia,7547515,4758784,4363716,395068
01/05/2013,Hawaii,1073510,648702,618211,30491
01/05/2013,Idaho,1206138,776008,722073,53935
01/05/2013,Illinois,10022943,6564150,5958543,605607
01/05/2013,Indiana,5059482,3185716,2937252,248464
01/05/2013,Iowa,2402634,1673821,1593137,80684
01/05/2013,Kansas,2181864,1491094,1410482,80612
01/05/2013,Kentucky,3408721,2063352,1897711,165641
01/05/2013,Louisiana,3522141,2103144,1963094,140050
01/05/2013,Maine,1084318,704715,656605,48110
01/05/2013,Maryland,4634490,3134344,2926541,207803
01/05/2013,Massachusetts,5399486,3518522,3281377,237145
01/05/2013,Michigan,7820362,4738195,4320494,417701
01/05/2013,Minnesota,4213509,2960131,2808881,151250
01/05/2013,Mississippi,2262701,1280192,1170333,109859
01/05/2013,Missouri,4687010,3014209,2808028,206181
01/05/2013,Montana,798209,510966,483222,27744
01/05/2013,Nebraska,1419166,1017337,979326,38011
01/05/2013,Nevada,2149619,1370943,1231067,139876
01/05/2013,Ohio,9053073,5713147,5281766,431381
01/05/2013,Oklahoma,2917592,1801681,1708925,92756
01/05/2013,Oregon,3121022,1923376,1771464,151912
01/05/2013,Pennsylvania,10175207,6431705,5969205,462500
01/05/2013,Tennessee,5057965,3089865,2844913,244952
01/05/2013,Texas,19633581,12816378,11991479,824899
01/05/2013,Utah,2058133,1382531,1323353,59178
01/05/2013,Vermont,512553,350554,334741,15813
01/05/2013,Virginia,6375248,4236152,3998446,237706
01/05/2013,Washington,5430881,3456355,3224598,231757
01/05/2013,Wisconsin,4500856,3082194,2873099,209095
01/05/2013,Wyoming,448342,302153,287874,14279
01/06/2013,Alabama,3764923,2174677,2016898,157779
01/06/2013,Alaska,538281,363613,338220,25393
01/06/2013,Arizona,5079772,3064094,2822985,241109
01/06/2013,Arkansas,2276045,1333280,1237985,95295
01/06/2013,California,29606950,18587359,16900895,1686464
01/06/2013,Colorado,4060727,2768303,2579085,189218
01/06/2013,Connecticut,2855924,1868813,1718256,150557
01/06/2013,Delaware,727078,442641,413085,29556
01/06/2013,Florida,15654708,9417639,8706200,711439
01/06/2013,Georgia,7554106,4757233,4366608,390625
01/06/2013,Hawaii,1073629,649806,619477,30329
01/06/2013,Idaho,1207515,777564,723613,53951
01/06/2013,Illinois,10026812,6564252,5960949,603303
01/06/2013,Indiana,5062772,3190582,2946381,244201
01/06/2013,Iowa,2404245,1679506,1599483,80023
01/06/2013,Kansas,2182471,1491270,1411118,80152
01/06/2013,Kentucky,3410807,2062469,1896774,165695
01/06/2013,Louisiana,3524095,2103648,1965593,138055
01/06/2013,Maine,1084636,705441,657855,47586
01/06/2013,Maryland,4637576,3133645,2927329,206316
01/06/2013,Massachusetts,5404700,3520920,3284024,236896
01/06/2013,Michigan,7823981,4745039,4327389,417650
01/06/2013,Minnesota,4216855,2959310,2809549,149761
01/06/2013,Mississippi,2263641,1272370,1163744,108626
01/06/2013,Missouri,4689032,3015995,2810122,205873
01/06/2013,Montana,798963,511208,483568,27640
01/06/2013,Nebraska,1420027,1017004,979203,37801
01/06/2013,Nevada,2152150,1372012,1233932,138080
01/06/2013,Ohio,9057146,5717334,5285529,431805
01/06/2013,Oklahoma,2919929,1802864,1710192,92672
01/06/2013,Oregon,3123530,1923051,1773458,149593
01/06/2013,Pennsylvania,10178028,6429380,5971295,458085
01/06/2013,Tennessee,5061823,3085954,2843190,242764
01/06/2013,Texas,19662766,12837490,12018765,818725
01/06/2013,Utah,2061510,1386526,1327663,58863
01/06/2013,Vermont,512724,350425,334728,15697
01/06/2013,Virginia,6379556,4240224,4002240,237984
01/06/2013,Washington,5435401,3460427,3228621,231806
01/06/2013,Wisconsin,4503389,3083584,2876730,206854
01/06/2013,Wyoming,448731,302234,288123,14111
01/07/2013,Alabama,3766869,2174320,2016720,157600
01/07/2013,Alaska,538697,363803,338308,25495
01/07/2013,Arizona,5086380,3067255,2827358,239897
01/07/2013,Arkansas,2276997,1332281,1237390,94891
01/07/2013,California,29635123,18593103,16919448,1673655
01/07/2013,Colorado,4067025,2769662,2581932,187730
01/07/2013,Connecticut,2857034,1870801,1721124,149677
01/07/2013,Delaware,727812,442935,413831,29104
01/07/2013,Florida,15674637,9427528,8722512,705016
01/07/2013,Georgia,7560981,4753872,4367542,386330
01/07/2013,Hawaii,1074519,650974,620569,30405
01/07/2013,Idaho,1208893,779087,725099,53988
01/07/2013,Illinois,10030317,6562584,5961642,600942
01/07/2013,Indiana,5065926,3196530,2956324,240206
01/07/2013,Iowa,2405753,1683993,1604608,79385
01/07/2013,Kansas,2183388,1490847,1411224,79623
01/07/2013,Kentucky,3413114,2060497,1894998,165499
01/07/2013,Louisiana,3526293,2103958,1967784,136174
01/07/2013,Maine,1084942,705989,658878,47111
01/07/2013,Maryland,4640951,3132042,2927100,204942
01/07/2013,Massachusetts,5409770,3521770,3285397,236373
01/07/2013,Michigan,7827369,4749853,4332010,417843
01/07/2013,Minnesota,4220108,2959245,2810761,148484
01/07/2013,Mississippi,2264709,1268048,1160302,107746
01/07/2013,Missouri,4691093,3015876,2810658,205218
01/07/2013,Montana,799737,511458,483921,27537
01/07/2013,Nebraska,1420974,1015997,978454,37543
01/07/2013,Nevada,2154816,1372712,1236337,136375
01/07/2013,Ohio,9061057,5718793,5285992,432801
01/07/2013,Oklahoma,2922377,1803164,1710369,92795
01/07/2013,Oregon,3125928,1922652,1775086,147566
01/07/2013,Pennsylvania,10180604,6424767,5969474,455293
01/07/2013,Tennessee,5065824,3080892,2840265,240627
01/07/2013,Texas,19692871,12855277,12041788,813489
01/07/2013,Utah,2064852,1389933,1331380,58553
01/07/2013,Vermont,512904,350240,334676,15564
01/07/2013,Virginia,6385274,4243322,4005011,238311
01/07/2013,Washington,5440583,3464183,3232372,231811
01/07/2013,Wisconsin,4505801,3083217,2878077,205140
01/07/2013,Wyoming,449152,302271,288226,14045
01/08/2013,Alabama,3768499,2172637,2015204,157433
01/08/2013,Alaska,539112,363845,338340,25505
01/08/2013,Arizona,5094765,3069196,2831079,238117
01/08/2013,Arkansas,2278011,1330709,1236614,94095
01/08/2013,California,29665950,18587188,16930930,1656258
01/08/2013,Colorado,4073981,2769322,2584166,185156
01/08/2013,Connecticut,2858175,1871349,1723188,148161
01/08/2013,Delaware,728676,443283,414660,28623
01/08/2013,Florida,15699539,9432470,8735091,697379
01/08/2013,Georgia,7568874,4747684,4366691,380993
01/08/2013,Hawaii,1075489,652138,621567,30571
01/08/2013,Idaho,1210463,780447,726569,53878
01/08/2013,Illinois,10032173,6556695,5960397,596298
01/08/2013,Indiana,5068571,3201733,2966614,235119
01/08/2013,Iowa,2407129,1686408,1607835,78573
01/08/2013,Kansas,2184718,1489665,1411057,78608
01/08/2013,Kentucky,3414664,2056498,1892207,164291
01/08/2013,Louisiana,3528368,2103449,1969745,133704
01/08/2013,Maine,1085388,705978,659479,46499
01/08/2013,Maryland,4643937,3128842,2925935,202907
01/08/2013,Massachusetts,5414595,3520422,3285726,234696
01/08/2013,Michigan,7830628,4750495,4334709,415786
01/08/2013,Minnesota,4223049,2959719,2812839,146880
01/08/2013,Mississippi,2265558,1254811,1148171,106640
01/08/2013,Missouri,4693101,3013797,2810184,203613
01/08/2013,Montana,800442,511695,484345,27350
01/08/2013,Nebraska,1422003,1014398,977305,37093
01/08/2013,Nevada,2158236,1372608,1238307,134301
01/08/2013,Ohio,9064677,5716629,5284908,431721
01/08/2013,Oklahoma,2924485,1802134,1709443,92691
01/08/2013,Oregon,3129332,1921985,1776755,145230
01/08/2013,Pennsylvania,10183403,6416123,5964676,451447
01/08/2013,Tennessee,5069972,3074336,2836800,237536
01/08/2013,Texas,19728313,12867238,12061310,805928
01/08/2013,Utah,2067849,1392500,1334511,57989
01/08/2013,Vermont,512966,349953,334580,15373
01/08/2013,Virginia,6391397,4244602,4007012,237590
01/08/2013,Washington,5448331,3466584,3235962,230622
01/08/2013,Wisconsin,4507808,3080977,2877730,203247
01/08/2013,Wyoming,449222,302231,288200,14031
01/09/2013,Alabama,3770214,2169847,2013022,156825
01/09/2013,Alaska,539171,363710,338320,25390
01/09/2013,Arizona,5103215,3069703,2834283,235420
01/09/2013,Arkansas,2279106,1328616,1235898,92718
01/09/2013,California,29696653,18570217,16939401,1630816
01/09/2013,Colorado,4080567,2767570,2586419,181151
01/09/2013,Connecticut,2859384,1870764,1724994,145770
01/09/2013,Delaware,729578,443676,415572,28104
01/09/2013,Florida,15724553,9433614,8746255,687359
01/09/2013,Georgia,7576721,4739785,4365522,374263
01/09/2013,Hawaii,1075926,653325,622633,30692
01/09/2013,Idaho,1212088,781625,728067,53558
01/09/2013,Illinois,10034545,6547345,5959101,588244
01/09/2013,Indiana,5071500,3204516,2976182,228334
01/09/2013,Iowa,2408648,1686554,1609044,77510
01/09/2013,Kansas,2185822,1488146,1411091,77055
01/09/2013,Kentucky,3416171,2050680,1888658,162022
01/09/2013,Louisiana,3530459,2102001,1971714,130287
01/09/2013,Maine,1085923,705310,659610,45700
01/09/2013,Maryland,4646932,3124472,2924492,199980
01/09/2013,Massachusetts,5419749,3517704,3286121,231583
01/09/2013,Michigan,7834323,4747499,4336984,410515
01/09/2013,Minnesota,4226279,2960319,2815492,144827
01/09/2013,Mississippi,2266375,1252815,1147763,105052
01/09/2013,Missouri,4695256,3011160,2809780,201380
01/09/2013,Montana,801146,511880,484863,27017
01/09/2013,Nebraska,1423047,1012637,976235,36402
01/09/2013,Nevada,2161607,1371772,1240084,131688
01/09/2013,Ohio,9068774,5711245,5284794,426451
01/09/2013,Oklahoma,2926590,1800109,1707972,92137
01/09/2013,Oregon,3132931,1921524,1778975,142549
01/09/2013,Pennsylvania,10186846,6404340,5959318,445022
01/09/2013,Tennessee,5074160,3066803,2833931,232872
01/09/2013,Texas,19763523,12873858,12079341,794517
01/09/2013,Utah,2070938,1394372,1337267,57105
01/09/2013,Vermont,513076,349601,334486,15115
01/09/2013,Virginia,6396539,4244434,4009047,235387
01/09/2013,Washington,5455719,3467375,3239639,227736
01/09/2013,Wisconsin,4510094,3077408,2877039,200369
01/09/2013,Wyoming,449293,302130,288119,14011
01/10/2013,Alabama,3771896,2167230,2011093,156137
01/10/2013,Alaska,539295,363558,338279,25279
01/10/2013,Arizona,5111574,3070375,2837884,232491
01/10/2013,Arkansas,2280144,1326715,1235660,91055
01/10/2013,California,29726663,18553825,16951113,1602712
01/10/2013,Colorado,4087135,2766264,2589867,176397
01/10/2013,Connecticut,2860520,1870128,1727081,143047
01/10/2013,Delaware,730453,444215,416563,27652
01/10/2013,Florida,15749207,9436839,8759566,677273
01/10/2013,Georgia,7584668,4733883,4366214,367669
01/10/2013,Hawaii,1076293,654646,623909,30737
01/10/2013,Idaho,1213707,782755,729577,53178
01/10/2013,Illinois,10036798,6539322,5960606,578716
01/10/2013,Indiana,5074366,3205501,2984597,220904
01/10/2013,Iowa,2410150,1685404,1608832,76572
01/10/2013,Kansas,2186901,1487170,1411799,75371
01/10/2013,Kentucky,3417645,2044372,1884947,159425
01/10/2013,Louisiana,3532431,2100686,1974140,126546
01/10/2013,Maine,1086416,704366,659476,44890
01/10/2013,Maryland,4649825,3120510,2923641,196869
01/10/2013,Massachusetts,5424816,3516257,3288254,228003
01/10/2013,Michigan,7837931,4744156,4340565,403591
01/10/2013,Minnesota,4229411,2961292,2818328,142964
01/10/2013,Mississippi,2267144,1250602,1147147,103455
01/10/2013,Missouri,4697387,3010507,2810589,199918
01/10/2013,Montana,801824,512116,485480,26636
01/10/2013,Nebraska,1424077,1011485,975674,35811
01/10/2013,Nevada,2164903,1371166,1242032,129134
01/10/2013,Ohio,9072686,5705087,5287632,417455
01/10/2013,Oklahoma,2928709,1798068,1706719,91349
01/10/2013,Oregon,3136440,1922159,1781810,140349
01/10/2013,Pennsylvania,10189979,6393597,5956291,437306
01/10/2013,Tennessee,5078253,3059810,2832394,227416
01/10/2013,Texas,19798357,12880739,12099121,781618
01/10/2013,Utah,2073970,1396158,1339974,56184
01/10/2013,Vermont,513176,349300,334450,14850
01/10/2013,Virginia,6401486,4244667,4011855,232812
01/10/2013,Washington,5462940,3467791,3243553,224238
01/10/2013,Wisconsin,4512294,3073994,2877113,196881
01/10/2013,Wyoming,449366,302077,288075,14002
01/11/2013,Alabama,3773384,2165715,2010028,155687
01/11/2013,Alaska,539263,363547,338306,25241
01/11/2013,Arizona,5119649,3072551,2843115,229436
01/11/2013,Arkansas,2281058,1325461,1236175,89286
01/11/2013,California,29756007,18547876,16971722,1576154
01/11/2013,Colorado,4093376,2767651,2595558,172093
01/11/2013,Connecticut,2861561,1870266,1729880,140386
01/11/2013,Delaware,731214,444909,417594,27315
01/11/2013,Florida,15772705,9446215,8777668,668547
01/11/2013,Georgia,7592498,4732267,4370024,362243
01/11/2013,Hawaii,1076475,656212,625532,30680
01/11/2013,Idaho,1215253,781042,731179,49863
01/11/2013,Illinois,10038967,6536335,5967239,569096
01/11/2013,Indiana,5077084,3206192,2992216,213976
01/11/2013,Iowa,2411521,1684452,1608558,75894
01/11/2013,Kansas,2187720,1487212,1413405,73807
01/11/2013,Kentucky,3418877,2038670,1881766,156904
01/11/2013,Louisiana,3534161,2100476,1977442,123034
01/11/2013,Maine,1086870,703474,659283,44191
01/11/2013,Maryland,4652421,3118057,2924041,194016
01/11/2013,Massachusetts,5429678,3517745,3293116,224629
01/11/2013,Michigan,7841202,4743413,4346689,396724
01/11/2013,Minnesota,4232451,2962764,2821182,141582
01/11/2013,Mississippi,2267787,1248764,1146573,102191
01/11/2013,Missouri,4699421,3012981,2813239,199742
01/11/2013,Montana,802467,512380,486132,26248
01/11/2013,Nebraska,1424973,1011351,975833,35518
01/11/2013,Nevada,2168144,1371342,1244462,126880
01/11/2013,Ohio,9076263,5700211,5294623,405588
01/11/2013,Oklahoma,2930743,1796614,1706259,90355
01/11/2013,Oregon,3139813,1924468,1785385,139083
01/11/2013,Pennsylvania,10192700,6387329,5958121,429208
01/11/2013,Tennessee,5082093,3054206,2832369,221837
01/11/2013,Texas,19832481,12892128,12124031,768097
01/11/2013,Utah,2076934,1398215,1342906,55309
01/11/2013,Vermont,513249,349089,334466,14623
01/11/2013,Virginia,6405584,4246742,4016111,230631
01/11/2013,Washington,5469691,3468654,3247718,220936
01/11/2013,Wisconsin,4514392,3071951,2878978,192973
01/11/2013,Wyoming,449390,302109,288157,13952
01/12/2013,Alabama,3774572,2165388,2009949,155439
01/12/2013,Alaska,539431,363695,338449,25246
01/12/2013,Arizona,5127350,3076382,2850146,226236
01/12/2013,Arkansas,2281785,1324767,1237331,87436
01/12/2013,California,29783733,18554149,17001882,1552267
01/12/2013,Colorado,4099604,2772177,2603433,168744
01/12/2013,Connecticut,2862341,1871503,1733625,137878
01/12/2013,Delaware,732002,445675,418596,27079
01/12/2013,Florida,15795270,9461489,8800149,661340
01/12/2013,Georgia,7600196,4734481,4376243,358238
01/12/2013,Hawaii,1077144,657879,627380,30499
01/12/2013,Idaho,1216693,779488,732868,46620
01/12/2013,Illinois,10040361,6537549,5978331,559218
01/12/2013,Indiana,5079216,3207647,2999291,208356
01/12/2013,Iowa,2412622,1684792,1609386,75406
01/12/2013,Kansas,2188613,1488263,1415787,72476
01/12/2013,Kentucky,3419898,2034084,1879552,154532
01/12/2013,Louisiana,3535754,2101607,1981332,120275
01/12/2013,Maine,1087193,702632,659022,43610
01/12/2013,Maryland,4654826,3117158,2925695,191463
01/12/2013,Massachusetts,5433952,3522182,3300577,221605
01/12/2013,Michigan,7843590,4745607,4354920,390687
01/12/2013,Minnesota,4234970,2964246,2823768,140478
01/12/2013,Mississippi,2268395,1247492,1146243,101249
01/12/2013,Missouri,4701109,3017799,2817410,200389
01/12/2013,Montana,803034,512516,486660,25856
01/12/2013,Nebraska,1425825,1012031,976601,35430
01/12/2013,Nevada,2171241,1372217,1247354,124863
01/12/2013,Ohio,9078805,5696553,5304884,391669
01/12/2013,Oklahoma,2932602,1795533,1706508,89025
01/12/2013,Oregon,3142820,1928211,1789567,138644
01/12/2013,Pennsylvania,10194255,6386175,5964685,421490
01/12/2013,Tennessee,5085584,3049904,2833383,216521
01/12/2013,Texas,19865772,12907972,12154284,753688
01/12/2013,Utah,2079764,1400436,1346017,54419
01/12/2013,Vermont,513269,348937,334491,14446
01/12/2013,Virginia,6410731,4250846,4021840,229006
01/12/2013,Washington,5476537,3469934,3251784,218150
01/12/2013,Wisconsin,4515931,3071403,2882705,188698
01/12/2013,Wyoming,449393,302194,288374,13820
01/01/2014,Alabama,3775896,2165971,2010942,155029
01/01/2014,Alaska,539619,363966,338735,25231
01/01/2014,Arizona,5135007,3081484,2858474,223010
01/01/2014,Arkansas,2282487,1324443,1238994,85449
01/01/2014,California,29812266,18569356,17040259,1529097
01/01/2014,Colorado,4105799,2778644,2613030,165614
01/01/2014,Connecticut,2863185,1873722,1738339,135383
01/01/2014,Delaware,732837,446546,419663,26883
01/01/2014,Florida,15818006,9479786,8825090,654696
01/01/2014,Georgia,7608115,4738716,4383593,355123
01/01/2014,Hawaii,1077742,659402,629214,30188
01/01/2014,Idaho,1218117,778076,734548,43528
01/01/2014,Illinois,10041949,6539433,5991934,547499
01/01/2014,Indiana,5081350,3210348,3006208,204140
01/01/2014,Iowa,2413708,1686880,1611910,74970
01/01/2014,Kansas,2189481,1490102,1418761,71341
01/01/2014,Kentucky,3420974,2030616,1878659,151957
01/01/2014,Louisiana,3537379,2103844,1985316,118528
01/01/2014,Maine,1087515,701831,658792,43039
01/01/2014,Maryland,4657298,3117343,2928422,188921
01/01/2014,Massachusetts,5438307,3528825,3310181,218644
01/01/2014,Michigan,7846050,4749538,4364414,385124
01/01/2014,Minnesota,4237487,2965437,2826045,139392
01/01/2014,Mississippi,2269079,1246805,1146363,100442
01/01/2014,Missouri,4702832,3023454,2822595,200859
01/01/2014,Montana,803600,512421,486983,25438
01/01/2014,Nebraska,1426584,1013076,977740,35336
01/01/2014,Nevada,2174343,1373421,1250571,122850
01/01/2014,Ohio,9081389,5693500,5316915,376585
01/01/2014,Oklahoma,2934523,1794313,1707122,87191
01/01/2014,Oregon,3145835,1932624,1794235,138389
01/01/2014,Pennsylvania,10195861,6388276,5974041,414235
01/01/2014,Tennessee,5089069,3046560,2834891,211669
01/01/2014,Texas,19899461,12926206,12188294,737912
01/01/2014,Utah,2082531,1402644,1349185,53459
01/01/2014,Vermont,513280,348806,334528,14278
01/01/2014,Virginia,6415418,4256299,4028612,227687
01/01/2014,Washington,5483240,3471141,3255449,215692
01/01/2014,Wisconsin,4517494,3071739,2887465,184274
01/01/2014,Wyoming,449367,302308,288675,13633
01/02/2014,Alabama,3776877,2166876,2012653,154223
01/02/2014,Alaska,539509,364333,339157,25176
01/02/2014,Arizona,5142282,3087246,2867319,219927
01/02/2014,Arkansas,2283060,1324270,1240888,83382
01/02/2014,California,29837518,18588369,17083487,1504882
01/02/2014,Colorado,4111541,2785590,2623718,161872
01/02/2014,Connecticut,2863789,1876435,1743577,132858
01/02/2014,Delaware,733503,447591,420921,26670
01/02/2014,Florida,15838937,9497821,8849988,647833
01/02/2014,Georgia,7615165,4743210,4390706,352504
01/02/2014,Hawaii,1077845,660678,630881,29797
01/02/2014,Idaho,1219442,776745,736121,40624
01/02/2014,Illinois,10042715,6539294,6006418,532876
01/02/2014,Indiana,5083309,3214183,3013026,201157
01/02/2014,Iowa,2414682,1690118,1615655,74463
01/02/2014,Kansas,2190055,1492219,1421820,70399
01/02/2014,Kentucky,3421719,2027674,1878905,148769
01/02/2014,Louisiana,3538761,2107066,1989022,118044
01/02/2014,Maine,1087757,701068,658705,42363
01/02/2014,Maryland,4659350,3118114,2931696,186418
01/02/2014,Massachusetts,5442411,3536741,3321159,215582
01/02/2014,Michigan,7848175,4754121,4374624,379497
01/02/2014,Minnesota,4239854,2966801,2828846,137955
01/02/2014,Mississippi,2269514,1246453,1146767,99686
01/02/2014,Missouri,4704124,3028252,2827952,200300
01/02/2014,Montana,804113,512169,487185,24984
01/02/2014,Nebraska,1427283,1013940,978832,35108
01/02/2014,Nevada,2177240,1374578,1253863,120715
01/02/2014,Ohio,9083600,5691029,5328838,362191
01/02/2014,Oklahoma,2936088,1792880,1707926,84954
01/02/2014,Oregon,3148678,1936905,1799250,137655
01/02/2014,Pennsylvania,10197005,6390970,5983678,407292
01/02/2014,Tennessee,5092218,3043669,2835964,207705
01/02/2014,Texas,19931260,12944743,12223189,721554
01/02/2014,Utah,2085290,1404680,1352211,52469
01/02/2014,Vermont,513290,348678,334573,14105
01/02/2014,Virginia,6418890,4261740,4035391,226349
01/02/2014,Washington,5489276,3471891,3258702,213189
01/02/2014,Wisconsin,4518845,3072006,2892285,179721
01/02/2014,Wyoming,449336,302412,288990,13422
01/03/2014,Alabama,3777962,2167429,2014263,153166
01/03/2014,Alaska,539754,364723,339585,25138
01/03/2014,Arizona,5149581,3093246,2875911,217335
01/03/2014,Arkansas,2283711,1324213,1242674,81539
01/03/2014,California,29863107,18608224,17126546,1481678
01/03/2014,Colorado,4117658,2791859,2634418,157441
01/03/2014,Connecticut,2864494,1879255,1748668,130587
01/03/2014,Delaware,734258,448826,422367,26459
01/03/2014,Florida,15860256,9513557,8872130,641427
01/03/2014,Georgia,7622847,4746928,4396047,350881
01/03/2014,Hawaii,1078425,661775,632329,29446
01/03/2014,Idaho,1220865,775559,737567,37992
01/03/2014,Illinois,10043753,6535796,6019511,516285
01/03/2014,Indiana,5085349,3218859,3019531,199328
01/03/2014,Iowa,2415666,1693311,1619332,73979
01/03/2014,Kansas,2190902,1494043,1424398,69645
01/03/2014,Kentucky,3422732,2024499,1879447,145052
01/03/2014,Louisiana,3540264,2111847,1992426,119421
01/03/2014,Maine,1088088,700376,658761,41615
01/03/2014,Maryland,4661547,3119340,2934794,184546
01/03/2014,Massachusetts,5446508,3544719,3331902,212817
01/03/2014,Michigan,7850278,4758378,4384836,373542
01/03/2014,Minnesota,4242288,2969112,2833095,136017
01/03/2014,Mississippi,2270082,1246033,1147012,99021
01/03/2014,Missouri,4705663,3030991,2832619,198372
01/03/2014,Montana,804660,511966,487393,24573
01/03/2014,Nebraska,1428099,1014248,979472,34776
01/03/2014,Nevada,2180188,1375605,1256934,118671
01/03/2014,Ohio,9085936,5690228,5339396,350832
01/03/2014,Oklahoma,2937906,1791504,1708779,82725
01/03/2014,Oregon,3151548,1940643,1804298,136345
01/03/2014,Pennsylvania,10198199,6392273,5991065,401208
01/03/2014,Tennessee,5095612,3041048,2835726,205322
01/03/2014,Texas,19963437,12962485,12254958,707527
01/03/2014,Utah,2088050,1406514,1354871,51643
01/03/2014,Vermont,513286,348585,334605,13980
01/03/2014,Virginia,6423820,4265948,4040682,225266
01/03/2014,Washington,5495957,3472850,3261947,210903
01/03/2014,Wisconsin,4520263,3072114,2896598,175516
01/03/2014,Wyoming,449330,302506,289248,13258
01/04/2014,Alabama,3779148,2166887,2015052,151835
01/04/2014,Alaska,539920,364982,339829,25153
01/04/2014,Arizona,5157085,3098896,2883663,215233
01/04/2014,Arkansas,2284412,1324212,1244129,80083
01/04/2014,California,29890084,18624963,17164661,1460302
01/04/2014,Colorado,4123834,2796320,2644060,152260
01/04/2014,Connecticut,2865227,1882025,1753324,128701
01/04/2014,Delaware,735008,450102,423844,26258
01/04/2014,Florida,15881941,9525298,8890013,635285
01/04/2014,Georgia,7630658,4748750,4398631,350119
01/04/2014,Hawaii,1078966,662692,633518,29174
01/04/2014,Idaho,1222312,774476,738865,35611
01/04/2014,Illinois,10045091,6528094,6029065,499029
01/04/2014,Indiana,5087465,3222985,3024974,198011
01/04/2014,Iowa,2416760,1695751,1622168,73583
01/04/2014,Kansas,2191747,1495057,1426026,69031
01/04/2014,Kentucky,3423820,2020074,1879242,140832
01/04/2014,Louisiana,3541777,2118328,1995649,122679
01/04/2014,Maine,1088386,699680,658856,40824
01/04/2014,Maryland,4663823,3120501,2937114,183387
01/04/2014,Massachusetts,5450754,3551300,3340784,210516
01/04/2014,Michigan,7852565,4760730,4393862,366868
01/04/2014,Minnesota,4244776,2971996,2838498,133498
01/04/2014,Mississippi,2270655,1245010,1146757,98253
01/04/2014,Missouri,4707337,3031462,2836109,195353
01/04/2014,Montana,805196,511934,487669,24265
01/04/2014,Nebraska,1428903,1013835,979454,34381
01/04/2014,Nevada,2183244,1376354,1259583,116771
01/04/2014,Ohio,9088443,5691744,5348627,343117
01/04/2014,Oklahoma,2939772,1790356,1709600,80756
01/04/2014,Oregon,3154549,1943538,1808969,134569
01/04/2014,Pennsylvania,10199621,6390305,5994857,395448
01/04/2014,Tennessee,5099031,3038521,2834046,204475
01/04/2014,Texas,19996449,12977478,12280595,696883
01/04/2014,Utah,2090879,1408112,1357035,51077
01/04/2014,Vermont,513303,348513,334580,13933
01/04/2014,Virginia,6428555,4267774,4043315,224459
01/04/2014,Washington,5502692,3474684,3265637,209047
01/04/2014,Wisconsin,4521748,3072178,2900257,171921
01/04/2014,Wyoming,449340,302590,289389,13201
01/05/2014,Alabama,3780402,2165427,2015410,150017
01/05/2014,Alaska,539952,365047,339891,25156
01/05/2014,Arizona,5164679,3104438,2891087,213351
01/05/2014,Arkansas,2285227,1324336,1245446,78890
01/05/2014,California,29916600,18638929,17200175,1438754
01/05/2014,Colorado,4129980,2799033,2652822,146211
01/05/2014,Connecticut,2866111,1884757,1757743,127014
01/05/2014,Delaware,735746,451305,425282,26023
01/05/2014,Florida,15903940,9534040,8905898,628142
01/05/2014,Georgia,7638321,4748727,4399795,348932
01/05/2014,Hawaii,1079174,663424,634545,28879
01/05/2014,Idaho,1223807,774878,740193,34685
01/05/2014,Illinois,10046805,6518261,6036226,482035
01/05/2014,Indiana,5090010,3226182,3030027,196155
01/05/2014,Iowa,2418089,1697727,1624533,73194
01/05/2014,Kansas,2192602,1495273,1426868,68405
01/05/2014,Kentucky,3425003,2014317,1878442,135875
01/05/2014,Louisiana,3543376,2126535,1999443,127092
01/05/2014,Maine,1088766,698898,658932,39966
01/05/2014,Maryland,4666100,3121400,2939236,182164
01/05/2014,Massachusetts,5455405,3556705,3348340,208365
01/05/2014,Michigan,7855445,4760984,4402006,358978
01/05/2014,Minnesota,4247681,2975113,2844737,130376
01/05/2014,Mississippi,2271250,1243633,1146391,97242
01/05/2014,Missouri,4709237,3030820,2839226,191594
01/05/2014,Montana,805821,512134,488112,24022
01/05/2014,Nebraska,1429800,1012989,979097,33892
01/05/2014,Nevada,2186235,1376943,1262099,114844
01/05/2014,Ohio,9091567,5696376,5358794,337582
01/05/2014,Oklahoma,2941732,1790090,1711113,78977
01/05/2014,Oregon,3157729,1945984,1813583,132401
01/05/2014,Pennsylvania,10201740,6385963,5997076,388887
01/05/2014,Tennessee,5102669,3036563,2832484,204079
01/05/2014,Texas,20029222,12990622,12302615,688007
01/05/2014,Utah,2093891,1409831,1359074,50757
01/05/2014,Vermont,513384,348496,334560,13936
01/05/2014,Virginia,6432887,4267161,4043979,223182
01/05/2014,Washington,5509350,3478313,3270893,207420
01/05/2014,Wisconsin,4523688,3072776,2904115,168661
01/05/2014,Wyoming,449389,302688,289475,13213
01/06/2014,Alabama,3781842,2164102,2016249,147853
01/06/2014,Alaska,540093,364977,339893,25084
01/06/2014,Arizona,5172489,3110915,2899220,211695
01/06/2014,Arkansas,2286089,1324928,1247064,77864
01/06/2014,California,29944683,18656005,17238675,1417330
01/06/2014,Colorado,4136443,2800957,2661226,139731
01/06/2014,Connecticut,2867060,1887936,1762463,125473
01/06/2014,Delaware,736544,452472,426731,25741
01/06/2014,Florida,15926650,9543064,8923099,619965
01/06/2014,Georgia,7646501,4748412,4401903,346509
01/06/2014,Hawaii,1079608,664120,635619,28501
01/06/2014,Idaho,1225357,772518,741711,30807
01/06/2014,Illinois,10048895,6510457,6043882,466575
01/06/2014,Indiana,5092587,3228715,3035235,193480
01/06/2014,Iowa,2419419,1699665,1626906,72759
01/06/2014,Kansas,2193633,1495152,1427461,67691
01/06/2014,Kentucky,3426320,2008207,1877753,130454
01/06/2014,Louisiana,3545128,2136367,2004372,131995
01/06/2014,Maine,1089198,698129,659052,39077
01/06/2014,Maryland,4668668,3122644,2942245,180399
01/06/2014,Massachusetts,5460196,3562788,3356523,206265
01/06/2014,Michigan,7858371,4760581,4410586,349995
01/06/2014,Minnesota,4250635,2978678,2851608,127070
01/06/2014,Mississippi,2271966,1242518,1146590,95928
01/06/2014,Missouri,4711311,3030914,2843247,187667
01/06/2014,Montana,806454,512539,488704,23835
01/06/2014,Nebraska,1430764,1012254,978935,33319
01/06/2014,Nevada,2189378,1377865,1264946,112919
01/06/2014,Ohio,9094839,5704592,5372122,332470
01/06/2014,Oklahoma,2943814,1791491,1714066,77425
01/06/2014,Oregon,3160985,1948765,1818552,130213
01/06/2014,Pennsylvania,10204125,6382223,6001094,381129
01/06/2014,Tennessee,5106517,3036228,2832894,203334
01/06/2014,Texas,20063200,13005331,12325395,679936
01/06/2014,Utah,2096947,1412233,1361525,50708
01/06/2014,Vermont,513456,348595,334637,13958
01/06/2014,Virginia,6437866,4265150,4044124,221026
01/06/2014,Washington,5516406,3484570,3278515,206055
01/06/2014,Wisconsin,4525650,3074787,2909425,165362
01/06/2014,Wyoming,449410,302902,289593,13309
01/07/2014,Alabama,3783338,2163245,2017648,145597
01/07/2014,Alaska,540362,364744,339820,24924
01/07/2014,Arizona,5180459,3118643,2908222,210421
01/07/2014,Arkansas,2287037,1326166,1249184,76982
01/07/2014,California,29973268,18677566,17279967,1397599
01/07/2014,Colorado,4143100,2802732,2669021,133711
01/07/2014,Connecticut,2868086,1891461,1767363,124098
01/07/2014,Delaware,737354,453608,428207,25401
01/07/2014,Florida,15949789,9553381,8941700,611681
01/07/2014,Georgia,7654601,4748222,4405529,342693
01/07/2014,Hawaii,1080312,664779,636723,28056
01/07/2014,Idaho,1226932,774415,743273,31142
01/07/2014,Illinois,10050873,6506321,6053007,453314
01/07/2014,Indiana,5095338,3230459,3039980,190479
01/07/2014,Iowa,2420807,1701256,1628984,72272
01/07/2014,Kansas,2194773,1494899,1427996,66903
01/07/2014,Kentucky,3427780,2002336,1877122,125214
01/07/2014,Louisiana,3547016,2146989,2010030,136959
01/07/2014,Maine,1089642,697406,659150,38256
01/07/2014,Maryland,4671342,3124415,2946042,178373
01/07/2014,Massachusetts,5465033,3570532,3366302,204230
01/07/2014,Michigan,7861502,4760410,4419845,340565
01/07/2014,Minnesota,4253663,2982337,2858156,124181
01/07/2014,Mississippi,2272687,1241849,1147388,94461
01/07/2014,Missouri,4713419,3032475,2848329,184146
01/07/2014,Montana,807113,512909,489212,23697
01/07/2014,Nebraska,1431772,1011874,979130,32744
01/07/2014,Nevada,2192599,1379296,1268140,111156
01/07/2014,Ohio,9098363,5714956,5387836,327120
01/07/2014,Oklahoma,2945898,1794276,1718123,76153
01/07/2014,Oregon,3164306,1951938,1823499,128439
01/07/2014,Pennsylvania,10206633,6380460,6007565,372895
01/07/2014,Tennessee,5110481,3037420,2835451,201969
01/07/2014,Texas,20097595,13020533,12348864,671669
01/07/2014,Utah,2100046,1415313,1364434,50879
01/07/2014,Vermont,513527,348732,334745,13987
01/07/2014,Virginia,6443321,4261973,4043653,218320
01/07/2014,Washington,5523748,3493179,3287937,205242
01/07/2014,Wisconsin,4527717,3077724,2915883,161841
01/07/2014,Wyoming,449473,303175,289739,13436
01/08/2014,Alabama,3785171,2162943,2019514,143429
01/08/2014,Alaska,540603,364445,339777,24668
01/08/2014,Arizona,5189451,3127937,2918301,209636
01/08/2014,Arkansas,2288351,1328224,1251928,76296
01/08/2014,California,30003777,18704813,17324005,1380808
01/08/2014,Colorado,4151522,2805239,2676304,128935
01/08/2014,Connecticut,2868777,1894819,1771979,122840
01/08/2014,Delaware,738197,454713,429692,25021
01/08/2014,Florida,15979383,9565595,8961454,604141
01/08/2014,Georgia,7664292,4748449,4410760,337689
01/08/2014,Hawaii,1080863,665410,637809,27601
01/08/2014,Idaho,1228689,776184,744890,31294
01/08/2014,Illinois,10052122,6505638,6063338,442300
01/08/2014,Indiana,5097721,3233023,3044917,188106
01/08/2014,Iowa,2422082,1702696,1630943,71753
01/08/2014,Kansas,2195906,1494750,1428614,66136
01/08/2014,Kentucky,3429552,1997344,1876646,120698
01/08/2014,Louisiana,3549310,2157540,2015914,141626
01/08/2014,Maine,1089878,696893,659284,37609
01/08/2014,Maryland,4674244,3126888,2950361,176527
01/08/2014,Massachusetts,5469190,3580091,3377865,202226
01/08/2014,Michigan,7864342,4761597,4429841,331756
01/08/2014,Minnesota,4256649,2985812,2863719,122093
01/08/2014,Mississippi,2273462,1241705,1148638,93067
01/08/2014,Missouri,4715848,3035691,2854353,181338
01/08/2014,Montana,807887,513167,489580,23587
01/08/2014,Nebraska,1432717,1011897,979646,32251
01/08/2014,Nevada,2196560,1381318,1271663,109655
01/08/2014,Ohio,9102012,5726029,5404261,321768
01/08/2014,Oklahoma,2948530,1798094,1722930,75164
01/08/2014,Oregon,3168976,1955313,1828180,127133
01/08/2014,Pennsylvania,10209072,6382229,6016409,365820
01/08/2014,Tennessee,5115278,3040492,2840279,200213
01/08/2014,Texas,20135749,13036080,12373428,662652
01/08/2014,Utah,2103664,1418964,1367794,51170
01/08/2014,Vermont,513704,348863,334843,14020
01/08/2014,Virginia,6448300,4258573,4043065,215508
01/08/2014,Washington,5532478,3503437,3298328,205109
01/08/2014,Wisconsin,4529784,3081114,2922633,158481
01/08/2014,Wyoming,449719,303393,289922,13471
01/09/2014,Alabama,3787004,2162865,2021615,141250
01/09/2014,Alaska,540851,364135,339845,24290
01/09/2014,Arizona,5198387,3138216,2929099,209117
01/09/2014,Arkansas,2289722,1330805,1255079,75726
01/09/2014,California,30034552,18735234,17369795,1365439
01/09/2014,Colorado,4159972,2808186,2682837,125349
01/09/2014,Connecticut,2869566,1897546,1776030,121516
01/09/2014,Delaware,739121,455690,431084,24606
01/09/2014,Florida,16009146,9577872,8980727,597145
01/09/2014,Georgia,7674134,4748685,4416904,331781
01/09/2014,Hawaii,1081629,666039,638866,27173
01/09/2014,Idaho,1230456,777919,746662,31257
01/09/2014,Illinois,10053396,6506203,6073599,432604
01/09/2014,Indiana,5100064,3237161,3050703,186458
01/09/2014,Iowa,2423284,1704150,1633086,71064
01/09/2014,Kansas,2197146,1494751,1429313,65438
01/09/2014,Kentucky,3431380,1993235,1876403,116832
01/09/2014,Louisiana,3551647,2166638,2021167,145471
01/09/2014,Maine,1090164,696540,659456,37084
01/09/2014,Maryland,4677269,3129613,2954694,174919
01/09/2014,Massachusetts,5473295,3590220,3390213,200007
01/09/2014,Michigan,7867142,4763243,4439814,323429
01/09/2014,Minnesota,4259600,2988734,2868043,120691
01/09/2014,Mississippi,2274286,1241870,1150211,91659
01/09/2014,Missouri,4718289,3039992,2860932,179060
01/09/2014,Montana,808672,513367,489884,23483
01/09/2014,Nebraska,1433715,1012111,980321,31790
01/09/2014,Nevada,2200552,1383739,1275356,108383
01/09/2014,Ohio,9105659,5735306,5419107,316199
01/09/2014,Oklahoma,2951189,1802468,1728111,74357
01/09/2014,Oregon,3173535,1958331,1832536,125795
01/09/2014,Pennsylvania,10211398,6387480,6026772,360708
01/09/2014,Tennessee,5120089,3045235,2846964,198271
01/09/2014,Texas,20174227,13050337,12398563,651774
01/09/2014,Utah,2107319,1422899,1371451,51448
01/09/2014,Vermont,513902,348966,334944,14022
01/09/2014,Virginia,6453876,4255711,4042931,212780
01/09/2014,Washington,5541439,3513688,3308405,205283
01/09/2014,Wisconsin,4531863,3084262,2928668,155594
01/09/2014,Wyoming,449959,303460,290127,13333
01/10/2014,Alabama,3788819,2162682,2023989,138693
01/10/2014,Alaska,541178,363829,340035,23794
01/10/2014,Arizona,5207290,3147375,2939396,207979
01/10/2014,Arkansas,2291014,1333104,1258078,75026
01/10/2014,California,30065291,18760622,17413762,1346860
01/10/2014,Colorado,4168412,2810762,2688227,122535
01/10/2014,Connecticut,2870249,1899432,1779699,119733
01/10/2014,Delaware,739991,456448,432329,24119
01/10/2014,Florida,16038837,9586098,8996931,589167
01/10/2014,Georgia,7684016,4747387,4422548,324839
01/10/2014,Hawaii,1082361,666609,639868,26741
01/10/2014,Idaho,1232213,779643,748640,31003
01/10/2014,Illinois,10054590,6504445,6081936,422509
01/10/2014,Indiana,5102418,3241264,3056667,184597
01/10/2014,Iowa,2424508,1705341,1635343,69998
01/10/2014,Kansas,2198312,1494702,1429984,64718
01/10/2014,Kentucky,3433119,1989610,1876386,113224
01/10/2014,Louisiana,3553983,2172611,2024800,147811
01/10/2014,Maine,1090411,696052,659532,36520
01/10/2014,Maryland,4680246,3131723,2958485,173238
01/10/2014,Massachusetts,5477355,3598416,3401460,196956
01/10/2014,Michigan,7869825,4763011,4448646,314365
01/10/2014,Minnesota,4262535,2990545,2871022,119523
01/10/2014,Mississippi,2275099,1242310,1152316,89994
01/10/2014,Missouri,4720710,3044054,2867348,176706
01/10/2014,Montana,809429,513525,490239,23286
01/10/2014,Nebraska,1434661,1012100,980917,31183
01/10/2014,Nevada,2204509,1385877,1278928,106949
01/10/2014,Ohio,9109182,5740022,5429896,310126
01/10/2014,Oklahoma,2953863,1806752,1733263,73489
01/10/2014,Oregon,3178139,1960334,1836625,123709
01/10/2014,Pennsylvania,10213628,6393131,6036120,357011
01/10/2014,Tennessee,5124892,3049884,2854160,195724
01/10/2014,Texas,20212629,13058380,12420918,637462
01/10/2014,Utah,2110926,1426616,1375102,51514
01/10/2014,Vermont,514074,348999,335064,13935
01/10/2014,Virginia,6459517,4252749,4042841,209908
01/10/2014,Washington,5550339,3521452,3316839,204613
01/10/2014,Wisconsin,4533838,3086117,2933222,152895
01/10/2014,Wyoming,450204,303319,290316,13003
01/11/2014,Alabama,3790314,2162723,2026910,135813
01/11/2014,Alaska,541342,363530,340262,23268
01/11/2014,Arizona,5215731,3153926,2947951,205975
01/11/2014,Arkansas,2292159,1334565,1260362,74203
01/11/2014,California,30094154,18775765,17451977,1323788
01/11/2014,Colorado,4176464,2811968,2691945,120023
01/11/2014,Connecticut,2870767,1900520,1783052,117468
01/11/2014,Delaware,740761,457025,433436,23589
01/11/2014,Florida,16066665,9588482,9008617,579865
01/11/2014,Georgia,7693498,4744010,4426681,317329
01/11/2014,Hawaii,1082878,667024,640728,26296
01/11/2014,Idaho,1233894,781294,750676,30618
01/11/2014,Illinois,10055199,6498807,6086861,411946
01/11/2014,Indiana,5104411,3243507,3061704,181803
01/11/2014,Iowa,2425484,1705842,1637265,68577
01/11/2014,Kansas,2199173,1494484,1430308,64176
01/11/2014,Kentucky,3434586,1986279,1876349,109930
01/11/2014,Louisiana,3555955,2174782,2026322,148460
01/11/2014,Maine,1090608,695222,659414,35808
01/11/2014,Maryland,4682816,3132751,2961418,171333
01/11/2014,Massachusetts,5481096,3602853,3409823,193030
01/11/2014,Michigan,7871987,4759649,4455559,304090
01/11/2014,Minnesota,4265112,2991030,2872957,118073
01/11/2014,Mississippi,2275694,1243119,1155075,88044
01/11/2014,Missouri,4722848,3047123,2872738,174385
01/11/2014,Montana,810110,513751,490786,22965
01/11/2014,Nebraska,1435461,1011615,981159,30456
01/11/2014,Nevada,2208283,1387386,1282078,105308
01/11/2014,Ohio,9111983,5738510,5434432,304078
01/11/2014,Oklahoma,2956288,1810599,1737920,72679
01/11/2014,Oregon,3182459,1960742,1840037,120705
01/11/2014,Pennsylvania,10215030,6396471,6042204,354267
01/11/2014,Tennessee,5129292,3052910,2860333,192577
01/11/2014,Texas,20249578,13057664,12436708,620956
01/11/2014,Utah,2114402,1429762,1378419,51343
01/11/2014,Vermont,514237,348937,335207,13730
01/11/2014,Virginia,6463917,4249011,4042113,206898
01/11/2014,Washington,5558599,3525535,3323022,202513
01/11/2014,Wisconsin,4535533,3085929,2935868,150061
01/11/2014,Wyoming,450360,302997,290435,12562
01/12/2014,Alabama,3791522,2163996,2030603,133393
01/12/2014,Alaska,541292,363338,340470,22868
01/12/2014,Arizona,5223652,3158664,2954989,203675
01/12/2014,Arkansas,2293069,1335449,1261924,73525
01/12/2014,California,30119935,18785368,17484592,1300776
01/12/2014,Colorado,4183994,2812244,2694387,117857
01/12/2014,Connecticut,2871003,1901233,1786010,115223
01/12/2014,Delaware,741480,457575,434437,23138
01/12/2014,Florida,16093012,9588236,9017099,571137
01/12/2014,Georgia,7702197,4740275,4429609,310666
01/12/2014,Hawaii,1083135,667398,641508,25890
01/12/2014,Idaho,1235428,783031,752712,30319
01/12/2014,Illinois,10055054,6492057,6089359,402698
01/12/2014,Indiana,5106016,3243867,3065804,178063
01/12/2014,Iowa,2426356,1705596,1638437,67159
01/12/2014,Kansas,2199786,1494280,1430176,64104
01/12/2014,Kentucky,3435694,1983555,1876205,107350
01/12/2014,Louisiana,3557592,2174213,2026255,147958
01/12/2014,Maine,1090665,694247,659254,34993
01/12/2014,Maryland,4684903,3133445,2963878,169567
01/12/2014,Massachusetts,5484347,3603769,3414729,189040
01/12/2014,Michigan,7873568,4754985,4461008,293977
01/12/2014,Minnesota,4267379,2991295,2874858,116437
01/12/2014,Mississippi,2276091,1244773,1158482,86291
01/12/2014,Missouri,4724514,3049812,2877073,172739
01/12/2014,Montana,810716,514253,491643,22610
01/12/2014,Nebraska,1436119,1010872,980970,29902
01/12/2014,Nevada,2211859,1388719,1284896,103823
01/12/2014,Ohio,9114058,5732637,5433117,299520
01/12/2014,Oklahoma,2958392,1814538,1742065,72473
01/12/2014,Oregon,3186524,1960168,1842745,117423
01/12/2014,Pennsylvania,10215558,6397976,6045102,352874
01/12/2014,Tennessee,5133124,3054766,2865175,189591
01/12/2014,Texas,20284449,13051833,12446054,605779
01/12/2014,Utah,2117704,1432638,1381478,51160
01/12/2014,Vermont,514348,348838,335378,13460
01/12/2014,Virginia,6467759,4245503,4041135,204368
01/12/2014,Washington,5566204,3527147,3327558,199589
01/12/2014,Wisconsin,4536913,3084481,2937011,147470
01/12/2014,Wyoming,450507,302631,290474,12157
01/01/2015,Alabama,3792717,2166771,2034786,131985
01/01/2015,Alaska,541541,363226,340538,22688
01/01/2015,Arizona,5231632,3162393,2961081,201312
01/01/2015,Arkansas,2293962,1336169,1263086,73083
01/01/2015,California,30147095,18794302,17513360,1280942
01/01/2015,Colorado,4191682,2812740,2696305,116435
01/01/2015,Connecticut,2871234,1901701,1788370,113331
01/01/2015,Delaware,742189,458168,435330,22838
01/01/2015,Florida,16119608,9588873,9024705,564168
01/01/2015,Georgia,7711426,4737642,4431983,305659
01/01/2015,Hawaii,1083804,667875,642329,25546
01/01/2015,Idaho,1236985,785010,754789,30221
01/01/2015,Illinois,10054926,6487628,6091476,396152
01/01/2015,Indiana,5107398,3243609,3069876,173733
01/01/2015,Iowa,2427052,1704798,1638800,65998
01/01/2015,Kansas,2200557,1494068,1429606,64462
01/01/2015,Kentucky,3436806,1981477,1875886,105591
01/01/2015,Louisiana,3559303,2172224,2025344,146880
01/01/2015,Maine,1090698,693272,659092,34180
01/01/2015,Maryland,4687116,3134640,2966550,168090
01/01/2015,Massachusetts,5487464,3602272,3416690,185582
01/01/2015,Michigan,7874799,4751121,4465483,285638
01/01/2015,Minnesota,4269426,2992386,2877365,115021
01/01/2015,Mississippi,2276579,1247332,1162332,85000
01/01/2015,Missouri,4726122,3052395,2880669,171726
01/01/2015,Montana,811282,515033,492735,22298
01/01/2015,Nebraska,1436792,1010079,980427,29652
01/01/2015,Nevada,2215425,1390075,1287564,102511
01/01/2015,Ohio,9115824,5725314,5428302,297012
01/01/2015,Oklahoma,2960645,1819030,1745819,73211
01/01/2015,Oregon,3190400,1959718,1845083,114635
01/01/2015,Pennsylvania,10215735,6399411,6046534,352877
01/01/2015,Tennessee,5136969,3056389,2869136,187253
01/01/2015,Texas,20320317,13045727,12451402,594325
01/01/2015,Utah,2120965,1435490,1384452,51038
01/01/2015,Vermont,514435,348721,335527,13194
01/01/2015,Virginia,6472206,4242711,4040145,202566
01/01/2015,Washington,5574083,3528211,3331515,196696
01/01/2015,Wisconsin,4538023,3082864,2937399,145465
01/01/2015,Wyoming,450619,302350,290427,11923
01/02/2015,Alabama,3793390,2170601,2038928,131673
01/02/2015,Alaska,541749,363134,340415,22719
01/02/2015,Arizona,5238741,3165741,2966433,199308
01/02/2015,Arkansas,2294489,1336952,1264167,72785
01/02/2015,California,30170177,18804573,17539526,1265047
01/02/2015,Colorado,4199004,2813690,2698184,115506
01/02/2015,Connecticut,2871089,1901730,1789810,111920
01/02/2015,Delaware,742821,458835,436141,22694
01/02/2015,Florida,16143433,9592040,9032822,559218
01/02/2015,Georgia,7719736,4736239,4433957,302282
01/02/2015,Hawaii,1084437,668343,643165,25178
01/02/2015,Idaho,1238342,787221,756853,30368
01/02/2015,Illinois,10053295,6487282,6094125,393157
01/02/2015,Indiana,5108171,3243958,3074662,169296
01/02/2015,Iowa,2427387,1703904,1638715,65189
01/02/2015,Kansas,2201056,1493764,1428745,65019
01/02/2015,Kentucky,3437547,1979937,1875247,104690
01/02/2015,Louisiana,3560608,2169594,2024043,145551
01/02/2015,Maine,1090572,692242,658825,33417
01/02/2015,Maryland,4688804,3136563,2969832,166731
01/02/2015,Massachusetts,5489882,3599631,3416731,182900
01/02/2015,Michigan,7874962,4748842,4469325,279517
01/02/2015,Minnesota,4271024,2994638,2880470,114168
01/02/2015,Mississippi,2276813,1250514,1166324,84190
01/02/2015,Missouri,4727116,3054756,2883759,170997
01/02/2015,Montana,811751,515924,493824,22100
01/02/2015,Nebraska,1437272,1009386,979687,29699
01/02/2015,Nevada,2218759,1391547,1290189,101358
01/02/2015,Ohio,9116352,5719068,5423145,295923
01/02/2015,Oklahoma,2962478,1823885,1749030,74855
01/02/2015,Oregon,3193924,1960323,1847488,112835
01/02/2015,Pennsylvania,10214411,6402054,6048226,353828
01/02/2015,Tennessee,5140220,3058800,2873342,185458
01/02/2015,Texas,20353602,13042678,12455072,587606
01/02/2015,Utah,2124081,1438477,1387444,51033
01/02/2015,Vermont,514456,348536,335570,12966
01/02/2015,Virginia,6476073,4240767,4039464,201303
01/02/2015,Washington,5581414,3530246,3335608,194638
01/02/2015,Wisconsin,4538575,3081614,2937529,144085
01/02/2015,Wyoming,450732,302209,290287,11922
01/03/2015,Alabama,3794218,2174960,2042936,132024
01/03/2015,Alaska,541763,363053,340222,22831
01/03/2015,Arizona,5246030,3169469,2971786,197683
01/03/2015,Arkansas,2295183,1337920,1265637,72283
01/03/2015,California,30192273,18816299,17566611,1249688
01/03/2015,Colorado,4206284,2815196,2700859,114337
01/03/2015,Connecticut,2871016,1900978,1790269,110709
01/03/2015,Delaware,743467,459628,437007,22621
01/03/2015,Florida,16167449,9598497,9043681,554816
01/03/2015,Georgia,7727931,4735865,4436481,299384
01/03/2015,Hawaii,1084597,668758,644078,24680
01/03/2015,Idaho,1239788,789517,758877,30640
01/03/2015,Illinois,10052133,6491517,6098798,392719
01/03/2015,Indiana,5109371,3245723,3080816,164907
01/03/2015,Iowa,2428014,1703231,1638687,64544
01/03/2015,Kansas,2201561,1493443,1428091,65352
01/03/2015,Kentucky,3438481,1978823,1874526,104297
01/03/2015,Louisiana,3561944,2166522,2022881,143641
01/03/2015,Maine,1090565,691110,658472,32638
01/03/2015,Maryland,4690491,3139033,2974094,164939
01/03/2015,Massachusetts,5492682,3597341,3416770,180571
01/03/2015,Michigan,7875796,4748857,4473859,274998
01/03/2015,Minnesota,4272956,2998186,2884337,113849
01/03/2015,Mississippi,2277021,1253923,1170356,83567
01/03/2015,Missouri,4728406,3056791,2887036,169755
01/03/2015,Montana,812295,516734,494730,22004
01/03/2015,Nebraska,1437833,1009054,979132,29922
01/03/2015,Nevada,2222091,1393136,1292980,100156
01/03/2015,Ohio,9117696,5715533,5421129,294404
01/03/2015,Oklahoma,2964358,1828473,1751584,76889
01/03/2015,Oregon,3197709,1962380,1850584,111796
01/03/2015,Pennsylvania,10213980,6406408,6052263,354145
01/03/2015,Tennessee,5143697,3062426,2878956,183470
01/03/2015,Texas,20386355,13044962,12461125,583837
01/03/2015,Utah,2127259,1441814,1390696,51118
01/03/2015,Vermont,514531,348217,335461,12756
01/03/2015,Virginia,6479492,4239843,4040318,199525
01/03/2015,Washington,5588657,3533904,3340601,193303
01/03/2015,Wisconsin,4539542,3080867,2938085,142782
01/03/2015,Wyoming,450837,302218,290102,12116
01/04/2015,Alabama,3795273,2170166,2037552,132614
01/04/2015,Alaska,541860,362975,340096,22879
01/04/2015,Arizona,5253623,3174046,2977647,196399
01/04/2015,Arkansas,2296029,1338983,1267673,71310
01/04/2015,California,30216829,18826398,17594659,1231739
01/04/2015,Colorado,4213837,2817304,2704794,112510
01/04/2015,Connecticut,2871086,1899181,1789732,109449
01/04/2015,Delaware,744119,460528,437998,22530
01/04/2015,Florida,16192418,9607811,9058084,549727
01/04/2015,Georgia,7736619,4735991,4439804,296187
01/04/2015,Hawaii,1084940,669187,645104,24083
01/04/2015,Idaho,1241296,791724,760809,30915
01/04/2015,Illinois,10051577,6499013,6106082,392931
01/04/2015,Indiana,5110758,3249285,3088493,160792
01/04/2015,Iowa,2428690,1702323,1638444,63879
01/04/2015,Kansas,2202145,1493226,1428104,65122
01/04/2015,Kentucky,3439530,1977936,1873917,104019
01/04/2015,Louisiana,3563437,2162787,2021790,140997
01/04/2015,Maine,1090579,689909,658087,31822
01/04/2015,Maryland,4692382,3141417,2978798,162619
01/04/2015,Massachusetts,5495719,3595870,3417689,178181
01/04/2015,Michigan,7876897,4750757,4479763,270994
01/04/2015,Minnesota,4275054,3002331,2888543,113788
01/04/2015,Mississippi,2277330,1257058,1174188,82870
01/04/2015,Missouri,4729926,3058205,2890940,167265
01/04/2015,Montana,812851,517282,495305,21977
01/04/2015,Nebraska,1438471,1009259,979055,30204
01/04/2015,Nevada,2225535,1394785,1295937,98848
01/04/2015,Ohio,9119310,5713945,5422656,291289
01/04/2015,Oklahoma,2966457,1831977,1753289,78688
01/04/2015,Oregon,3201589,1965819,1854638,111181
01/04/2015,Pennsylvania,10213906,6412274,6059046,353228
01/04/2015,Tennessee,5147408,3066692,2885754,180938
01/04/2015,Texas,20420653,13052347,12471167,581180
01/04/2015,Utah,2130584,1445478,1394232,51246
01/04/2015,Vermont,514616,347766,335199,12567
01/04/2015,Virginia,6483301,4239190,4042765,196425
01/04/2015,Washington,5596195,3539114,3346743,192371
01/04/2015,Wisconsin,4540646,3080496,2939372,141124
01/04/2015,Wyoming,450938,302299,289899,12400
01/05/2015,Alabama,3796534,2164519,2031470,133049
01/05/2015,Alaska,542036,362798,339977,22821
01/05/2015,Arizona,5261501,3179024,2983595,195429
01/05/2015,Arkansas,2296996,1339839,1269993,69846
01/05/2015,California,30242644,18830333,17620363,1209970
01/05/2015,Colorado,4221620,2819533,2709579,109954
01/05/2015,Connecticut,2871419,1896379,1788339,108040
01/05/2015,Delaware,744838,461456,439061,22395
01/05/2015,Florida,16218527,9618147,9074570,543577
01/05/2015,Georgia,7745959,4735398,4442925,292473
01/05/2015,Hawaii,1085320,669614,646142,23472
01/05/2015,Idaho,1242885,793675,762546,31129
01/05/2015,Illinois,10051696,6506301,6114433,391868
01/05/2015,Indiana,5112558,3254041,3096911,157130
01/05/2015,Iowa,2429607,1700817,1637661,63156
01/05/2015,Kansas,2202959,1493024,1428789,64235
01/05/2015,Kentucky,3440841,1976817,1873250,103567
01/05/2015,Louisiana,3565205,2158261,2020294,137967
01/05/2015,Maine,1090689,688694,657703,30991
01/05/2015,Maryland,4694501,3142923,2982840,160083
01/05/2015,Massachusetts,5499163,3594220,3418656,175564
01/05/2015,Michigan,7878551,4753081,4486713,266368
01/05/2015,Minnesota,4277518,3005863,2892071,113792
01/05/2015,Mississippi,2277791,1259289,1177336,81953
01/05/2015,Missouri,4731896,3058587,2895171,163416
01/05/2015,Montana,813497,517493,495499,21994
01/05/2015,Nebraska,1439238,1009818,979369,30449
01/05/2015,Nevada,2229088,1396200,1298740,97460
01/05/2015,Ohio,9121634,5712467,5426068,286399
01/05/2015,Oklahoma,2968807,1833635,1753826,79809
01/05/2015,Oregon,3205720,1970139,1859558,110581
01/05/2015,Pennsylvania,10214662,6417950,6066953,350997
01/05/2015,Tennessee,5151480,3070773,2892935,177838
01/05/2015,Texas,20455987,13062363,12483045,579318
01/05/2015,Utah,2134048,1449095,1397733,51362
01/05/2015,Vermont,514728,347189,334785,12404
01/05/2015,Virginia,6487589,4237686,4045613,192073
01/05/2015,Washington,5604203,3544965,3353329,191636
01/05/2015,Wisconsin,4542174,3080195,2941178,139017
01/05/2015,Wyoming,451154,302311,289650,12661
01/06/2015,Alabama,3798019,2157472,2024484,132988
01/06/2015,Alaska,542351,362477,339787,22690
01/06/2015,Arizona,5269624,3183495,2988875,194620
01/06/2015,Arkansas,2298077,1340124,1272125,67999
01/06/2015,California,30269968,18825613,17640900,1184713
01/06/2015,Colorado,4229782,2821315,2714525,106790
01/06/2015,Connecticut,2871838,1892772,1786301,106471
01/06/2015,Delaware,745615,462330,440105,22225
01/06/2015,Florida,16245473,9627791,9091449,536342
01/06/2015,Georgia,7755736,4733228,4444943,288285
01/06/2015,Hawaii,1086160,669943,647039,22904
01/06/2015,Idaho,1244553,795165,763973,31192
01/06/2015,Illinois,10052135,6510435,6121275,389160
01/06/2015,Indiana,5114416,3258941,3105042,153899
01/06/2015,Iowa,2430604,1698838,1636400,62438
01/06/2015,Kansas,2204047,1492703,1429837,62866
01/06/2015,Kentucky,3442383,1975226,1872397,102829
01/06/2015,Louisiana,3567129,2152853,2017960,134893
01/06/2015,Maine,1090869,687442,657285,30157
01/06/2015,Maryland,4697090,3142915,2985301,157614
01/06/2015,Massachusetts,5502715,3591258,3418552,172706
01/06/2015,Michigan,7880361,4754815,4494018,260797
01/06/2015,Minnesota,4280102,3007688,2894004,113684
01/06/2015,Mississippi,2278424,1260313,1179455,80858
01/06/2015,Missouri,4734012,3057937,2899170,158767
01/06/2015,Montana,814167,517470,495452,22018
01/06/2015,Nebraska,1440080,1010488,979862,30626
01/06/2015,Nevada,2232794,1397085,1301068,96017
01/06/2015,Ohio,9124155,5709322,5428877,280445
01/06/2015,Oklahoma,2971286,1833226,1753090,80136
01/06/2015,Oregon,3209931,1974615,1865067,109548
01/06/2015,Pennsylvania,10215636,6421791,6073881,347910
01/06/2015,Tennessee,5155812,3073789,2899547,174242
01/06/2015,Texas,20492589,13072586,12493882,578704
01/06/2015,Utah,2137565,1452297,1400856,51441
01/06/2015,Vermont,514899,346525,334255,12270
01/06/2015,Virginia,6493089,4234686,4047714,186972
01/06/2015,Washington,5612692,3550112,3359187,190925
01/06/2015,Wisconsin,4543797,3079718,2943053,136665
01/06/2015,Wyoming,451324,302119,289316,12803
01/07/2015,Alabama,3799477,2149701,2017218,132483
01/07/2015,Alaska,542488,362134,339558,22576
01/07/2015,Arizona,5277926,3187178,2993303,193875
01/07/2015,Arkansas,2299219,1339927,1273942,65985
01/07/2015,California,30296923,18816836,17658045,1158791
01/07/2015,Colorado,4237868,2823037,2719557,103480
01/07/2015,Connecticut,2872304,1889106,1784137,104969
01/07/2015,Delaware,746397,463176,441109,22067
01/07/2015,Florida,16272655,9637406,9108581,528825
01/07/2015,Georgia,7764701,4730359,4446220,284139
01/07/2015,Hawaii,1086606,670277,647849,22428
01/07/2015,Idaho,1246242,796345,765212,31133
01/07/2015,Illinois,10052479,6511967,6125787,386180
01/07/2015,Indiana,5116564,3264081,3112811,151270
01/07/2015,Iowa,2431720,1697034,1635142,61892
01/07/2015,Kansas,2205000,1492465,1431085,61380
01/07/2015,Kentucky,3443963,1974094,1871994,102100
01/07/2015,Louisiana,3569129,2146855,2014908,131947
01/07/2015,Maine,1091034,686253,656874,29379
01/07/2015,Maryland,4699564,3141732,2986335,155397
01/07/2015,Massachusetts,5506549,3587263,3417329,169934
01/07/2015,Michigan,7882629,4756256,4501568,254688
01/07/2015,Minnesota,4282892,3008042,2894625,113417
01/07/2015,Mississippi,2278975,1260827,1180794,80033
01/07/2015,Missouri,4736104,3056934,2902982,153952
01/07/2015,Montana,814872,517499,495460,22039
01/07/2015,Nebraska,1440957,1011241,980537,30704
01/07/2015,Nevada,2236496,1397589,1302948,94641
01/07/2015,Ohio,9127172,5704862,5429949,274913
01/07/2015,Oklahoma,2973610,1831607,1751708,79899
01/07/2015,Oregon,3214297,1979176,1871082,108094
01/07/2015,Pennsylvania,10217178,6424397,6079630,344767
01/07/2015,Tennessee,5160228,3075793,2905360,170433
01/07/2015,Texas,20528677,13083798,12503348,580450
01/07/2015,Utah,2141186,1455143,1403612,51531
01/07/2015,Vermont,515055,345899,333746,12153
01/07/2015,Virginia,6497687,4231177,4049219,181958
01/07/2015,Washington,5621018,3554656,3363984,190672
01/07/2015,Wisconsin,4545633,3079639,2945129,134510
01/07/2015,Wyoming,451543,301719,288919,12800
01/08/2015,Alabama,3801201,2142296,2010491,131805
01/08/2015,Alaska,542917,361851,339307,22544
01/08/2015,Arizona,5287701,3190286,2997349,192937
01/08/2015,Arkansas,2300521,1339528,1275545,63983
01/08/2015,California,30322827,18810236,17674840,1135396
01/08/2015,Colorado,4245694,2825443,2724952,100491
01/08/2015,Connecticut,2872668,1886215,1782474,103741
01/08/2015,Delaware,747145,464036,442091,21945
01/08/2015,Florida,16304520,9648341,9126443,521898
01/08/2015,Georgia,7775261,4728148,4447634,280514
01/08/2015,Hawaii,1087442,670776,648736,22040
01/08/2015,Idaho,1248753,797404,766369,31035
01/08/2015,Illinois,10052472,6513391,6128765,384626
01/08/2015,Indiana,5119646,3269717,3120334,149383
01/08/2015,Iowa,2432799,1696005,1634411,61594
01/08/2015,Kansas,2206043,1492607,1432469,60138
01/08/2015,Kentucky,3445559,1974414,1872627,101787
01/08/2015,Louisiana,3570825,2141096,2011545,129551
01/08/2015,Maine,1091444,685224,656502,28722
01/08/2015,Maryland,4701204,3140095,2986765,153330
01/08/2015,Massachusetts,5510088,3583181,3415653,167528
01/08/2015,Michigan,7886210,4758144,4509543,248601
01/08/2015,Minnesota,4286218,3007887,2894759,113128
01/08/2015,Mississippi,2279661,1261680,1181932,79748
01/08/2015,Missouri,4738008,3056343,2906823,149520
01/08/2015,Montana,815722,517775,495684,22091
01/08/2015,Nebraska,1442076,1012103,981413,30690
01/08/2015,Nevada,2240387,1398013,1304599,93414
01/08/2015,Ohio,9130533,5700670,5429438,271232
01/08/2015,Oklahoma,2975237,1829635,1750196,79439
01/08/2015,Oregon,3220392,1983912,1877482,106430
01/08/2015,Pennsylvania,10219328,6426714,6084814,341900
01/08/2015,Tennessee,5165233,3077329,2910795,166534
01/08/2015,Texas,20562773,13096567,12512227,584340
01/08/2015,Utah,2145803,1457886,1406235,51651
01/08/2015,Vermont,515083,345384,333349,12035
01/08/2015,Virginia,6502056,4227968,4050212,177756
01/08/2015,Washington,5631123,3559448,3368239,191209
01/08/2015,Wisconsin,4547707,3080585,2947761,132824
01/08/2015,Wyoming,451558,301250,288478,12772
01/09/2015,Alabama,3802943,2136055,2004972,131083
01/09/2015,Alaska,543357,361622,339036,22586
01/09/2015,Arizona,5297456,3193508,3002093,191415
01/09/2015,Arkansas,2301817,1339273,1277195,62078
01/09/2015,California,30348765,18810658,17695331,1115327
01/09/2015,Colorado,4253521,2829407,2731343,98064
01/09/2015,Connecticut,2873060,1884305,1781625,102680
01/09/2015,Delaware,747902,464940,443116,21824
01/09/2015,Florida,16336389,9661738,9146394,515344
01/09/2015,Georgia,7785882,4727779,4450420,277359
01/09/2015,Hawaii,1088175,671504,649824,21680
01/09/2015,Idaho,1251267,798413,767529,30884
01/09/2015,Illinois,10052588,6517227,6132095,385132
01/09/2015,Indiana,5122740,3276546,3128292,148254
01/09/2015,Iowa,2433958,1696155,1634605,61550
01/09/2015,Kansas,2207110,1493272,1433984,59288
01/09/2015,Kentucky,3447166,1976725,1874730,101995
01/09/2015,Louisiana,3572509,2136562,2008611,127951
01/09/2015,Maine,1091811,684534,656347,28187
01/09/2015,Maryland,4702765,3138851,2987744,151107
01/09/2015,Massachusetts,5513606,3580147,3414849,165298
01/09/2015,Michigan,7889755,4761803,4518849,242954
01/09/2015,Minnesota,4289567,3008335,2895504,112831
01/09/2015,Mississippi,2280319,1263353,1183427,79926
01/09/2015,Missouri,4739901,3056675,2911038,145637
01/09/2015,Montana,816595,518275,496124,22151
01/09/2015,Nebraska,1443217,1013086,982465,30621
01/09/2015,Nevada,2244284,1398568,1306362,92206
01/09/2015,Ohio,9133856,5698995,5428901,270094
01/09/2015,Oklahoma,2976904,1828048,1749022,79026
01/09/2015,Oregon,3226425,1989069,1884395,104674
01/09/2015,Pennsylvania,10221392,6429981,6090516,339465
01/09/2015,Tennessee,5170211,3079250,2916889,162361
01/09/2015,Texas,20597035,13111812,12523886,587926
01/09/2015,Utah,2150498,1460802,1409096,51706
01/09/2015,Vermont,515145,345015,333114,11901
01/09/2015,Virginia,6506333,4225421,4050900,174521
01/09/2015,Washington,5641221,3565425,3373358,192067
01/09/2015,Wisconsin,4549782,3082966,2951433,131533
01/09/2015,Wyoming,451548,300853,288034,12819
01/10/2015,Alabama,3804782,2135797,2005232,130565
01/10/2015,Alaska,543664,361498,338801,22697
01/10/2015,Arizona,5307253,3198236,3008840,189396
01/10/2015,Arkansas,2303143,1339813,1279410,60403
01/10/2015,California,30374660,18824385,17724466,1099919
01/10/2015,Colorado,4261240,2835695,2739313,96382
01/10/2015,Connecticut,2873493,1883557,1781801,101756
01/10/2015,Delaware,748677,465959,444262,21697
01/10/2015,Florida,16368317,9679856,9170460,509396
01/10/2015,Georgia,7796741,4730976,4456067,274909
01/10/2015,Hawaii,1088651,672548,651209,21339
01/10/2015,Idaho,1253815,799645,768912,30733
01/10/2015,Illinois,10052875,6526537,6138315,388222
01/10/2015,Indiana,5125961,3286118,3137870,148248
01/10/2015,Iowa,2435125,1697907,1636189,61718
01/10/2015,Kansas,2208046,1494509,1435575,58934
01/10/2015,Kentucky,3448760,1981083,1878391,102692
01/10/2015,Louisiana,3574214,2134141,2006830,127311
01/10/2015,Maine,1092251,684485,656665,27820
01/10/2015,Maryland,4704406,3139081,2990357,148724
01/10/2015,Massachusetts,5517301,3579727,3416493,163234
01/10/2015,Michigan,7893558,4769314,4530470,238844
01/10/2015,Minnesota,4293032,3010487,2897657,112830
01/10/2015,Mississippi,2281019,1265802,1185416,80386
01/10/2015,Missouri,4741883,3058618,2916130,142488
01/10/2015,Montana,817456,519031,496790,22241
01/10/2015,Nebraska,1444360,1014321,983776,30545
01/10/2015,Nevada,2248135,1399703,1308661,91042
01/10/2015,Ohio,9137348,5702644,5430886,271758
01/10/2015,Oklahoma,2978633,1827831,1748766,79065
01/10/2015,Oregon,3232588,1995491,1892430,103061
01/10/2015,Pennsylvania,10223727,6436573,6098624,337949
01/10/2015,Tennessee,5175203,3083238,2925088,158150
01/10/2015,Texas,20631313,13133423,12543363,590060
01/10/2015,Utah,2155154,1464379,1412676,51703
01/10/2015,Vermont,515203,344859,333101,11758
01/10/2015,Virginia,6510187,4224998,4052719,172279
01/10/2015,Washington,5651071,3573801,3380768,193033
01/10/2015,Wisconsin,4551926,3087350,2956772,130578
01/10/2015,Wyoming,451574,300679,287649,13030
01/11/2015,Alabama,3806253,2127937,1997567,130370
01/11/2015,Alaska,544206,361518,338641,22877
01/11/2015,Arizona,5316586,3204955,3017642,187313
01/11/2015,Arkansas,2304202,1341300,1282346,58954
01/11/2015,California,30399646,18852382,17762494,1089888
01/11/2015,Colorado,4268872,2844179,2748716,95463
01/11/2015,Connecticut,2873656,1883966,1782985,100981
01/11/2015,Delaware,749351,467051,445489,21562
01/11/2015,Florida,16398883,9702643,9198031,504612
01/11/2015,Georgia,7807629,4737800,4464354,273446
01/11/2015,Hawaii,1089768,673778,652737,21041
01/11/2015,Idaho,1256189,801327,770672,30655
01/11/2015,Illinois,10052412,6542574,6148366,394208
01/11/2015,Indiana,5128517,3298722,3149094,149628
01/11/2015,Iowa,2435921,1701237,1639252,61985
01/11/2015,Kansas,2208941,1496037,1437062,58975
01/11/2015,Kentucky,3450120,1986651,1883128,103523
01/11/2015,Louisiana,3575593,2133748,2006151,127597
01/11/2015,Maine,1092544,685200,657554,27646
01/11/2015,Maryland,4705748,3141039,2994693,146346
01/11/2015,Massachusetts,5520358,3582932,3421499,161433
01/11/2015,Michigan,7896257,4781113,4544206,236907
01/11/2015,Minnesota,4295969,3014550,2901181,113369
01/11/2015,Mississippi,2281545,1268447,1187642,80805
01/11/2015,Missouri,4743494,3062018,2921813,140205
01/11/2015,Montana,818218,519981,497588,22393
01/11/2015,Nebraska,1445350,1015747,985231,30516
01/11/2015,Nevada,2251878,1401563,1311565,89998
01/11/2015,Ohio,9139608,5713128,5437112,276016
01/11/2015,Oklahoma,2980187,1829254,1749506,79748
01/11/2015,Oregon,3238237,2003622,1901807,101815
01/11/2015,Pennsylvania,10224547,6446815,6108866,337949
01/11/2015,Tennessee,5179769,3090043,2935651,154392
01/11/2015,Texas,20664893,13162283,12571333,590950
01/11/2015,Utah,2159614,1468832,1417067,51765
01/11/2015,Vermont,515222,344913,333306,11607
01/11/2015,Virginia,6515086,4227185,4056317,170868
01/11/2015,Washington,5661008,3585005,3390788,194217
01/11/2015,Wisconsin,4553525,3093448,2963483,129965
01/11/2015,Wyoming,451526,300834,287332,13502
01/12/2015,Alabama,3807670,2133700,2003525,130175
01/12/2015,Alaska,544288,361660,338572,23088
01/12/2015,Arizona,5325671,3212709,3027448,185261
01/12/2015,Arkansas,2305251,1343071,1285465,57606
01/12/2015,California,30422273,18886247,17804150,1082097
01/12/2015,Colorado,4275910,2853704,2758635,95069
01/12/2015,Connecticut,2873797,1884911,1784830,100081
01/12/2015,Delaware,749992,468016,446642,21374
01/12/2015,Florida,16428472,9726210,9226214,499996
01/12/2015,Georgia,7817713,4745734,4473442,272292
01/12/2015,Hawaii,1089802,674900,654135,20765
01/12/2015,Idaho,1258579,803322,772741,30581
01/12/2015,Illinois,10051892,6561973,6160489,401484
01/12/2015,Indiana,5131265,3312477,3160677,151800
01/12/2015,Iowa,2436877,1705328,1643195,62133
01/12/2015,Kansas,2209453,1497255,1438196,59059
01/12/2015,Kentucky,3451246,1992217,1888233,103984
01/12/2015,Louisiana,3576862,2134220,2005983,128237
01/12/2015,Maine,1092829,686446,658891,27555
01/12/2015,Maryland,4706659,3143703,2999779,143924
01/12/2015,Massachusetts,5523499,3588507,3428990,159517
01/12/2015,Michigan,7899267,4795181,4558668,236513
01/12/2015,Minnesota,4298949,3019343,2905253,114090
01/12/2015,Mississippi,2281963,1270497,1189803,80694
01/12/2015,Missouri,4745022,3065552,2927136,138416
01/12/2015,Montana,818959,520883,498325,22558
01/12/2015,Nebraska,1446285,1017042,986563,30479
01/12/2015,Nevada,2255466,1403650,1314754,88896
01/12/2015,Ohio,9142204,5728436,5446975,281461
01/12/2015,Oklahoma,2981527,1831352,1750553,80799
01/12/2015,Oregon,3244022,2012522,1911765,100757
01/12/2015,Pennsylvania,10225852,6458131,6118943,339188
01/12/2015,Tennessee,5184152,3098156,2947080,151076
01/12/2015,Texas,20696766,13194306,12603859,590447
01/12/2015,Utah,2164055,1473799,1421939,51860
01/12/2015,Vermont,515234,345067,333646,11421
01/12/2015,Virginia,6517537,4230228,4060702,169526
01/12/2015,Washington,5669906,3597830,3402683,195147
01/12/2015,Wisconsin,4555288,3099913,2970598,129315
01/12/2015,Wyoming,451469,301280,287030,14250
01/01/2016,Alabama,3808871,2138981,2009234,129747
01/01/2016,Alaska,545180,361853,338581,23272
01/01/2016,Arizona,5334647,3220542,3037144,183398
01/01/2016,Arkansas,2306098,1344484,1288132,56352
01/01/2016,California,30446733,18917326,17843140,1074186
01/01/2016,Colorado,4283491,2862652,2767788,94864
01/01/2016,Connecticut,2873756,1885910,1787016,98894
01/01/2016,Delaware,750671,468654,447512,21142
01/01/2016,Florida,16458012,9746916,9252093,494823
01/01/2016,Georgia,7828808,4752310,4481522,270788
01/01/2016,Hawaii,1091566,675700,655187,20513
01/01/2016,Idaho,1260815,805322,774854,30468
01/01/2016,Illinois,10050720,6579309,6171894,407415
01/01/2016,Indiana,5133138,3324395,3170641,153754
01/01/2016,Iowa,2437374,1708738,1646660,62078
01/01/2016,Kansas,2210492,1497864,1438842,59022
01/01/2016,Kentucky,3452439,1996889,1893069,103820
01/01/2016,Louisiana,3578098,2134557,2005777,128780
01/01/2016,Maine,1092946,687907,660486,27421
01/01/2016,Maryland,4707890,3145817,3004440,141377
01/01/2016,Massachusetts,5525824,3594084,3436899,157185
01/01/2016,Michigan,7900971,4808822,4571961,236861
01/01/2016,Minnesota,4301291,3022956,2908419,114537
01/01/2016,Mississippi,2282454,1271520,1191631,79889
01/01/2016,Missouri,4746243,3068547,2931518,137029
01/01/2016,Montana,819668,521545,498852,22693
01/01/2016,Nebraska,1447160,1018062,987626,30436
01/01/2016,Nevada,2259069,1405588,1317857,87731
01/01/2016,Ohio,9143345,5743731,5457717,286014
01/01/2016,Oklahoma,2982968,1832930,1751007,81923
01/01/2016,Oregon,3249240,2020991,1921114,99877
01/01/2016,Pennsylvania,10225383,6467536,6126634,340902
01/01/2016,Tennessee,5188358,3105686,2957506,148180
01/01/2016,Texas,20729955,13224910,12635778,589132
01/01/2016,Utah,2168291,1478801,1426877,51924
01/01/2016,Vermont,515143,345245,334036,11209
01/01/2016,Virginia,6523006,4232843,4065106,167737
01/01/2016,Washington,5679860,3610474,3415138,195336
01/01/2016,Wisconsin,4556269,3105263,2977051,128212
01/01/2016,Wyoming,451394,301853,286696,15157
01/02/2016,Alabama,3810043,2143456,2014380,129076
01/02/2016,Alaska,545399,362043,338619,23424
01/02/2016,Arizona,5343405,3227960,3046025,181935
01/02/2016,Arkansas,2306995,1345263,1289972,55291
01/02/2016,California,30467943,18941962,17875645,1066317
01/02/2016,Colorado,4290525,2870218,2775432,94786
01/02/2016,Connecticut,2873720,1886939,1789442,97497
01/02/2016,Delaware,751256,468905,447972,20933
01/02/2016,Florida,16486036,9763853,9274276,489577
01/02/2016,Georgia,7838741,4756401,4487435,268966
01/02/2016,Hawaii,1091817,676234,655874,20360
01/02/2016,Idaho,1263122,807148,776822,30326
01/02/2016,Illinois,10049562,6590470,6180514,409956
01/02/2016,Indiana,5135638,3332857,3178012,154845
01/02/2016,Iowa,2438141,1710383,1648419,61964
01/02/2016,Kansas,2210999,1497789,1438855,58934
01/02/2016,Kentucky,3453453,2000307,1897358,102949
01/02/2016,Louisiana,3579257,2134491,2005278,129213
01/02/2016,Maine,1093136,689398,662178,27220
01/02/2016,Maryland,4708745,3146807,3007840,138967
01/02/2016,Massachusetts,5528649,3598443,3443921,154522
01/02/2016,Michigan,7903525,4820513,4582714,237799
01/02/2016,Minnesota,4304127,3024171,2909497,114674
01/02/2016,Mississippi,2282748,1271510,1192863,78647
01/02/2016,Missouri,4747477,3070971,2934662,136309
01/02/2016,Montana,820356,521898,499113,22785
01/02/2016,Nebraska,1448030,1018720,988278,30442
01/02/2016,Nevada,2262476,1407222,1320668,86554
01/02/2016,Ohio,9145329,5754850,5466498,288352
01/02/2016,Oklahoma,2984249,1833389,1750363,83026
01/02/2016,Oregon,3254767,2028181,1928738,99443
01/02/2016,Pennsylvania,10225863,6473118,6130276,342842
01/02/2016,Tennessee,5192499,3111657,2965602,146055
01/02/2016,Texas,20761195,13252003,12662766,589237
01/02/2016,Utah,2172793,1483530,1431601,51929
01/02/2016,Vermont,515166,345423,334400,11023
01/02/2016,Virginia,6525781,4234522,4068700,165822
01/02/2016,Washington,5688716,3621594,3426657,194937
01/02/2016,Wisconsin,4557711,3108750,2981909,126841
01/02/2016,Wyoming,451385,302351,286294,16057
01/03/2016,Alabama,3811375,2146821,2018777,128044
01/03/2016,Alaska,545610,362120,338578,23542
01/03/2016,Arizona,5352249,3234359,3053620,180739
01/03/2016,Arkansas,2308015,1345319,1290874,54445
01/03/2016,California,30489297,18959258,17901022,1058236
01/03/2016,Colorado,4297576,2876122,2781378,94744
01/03/2016,Connecticut,2873702,1888081,1792129,95952
01/03/2016,Delaware,751898,468851,448073,20778
01/03/2016,Florida,16514110,9777290,9292824,484466
01/03/2016,Georgia,7849068,4796311,4529480,266831
01/03/2016,Hawaii,1091983,676608,656314,20294
01/03/2016,Idaho,1265474,808719,778561,30158
01/03/2016,Illinois,10048662,6593404,6185600,407804
01/03/2016,Indiana,5138247,3337674,3183002,154672
01/03/2016,Iowa,2438939,1710050,1648133,61917
01/03/2016,Kansas,2211607,1496952,1438043,58909
01/03/2016,Kentucky,3454600,2002784,1901323,101461
01/03/2016,Louisiana,3580477,2133521,2004061,129460
01/03/2016,Maine,1093359,690787,663837,26950
01/03/2016,Maryland,4709564,3146772,3009911,136861
01/03/2016,Massachusetts,5531634,3601685,3450057,151628
01/03/2016,Michigan,7906243,4829629,4590535,239094
01/03/2016,Minnesota,4307033,3023055,2908446,114609
01/03/2016,Mississippi,2283174,1270710,1193455,77255
01/03/2016,Missouri,4748932,3072852,2936300,136552
01/03/2016,Montana,821079,521936,499124,22812
01/03/2016,Nebraska,1448888,1018855,988365,30490
01/03/2016,Nevada,2265948,1408473,1323153,85320
01/03/2016,Ohio,9147631,5759537,5471393,288144
01/03/2016,Oklahoma,2985654,1832699,1748627,84072
01/03/2016,Oregon,3260421,2033640,1934161,99479
01/03/2016,Pennsylvania,10226626,6474416,6129729,344687
01/03/2016,Tennessee,5196802,3116195,2971290,144905
01/03/2016,Texas,20792661,13275533,12683175,592358
01/03/2016,Utah,2177280,1487708,1435988,51720
01/03/2016,Vermont,515178,345578,334690,10888
01/03/2016,Virginia,6528060,4235332,4070935,164397
01/03/2016,Washington,5697581,3630389,3436155,194234
01/03/2016,Wisconsin,4559314,3110352,2984977,125375
01/03/2016,Wyoming,451294,302567,285818,16749
01/04/2016,Alabama,3812782,2149261,2022346,126915
01/04/2016,Alaska,545942,362119,338457,23662
01/04/2016,Arizona,5361241,3239833,3059997,179836
01/04/2016,Arkansas,2309079,1344939,1291027,53912
01/04/2016,California,30512396,18973207,17921613,1051594
01/04/2016,Colorado,4304871,2880932,2786260,94672
01/04/2016,Connecticut,2873785,1889305,1794839,94466
01/04/2016,Delaware,752531,468680,447969,20711
01/04/2016,Florida,16542894,9790156,9309537,480619
01/04/2016,Georgia,7859831,4833906,4568888,265018
01/04/2016,Hawaii,1092461,676978,656743,20235
01/04/2016,Idaho,1267849,810104,780076,30028
01/04/2016,Illinois,10048172,6589117,6186891,402226
01/04/2016,Indiana,5140915,3339764,3186380,153384
01/04/2016,Iowa,2439789,1708496,1646486,62010
01/04/2016,Kansas,2212288,1495476,1436383,59093
01/04/2016,Kentucky,3455877,2005178,1905194,99984
01/04/2016,Louisiana,3581804,2131830,2002097,129733
01/04/2016,Maine,1093632,691999,665340,26659
01/04/2016,Maryland,4710558,3146561,3011264,135297
01/04/2016,Massachusetts,5534696,3604987,3456132,148855
01/04/2016,Michigan,7909088,4836910,4596471,240439
01/04/2016,Minnesota,4310025,3021085,2906473,114612
01/04/2016,Mississippi,2283610,1269674,1193563,76111
01/04/2016,Missouri,4750527,3074491,2936456,138035
01/04/2016,Montana,821797,521820,499039,22781
01/04/2016,Nebraska,1449875,1018474,987872,30602
01/04/2016,Nevada,2269583,1409538,1325445,84093
01/04/2016,Ohio,9150016,5759108,5472521,286587
01/04/2016,Oklahoma,2987151,1831282,1746117,85165
01/04/2016,Oregon,3266109,2037655,1937802,99853
01/04/2016,Pennsylvania,10227506,6472917,6126458,346459
01/04/2016,Tennessee,5201269,3120756,2975759,144997
01/04/2016,Texas,20825236,13297832,12698126,599706
01/04/2016,Utah,2181885,1491391,1440100,51291
01/04/2016,Vermont,515160,345690,334876,10814
01/04/2016,Virginia,6531334,4236772,4072587,164185
01/04/2016,Washington,5706896,3637282,3443618,193664
01/04/2016,Wisconsin,4560930,3110891,2986761,124130
01/04/2016,Wyoming,451233,302403,285301,17102
01/05/2016,Alabama,3814145,2151573,2025350,126223
01/05/2016,Alaska,546309,362119,338314,23805
01/05/2016,Arizona,5370157,3245197,3065928,179269
01/05/2016,Arkansas,2310084,1344591,1290913,53678
01/05/2016,California,30534603,18989520,17941250,1048270
01/05/2016,Colorado,4312234,2885680,2791195,94485
01/05/2016,Connecticut,2873870,1890682,1797493,93189
01/05/2016,Delaware,753166,468563,447804,20759
01/05/2016,Florida,16571697,9806455,9327449,479006
01/05/2016,Georgia,7870375,4870975,4606634,264341
01/05/2016,Hawaii,1092967,677630,657476,20154
01/05/2016,Idaho,1270248,811416,781429,29987
01/05/2016,Illinois,10047560,6580544,6184932,395612
01/05/2016,Indiana,5143600,3340290,3189022,151268
01/05/2016,Iowa,2440696,1706702,1644496,62206
01/05/2016,Kansas,2213068,1493780,1434209,59571
01/05/2016,Kentucky,3457188,2008503,1909307,99196
01/05/2016,Louisiana,3583030,2129860,1999764,130096
01/05/2016,Maine,1093899,693068,666646,26422
01/05/2016,Maryland,4711468,3147271,3012872,134399
01/05/2016,Massachusetts,5537771,3609457,3462973,146484
01/05/2016,Michigan,7911815,4843434,4601766,241668
01/05/2016,Minnesota,4313066,3019912,2904922,114990
01/05/2016,Mississippi,2284042,1269210,1193670,75540
01/05/2016,Missouri,4752183,3076191,2935649,140542
01/05/2016,Montana,822573,521715,498984,22731
01/05/2016,Nebraska,1450843,1017826,987002,30824
01/05/2016,Nevada,2273098,1410785,1327774,83011
01/05/2016,Ohio,9152322,5756166,5470836,285330
01/05/2016,Oklahoma,2988671,1829596,1743321,86275
01/05/2016,Oregon,3271771,2040822,1940533,100289
01/05/2016,Pennsylvania,10228380,6470707,6122515,348192
01/05/2016,Tennessee,5205703,3126578,2980257,146321
01/05/2016,Texas,20857325,13321031,12710616,610415
01/05/2016,Utah,2186473,1494904,1444126,50778
01/05/2016,Vermont,515170,345778,334986,10792
01/05/2016,Virginia,6534789,4240409,4074927,165482
01/05/2016,Washington,5716292,3643393,3449983,193410
01/05/2016,Wisconsin,4562657,3111252,2987959,123293
01/05/2016,Wyoming,451222,301896,284797,17099
01/06/2016,Alabama,3815642,2154315,2028210,126105
01/06/2016,Alaska,546635,362098,338159,23939
01/06/2016,Arizona,5379277,3250898,3072085,178813
01/06/2016,Arkansas,2311209,1344422,1290844,53578
01/06/2016,California,30557662,19008579,17961187,1047392
01/06/2016,Colorado,4319761,2891014,2797121,93893
01/06/2016,Connecticut,2874029,1892133,1800092,92041
01/06/2016,Delaware,753847,468515,447619,20896
01/06/2016,Florida,16601075,9826989,9347749,479240
01/06/2016,Georgia,7880992,4908561,4643573,264988
01/06/2016,Hawaii,1093490,678662,658647,20015
01/06/2016,Idaho,1272686,812750,782732,30018
01/06/2016,Illinois,10047244,6569841,6180798,389043
01/06/2016,Indiana,5146468,3339805,3191314,148491
01/06/2016,Iowa,2441687,1705132,1642812,62320
01/06/2016,Kansas,2213900,1492201,1431926,60275
01/06/2016,Kentucky,3458575,2012869,1913680,99189
01/06/2016,Louisiana,3584422,2127524,1997206,130318
01/06/2016,Maine,1094206,694036,667788,26248
01/06/2016,Maryland,4712540,3149300,3015276,134024
01/06/2016,Massachusetts,5541082,3614771,3470308,144463
01/06/2016,Michigan,7914881,4849566,4606797,242769
01/06/2016,Minnesota,4316269,3019989,2904199,115790
01/06/2016,Mississippi,2284502,1269750,1194254,75496
01/06/2016,Missouri,4753964,3077577,2934414,143163
01/06/2016,Montana,823348,521652,499016,22636
01/06/2016,Nebraska,1451894,1017046,985933,31113
01/06/2016,Nevada,2276707,1412384,1330298,82086
01/06/2016,Ohio,9155037,5752564,5467270,285294
01/06/2016,Oklahoma,2990230,1828018,1740924,87094
01/06/2016,Oregon,3277621,2043662,1943278,100384
01/06/2016,Pennsylvania,10229680,6468539,6119045,349494
01/06/2016,Tennessee,5210293,3133742,2985440,148302
01/06/2016,Texas,20889995,13344101,12722956,621145
01/06/2016,Utah,2191135,1498447,1448202,50245
01/06/2016,Vermont,515205,345859,335071,10788
01/06/2016,Virginia,6538478,4246189,4078270,167919
01/06/2016,Washington,5725845,3649388,3456222,193166
01/06/2016,Wisconsin,4564494,3111805,2989047,122758
01/06/2016,Wyoming,451169,301109,284349,16760
01/07/2016,Alabama,3817320,2157474,2031143,126331
01/07/2016,Alaska,547000,362029,338000,24029
01/07/2016,Arizona,5388764,3256816,3078706,178110
01/07/2016,Arkansas,2312505,1344309,1290861,53448
01/07/2016,California,30582360,19028074,17981056,1047018
01/07/2016,Colorado,4327483,2896793,2804247,92546
01/07/2016,Connecticut,2874369,1893536,1802669,90867
01/07/2016,Delaware,754560,468517,447440,21077
01/07/2016,Florida,16631565,9850017,9369741,480276
01/07/2016,Georgia,7891678,4947062,4680456,266606
01/07/2016,Hawaii,1094097,679858,660086,19772
01/07/2016,Idaho,1275237,814013,784003,30010
01/07/2016,Illinois,10047294,6558534,6175653,382881
01/07/2016,Indiana,5149720,3338179,3192914,145265
01/07/2016,Iowa,2442852,1703877,1641745,62132
01/07/2016,Kansas,2214883,1490884,1429885,60999
01/07/2016,Kentucky,3460228,2017591,1917963,99628
01/07/2016,Louisiana,3586053,2124777,1994428,130349
01/07/2016,Maine,1094627,694904,668817,26087
01/07/2016,Maryland,4714009,3152707,3018813,133894
01/07/2016,Massachusetts,5544738,3620318,3477693,142625
01/07/2016,Michigan,7918535,4855399,4611733,243666
01/07/2016,Minnesota,4319767,3021008,2904097,116911
01/07/2016,Mississippi,2285162,1270922,1195416,75506
01/07/2016,Missouri,4755898,3078141,2933221,144920
01/07/2016,Montana,824204,521634,499140,22494
01/07/2016,Nebraska,1453027,1016161,984777,31384
01/07/2016,Nevada,2280511,1414241,1333032,81209
01/07/2016,Ohio,9158454,5749748,5463246,286502
01/07/2016,Oklahoma,2991883,1826864,1739455,87409
01/07/2016,Oregon,3283694,2046599,1946984,99615
01/07/2016,Pennsylvania,10231756,6465434,6115856,349578
01/07/2016,Tennessee,5215287,3141665,2991411,150254
01/07/2016,Texas,20923730,13365941,12736496,629445
01/07/2016,Utah,2195928,1502055,1452325,49730
01/07/2016,Vermont,515265,345924,335154,10770
01/07/2016,Virginia,6542390,4253358,4082681,170677
01/07/2016,Washington,5735768,3655019,3462950,192069
01/07/2016,Wisconsin,4566737,3112393,2990301,122092
01/07/2016,Wyoming,451175,300247,283973,16274
01/08/2016,Alabama,3819041,2160744,2034025,126719
01/08/2016,Alaska,547166,361944,337853,24091
01/08/2016,Arizona,5398026,3262727,3085510,177217
01/08/2016,Arkansas,2313694,1344072,1290838,53234
01/08/2016,California,30603497,19046039,17999607,1046432
01/08/2016,Colorado,4333997,2902625,2812008,90617
01/08/2016,Connecticut,2874907,1894991,1805214,89777
01/08/2016,Delaware,755276,468615,447331,21284
01/08/2016,Florida,16660212,9873290,9391728,481562
01/08/2016,Georgia,7901048,4986532,4717653,268879
01/08/2016,Hawaii,1094428,680909,661451,19458
01/08/2016,Idaho,1277924,815143,785242,29901
01/08/2016,Illinois,10047320,6548208,6170083,378125
01/08/2016,Indiana,5152279,3335426,3193276,142150
01/08/2016,Iowa,2443877,1702459,1640827,61632
01/08/2016,Kansas,2215338,1489730,1428192,61538
01/08/2016,Kentucky,3461891,2022067,1921669,100398
01/08/2016,Louisiana,3586312,2121376,1991224,130152
01/08/2016,Maine,1095131,695716,669786,25930
01/08/2016,Maryland,4716465,3157347,3023343,134004
01/08/2016,Massachusetts,5548563,3625768,3484610,141158
01/08/2016,Michigan,7922091,4860940,4616444,244496
01/08/2016,Minnesota,4323214,3022594,2904394,118200
01/08/2016,Mississippi,2285881,1272319,1196860,75459
01/08/2016,Missouri,4757964,3077411,2932194,145217
01/08/2016,Montana,825155,521668,499311,22357
01/08/2016,Nebraska,1453909,1015208,983589,31619
01/08/2016,Nevada,2284685,1416277,1335898,80379
01/08/2016,Ohio,9162085,5749164,5459942,289222
01/08/2016,Oklahoma,2992749,1826152,1738948,87204
01/08/2016,Oregon,3288289,2049413,1951419,97994
01/08/2016,Pennsylvania,10234047,6460382,6111927,348455
01/08/2016,Tennessee,5220640,3148996,2997016,151980
01/08/2016,Texas,20954163,13386060,12750754,635306
01/08/2016,Utah,2200587,1505706,1456380,49326
01/08/2016,Vermont,515403,345995,335259,10736
01/08/2016,Virginia,6548312,4261151,4088025,173126
01/08/2016,Washington,5746009,3660154,3470082,190072
01/08/2016,Wisconsin,4568957,3112627,2991530,121097
01/08/2016,Wyoming,450983,299501,283660,15841
01/09/2016,Alabama,3820951,2163777,2036649,127128
01/09/2016,Alaska,547374,361974,337799,24175
01/09/2016,Arizona,5407618,3268544,3092046,176498
01/09/2016,Arkansas,2314999,1343648,1290648,53000
01/09/2016,California,30626494,19061155,18015129,1046026
01/09/2016,Colorado,4340722,2908090,2819516,88574
01/09/2016,Connecticut,2875660,1896690,1807641,89049
01/09/2016,Delaware,756102,468865,447328,21537
01/09/2016,Florida,16689784,9894617,9411626,482991
01/09/2016,Georgia,7910767,5007844,4736489,271355
01/09/2016,Hawaii,1094839,681639,662483,19156
01/09/2016,Idaho,1280709,816266,786512,29754
01/09/2016,Illinois,10047781,6539107,6164292,374815
01/09/2016,Indiana,5155140,3331610,3191886,139724
01/09/2016,Iowa,2445007,1700400,1639444,60956
01/09/2016,Kansas,2215863,1488560,1426801,61759
01/09/2016,Kentucky,3463726,2026061,1924543,101518
01/09/2016,Louisiana,3586737,2117470,1987810,129660
01/09/2016,Maine,1095713,696481,670673,25808
01/09/2016,Maryland,4719113,3162687,3028270,134417
01/09/2016,Massachusetts,5552657,3630818,3490335,140483
01/09/2016,Michigan,7925989,4866256,4620323,245933
01/09/2016,Minnesota,4326878,3024432,2904939,119493
01/09/2016,Mississippi,2286653,1273642,1198270,75372
01/09/2016,Missouri,4760235,3075144,2931162,143982
01/09/2016,Montana,826169,521755,499476,22279
01/09/2016,Nebraska,1454904,1014279,982416,31863
01/09/2016,Nevada,2289002,1418474,1338773,79701
01/09/2016,Ohio,9166161,5752040,5458133,293907
01/09/2016,Oklahoma,2993771,1825492,1738937,86555
01/09/2016,Oregon,3293114,2051528,1955705,95823
01/09/2016,Pennsylvania,10236775,6453159,6106573,346586
01/09/2016,Tennessee,5226225,3154762,3001280,153482
01/09/2016,Texas,20985782,13403980,12763563,640417
01/09/2016,Utah,2205274,1509362,1460215,49147
01/09/2016,Vermont,515579,346058,335351,10707
01/09/2016,Virginia,6554563,4269034,4094058,174976
01/09/2016,Washington,5756519,3665002,3477143,187859
01/09/2016,Wisconsin,4571331,3112289,2992319,119970
01/09/2016,Wyoming,450823,298941,283384,15557
01/10/2016,Alabama,3822861,2166110,2039127,126983
01/10/2016,Alaska,547373,362112,337870,24242
01/10/2016,Arizona,5417057,3274187,3098339,175848
01/10/2016,Arkansas,2316340,1342910,1290250,52660
01/10/2016,California,30648257,19071727,18028383,1043344
01/10/2016,Colorado,4347159,2912869,2826596,86273
01/10/2016,Connecticut,2876331,1898583,1810005,88578
01/10/2016,Delaware,756884,469237,447444,21793
01/10/2016,Florida,16718944,9912032,9428996,483036
01/10/2016,Georgia,7920402,5065858,4793054,272804
01/10/2016,Hawaii,1094781,681999,663144,18855
01/10/2016,Idaho,1283493,817413,787865,29548
01/10/2016,Illinois,10048334,6529612,6158816,370796
01/10/2016,Indiana,5158013,3326557,3188983,137574
01/10/2016,Iowa,2446168,1697326,1637247,60079
01/10/2016,Kansas,2216246,1487280,1425871,61409
01/10/2016,Kentucky,3465422,2029535,1926913,102622
01/10/2016,Louisiana,3587044,2113467,1984845,128622
01/10/2016,Maine,1096317,697115,671499,25616
01/10/2016,Maryland,4721604,3167854,3033190,134664
01/10/2016,Massachusetts,5556771,3635097,3494693,140404
01/10/2016,Michigan,7930030,4870453,4623219,247234
01/10/2016,Minnesota,4330635,3026209,2906061,120148
01/10/2016,Mississippi,2287376,1274607,1199606,75001
01/10/2016,Missouri,4762631,3071352,2930190,141162
01/10/2016,Montana,827139,521828,499594,22234
01/10/2016,Nebraska,1455876,1013352,981360,31992
01/10/2016,Nevada,2293207,1420709,1341689,79020
01/10/2016,Ohio,9170273,5757428,5457993,299435
01/10/2016,Oklahoma,2994760,1824350,1738956,85394
01/10/2016,Oregon,3297913,2052451,1959271,93180
01/10/2016,Pennsylvania,10239633,6444103,6100196,343907
01/10/2016,Tennessee,5231683,3158441,3004295,154146
01/10/2016,Texas,21016880,13419163,12774408,644755
01/10/2016,Utah,2210053,1512986,1463848,49138
01/10/2016,Vermont,515777,346102,335396,10706
01/10/2016,Virginia,6559961,4276217,4100496,175721
01/10/2016,Washington,5766564,3669217,3483903,185314
01/10/2016,Wisconsin,4573809,3111091,2992589,118502
01/10/2016,Wyoming,450635,298556,283145,15411
01/11/2016,Alabama,3824434,2167734,2042073,125661
01/11/2016,Alaska,547491,362298,338067,24231
01/11/2016,Arizona,5426062,3280006,3105116,174890
01/11/2016,Arkansas,2317392,1342237,1290085,52152
01/11/2016,California,30668672,19079948,18044658,1035290
01/11/2016,Colorado,4353436,2917546,2834159,83387
01/11/2016,Connecticut,2876745,1900809,1812673,88136
01/11/2016,Delaware,757580,469756,447782,21974
01/11/2016,Florida,16746204,9926694,9446908,479786
01/11/2016,Georgia,7929986,5066497,4794312,272185
01/11/2016,Hawaii,1095019,682195,663687,18508
01/11/2016,Idaho,1286128,818658,789438,29220
01/11/2016,Illinois,10048158,6518407,6154569,363838
01/11/2016,Indiana,5160413,3321175,3186375,134800
01/11/2016,Iowa,2447065,1693569,1634566,59003
01/11/2016,Kansas,2216532,1486064,1425661,60403
01/11/2016,Kentucky,3466939,2033028,1929665,103363
01/11/2016,Louisiana,3587097,2110081,1983120,126961
01/11/2016,Maine,1096776,697657,672408,25249
01/11/2016,Maryland,4723739,3172830,3038452,134378
01/11/2016,Massachusetts,5560400,3639080,3498632,140448
01/11/2016,Michigan,7933209,4873086,4626288,246798
01/11/2016,Minnesota,4333928,3028316,2908696,119620
01/11/2016,Mississippi,2287980,1275297,1201112,74185
01/11/2016,Missouri,4764665,3066907,2929960,136947
01/11/2016,Montana,828064,521938,499776,22162
01/11/2016,Nebraska,1456682,1012567,980719,31848
01/11/2016,Nevada,2297276,1423131,1344990,78141
01/11/2016,Ohio,9173416,5763754,5460359,303395
01/11/2016,Oklahoma,2995627,1822914,1739205,83709
01/11/2016,Oregon,3302377,2052819,1962568,90251
01/11/2016,Pennsylvania,10241288,6435694,6095476,340218
01/11/2016,Tennessee,5236761,3160471,3007297,153174
01/11/2016,Texas,21046899,13434311,12787312,646999
01/11/2016,Utah,2214643,1516777,1467644,49133
01/11/2016,Vermont,515880,346202,335457,10745
01/11/2016,Virginia,6565331,4283055,4107886,175169
01/11/2016,Washington,5776410,3673004,3490923,182081
01/11/2016,Wisconsin,4575836,3109627,2993340,116287
01/11/2016,Wyoming,450398,298248,282998,15250
01/12/2016,Alabama,3825968,2168771,2045834,122937
01/12/2016,Alaska,547590,362459,338328,24131
01/12/2016,Arizona,5434795,3286375,3112781,173594
01/12/2016,Arkansas,2318409,1342177,1290651,51526
01/12/2016,California,30688153,19090083,18068401,1021682
01/12/2016,Colorado,4359555,2922961,2842900,80061
01/12/2016,Connecticut,2877085,1903587,1815897,87690
01/12/2016,Delaware,758249,470473,448430,22043
01/12/2016,Florida,16773010,9941833,9468761,473072
01/12/2016,Georgia,7939421,5068628,4799051,269577
01/12/2016,Hawaii,1095214,682432,664308,18124
01/12/2016,Idaho,1288749,820142,791352,28790
01/12/2016,Illinois,10047713,6506520,6152559,353961
01/12/2016,Indiana,5162688,3317083,3185941,131142
01/12/2016,Iowa,2447876,1689919,1632092,57827
01/12/2016,Kansas,2216707,1485099,1426125,58974
01/12/2016,Kentucky,3468367,2036870,1933310,103560
01/12/2016,Louisiana,3587029,2107951,1982995,124956
01/12/2016,Maine,1097189,698186,673402,24784
01/12/2016,Maryland,4725774,3177879,3044323,133556
01/12/2016,Massachusetts,5563855,3643795,3503296,140499
01/12/2016,Michigan,7936205,4874253,4630737,243516
01/12/2016,Minnesota,4337066,3031048,2913051,117997
01/12/2016,Mississippi,2288535,1275809,1202794,73015
01/12/2016,Missouri,4766621,3063183,2930971,132212
01/12/2016,Montana,828950,522219,500168,22051
01/12/2016,Nebraska,1457487,1012214,980735,31479
01/12/2016,Nevada,2301284,1426046,1348939,77107
01/12/2016,Ohio,9176341,5770112,5465690,304422
01/12/2016,Oklahoma,2996384,1821747,1740013,81734
01/12/2016,Oregon,3306702,2053931,1966524,87407
01/12/2016,Pennsylvania,10242658,6430351,6094481,335870
01/12/2016,Tennessee,5241716,3161953,3011886,150067
01/12/2016,Texas,21076258,13452830,12805992,646838
01/12/2016,Utah,2219183,1520948,1471879,49069
01/12/2016,Vermont,515998,346418,335584,10834
01/12/2016,Virginia,6570569,4290653,4116919,173734
01/12/2016,Washington,5786076,3677076,3498667,178409
01/12/2016,Wisconsin,4577736,3108972,2995667,113305
01/12/2016,Wyoming,450188,297901,282982,14919
01/01/2017,Alabama,3827336,2169189,2050155,119034
01/01/2017,Alaska,547623,362577,338607,23970
01/01/2017,Arizona,5443325,3293551,3121383,172168
01/01/2017,Arkansas,2319332,1343005,1292124,50881
01/01/2017,California,30706378,19104295,18099840,1004455
01/01/2017,Colorado,4365315,2929729,2852981,76748
01/01/2017,Connecticut,2877354,1906632,1819374,87258
01/01/2017,Delaware,758922,471348,449362,21986
01/01/2017,Florida,16799082,9959680,9495705,463975
01/01/2017,Georgia,7948388,5072698,4807043,265655
01/01/2017,Hawaii,1095136,682762,665044,17718
01/01/2017,Idaho,1291268,821939,793663,28276
01/01/2017,Illinois,10046909,6496269,6153055,343214
01/01/2017,Indiana,5164740,3315526,3188666,126860
01/01/2017,Iowa,2448593,1687324,1630667,56657
01/01/2017,Kansas,2216729,1484359,1426926,57433
01/01/2017,Kentucky,3469500,2040998,1937727,103271
01/01/2017,Louisiana,3586792,2106911,1984300,122611
01/01/2017,Maine,1097564,698709,674366,24343
01/01/2017,Maryland,4727477,3183120,3050617,132503
01/01/2017,Massachusetts,5567147,3650057,3509430,140627
01/01/2017,Michigan,7938921,4874232,4637189,237043
01/01/2017,Minnesota,4340091,3034846,2919266,115580
01/01/2017,Mississippi,2288902,1276109,1204436,71673
01/01/2017,Missouri,4768305,3060674,2932864,127810
01/01/2017,Montana,829814,522736,500829,21907
01/01/2017,Nebraska,1458153,1012343,981325,31018
01/01/2017,Nevada,2305093,1429587,1353517,76070
01/01/2017,Ohio,9178815,5776773,5473846,302927
01/01/2017,Oklahoma,2996974,1821261,1741505,79756
01/01/2017,Oregon,3310911,2056713,1971741,84972
01/01/2017,Pennsylvania,10243590,6428773,6097160,331613
01/01/2017,Tennessee,5246270,3163878,3018945,144933
01/01/2017,Texas,21104864,13475517,12831319,644198
01/01/2017,Utah,2223546,1525486,1476505,48981
01/01/2017,Vermont,516063,346696,335767,10929
01/01/2017,Virginia,6574870,4299497,4127652,171845
01/01/2017,Washington,5795156,3682399,3507480,174919
01/01/2017,Wisconsin,4579412,3109927,2999980,109947
01/01/2017,Wyoming,449900,297484,283090,14394
01/02/2017,Alabama,3828265,2169168,2054720,114448
01/02/2017,Alaska,547523,362605,338829,23776
01/02/2017,Arizona,5451183,3301274,3130805,170469
01/02/2017,Arkansas,2319981,1344688,1294415,50273
01/02/2017,California,30720743,19121397,18136366,985031
01/02/2017,Colorado,4370670,2938091,2864182,73909
01/02/2017,Connecticut,2877294,1909269,1822563,86706
01/02/2017,Delaware,759440,472237,450433,21804
01/02/2017,Florida,16822770,9980408,9527052,453356
01/02/2017,Georgia,7956361,5078100,4817250,260850
01/02/2017,Hawaii,1094820,683131,665872,17259
01/02/2017,Idaho,1293661,823968,796281,27687
01/02/2017,Illinois,10044983,6488487,6155316,333171
01/02/2017,Indiana,5166404,3316422,3194259,122163
01/02/2017,Iowa,2449040,1686199,1630708,55491
01/02/2017,Kansas,2216489,1483907,1427958,55949
01/02/2017,Kentucky,3470348,2045074,1942386,102688
01/02/2017,Louisiana,3586192,2106351,1986682,119669
01/02/2017,Maine,1097810,699228,675229,23999
01/02/2017,Maryland,4728764,3188452,3057065,131387
01/02/2017,Massachusetts,5569963,3657344,3516653,140691
01/02/2017,Michigan,7940951,4873554,4645337,228217
01/02/2017,Minnesota,4342753,3039709,2927040,112669
01/02/2017,Mississippi,2289079,1276237,1205892,70345
01/02/2017,Missouri,4769419,3059217,2935347,123870
01/02/2017,Montana,830555,523443,501711,21732
01/02/2017,Nebraska,1458699,1012904,982401,30503
01/02/2017,Nevada,2308708,1433636,1358554,75082
01/02/2017,Ohio,9180547,5783542,5483674,299868
01/02/2017,Oklahoma,2997232,1821588,1743748,77840
01/02/2017,Oregon,3314845,2061602,1978539,83063
01/02/2017,Pennsylvania,10243625,6430102,6102515,327587
01/02/2017,Tennessee,5250360,3166548,3028406,138142
01/02/2017,Texas,21131020,13499782,12862492,637290
01/02/2017,Utah,2227847,1530178,1481315,48863
01/02/2017,Vermont,516120,346946,335994,10952
01/02/2017,Virginia,6578630,4309148,4139557,169591
01/02/2017,Washington,5803711,3689536,3517700,171836
01/02/2017,Wisconsin,4580718,3112689,3006097,106592
01/02/2017,Wyoming,449600,297008,283273,13735
01/03/2017,Alabama,3829333,2169063,2059199,109864
01/03/2017,Alaska,547417,362524,338908,23616
01/03/2017,Arizona,5459193,3308948,3140297,168651
01/03/2017,Arkansas,2320778,1346836,1296965,49871
01/03/2017,California,30735267,19138738,18171800,966938
01/03/2017,Colorado,4376278,2947782,2875727,72055
01/03/2017,Connecticut,2877313,1910761,1824688,86073
01/03/2017,Delaware,760014,473009,451426,21583
01/03/2017,Florida,16846758,10002242,9559207,443035
01/03/2017,Georgia,7964783,5084089,4828075,256014
01/03/2017,Hawaii,1094525,683299,666542,16757
01/03/2017,Idaho,1296159,826061,798974,27087
01/03/2017,Illinois,10043386,6483032,6157292,325740
01/03/2017,Indiana,5168285,3318619,3200762,117857
01/03/2017,Iowa,2449719,1686230,1631800,54430
01/03/2017,Kansas,2216375,1483866,1429048,54818
01/03/2017,Kentucky,3471436,2048431,1946296,102135
01/03/2017,Louisiana,3585727,2106037,1989661,116376
01/03/2017,Maine,1098136,699670,675848,23822
01/03/2017,Maryland,4730125,3193349,3062891,130458
01/03/2017,Massachusetts,5572949,3664380,3523611,140769
01/03/2017,Michigan,7943239,4872774,4653439,219335
01/03/2017,Minnesota,4345594,3044443,2934574,109869
01/03/2017,Mississippi,2289330,1276233,1206961,69272
01/03/2017,Missouri,4770874,3058640,2938027,120613
01/03/2017,Montana,831334,524216,502647,21569
01/03/2017,Nebraska,1459369,1013791,983736,30055
01/03/2017,Nevada,2312390,1437984,1363702,74282
01/03/2017,Ohio,9182728,5789264,5492641,296623
01/03/2017,Oklahoma,2997625,1822754,1746581,76173
01/03/2017,Oregon,3318897,2068264,1986270,81994
01/03/2017,Pennsylvania,10244043,6432034,6107865,324169
01/03/2017,Tennessee,5254762,3169775,3039106,130669
01/03/2017,Texas,21157545,13521412,12895119,626293
01/03/2017,Utah,2232281,1534721,1485912,48809
01/03/2017,Vermont,516208,347125,336240,10885
01/03/2017,Virginia,6582701,4318271,4151048,167223
01/03/2017,Washington,5812551,3698062,3528462,169600
01/03/2017,Wisconsin,4582253,3116581,3012701,103880
01/03/2017,Wyoming,449313,296518,283446,13072
01/04/2017,Alabama,3830510,2169397,2063832,105565
01/04/2017,Alaska,547545,362324,338797,23527
01/04/2017,Arizona,5467393,3316282,3149472,166810
01/04/2017,Arkansas,2321575,1349136,1299404,49732
01/04/2017,California,30752193,19156417,18204216,952201
01/04/2017,Colorado,4382200,2958477,2886975,71502
01/04/2017,Connecticut,2877417,1910872,1825493,85379
01/04/2017,Delaware,760618,473786,452398,21388
01/04/2017,Florida,16871541,10021874,9587640,434234
01/04/2017,Georgia,7973759,5091222,4839659,251563
01/04/2017,Hawaii,1094624,683102,666882,16220
01/04/2017,Idaho,1298673,828212,801688,26524
01/04/2017,Illinois,10042277,6480395,6158728,321667
01/04/2017,Indiana,5170204,3321686,3206865,114821
01/04/2017,Iowa,2450329,1687055,1633446,53609
01/04/2017,Kansas,2216468,1484339,1430129,54210
01/04/2017,Kentucky,3472662,2050906,1949344,101562
01/04/2017,Louisiana,3585365,2106249,1993148,113101
01/04/2017,Maine,1098491,700067,676260,23807
01/04/2017,Maryland,4731712,3197993,3068197,129796
01/04/2017,Massachusetts,5575973,3670870,3529989,140881
01/04/2017,Michigan,7945516,4873671,4660416,213255
01/04/2017,Minnesota,4348459,3048561,2940884,107677
01/04/2017,Mississippi,2289668,1276242,1207760,68482
01/04/2017,Missouri,4772470,3058858,2940847,118011
01/04/2017,Montana,832173,524980,503516,21464
01/04/2017,Nebraska,1460051,1014926,985145,29781
01/04/2017,Nevada,2316135,1442558,1368857,73701
01/04/2017,Ohio,9184900,5793990,5500107,293883
01/04/2017,Oklahoma,2998224,1825034,1750143,74891
01/04/2017,Oregon,3322961,2075771,1993891,81880
01/04/2017,Pennsylvania,10244449,6432707,6111244,321463
01/04/2017,Tennessee,5259299,3173752,3050343,123409
01/04/2017,Texas,21185490,13539599,12926792,612807
01/04/2017,Utah,2236716,1539025,1490178,48847
01/04/2017,Vermont,516283,347240,336510,10730
01/04/2017,Virginia,6587696,4326576,4161649,164927
01/04/2017,Washington,5821915,3707560,3538912,168648
01/04/2017,Wisconsin,4583785,3120906,3018674,102232
01/04/2017,Wyoming,449046,296125,283584,12541
01/05/2017,Alabama,3831738,2170254,2068766,101488
01/05/2017,Alaska,547568,362029,338550,23479
01/05/2017,Arizona,5475632,3322775,3157971,164804
01/05/2017,Arkansas,2322473,1351283,1301495,49788
01/05/2017,California,30768143,19173509,18233484,940025
01/05/2017,Colorado,4388075,2969650,2897307,72343
01/05/2017,Connecticut,2877571,1909656,1825046,84610
01/05/2017,Delaware,761229,474681,453457,21224
01/05/2017,Florida,16896488,10035568,9608502,427066
01/05/2017,Georgia,7982640,5099686,4852300,247386
01/05/2017,Hawaii,1094527,682436,666824,15612
01/05/2017,Idaho,1301254,830435,804386,26049
01/05/2017,Illinois,10041245,6480342,6160153,320189
01/05/2017,Indiana,5172316,3325107,3211596,113511
01/05/2017,Iowa,2451132,1688010,1635031,52979
01/05/2017,Kansas,2216547,1485132,1431168,53964
01/05/2017,Kentucky,3473934,2052494,1951741,100753
01/05/2017,Louisiana,3585080,2106810,1996900,109910
01/05/2017,Maine,1098886,700407,676534,23873
01/05/2017,Maryland,4733208,3202591,3073263,129328
01/05/2017,Massachusetts,5579253,3676709,3535808,140901
01/05/2017,Michigan,7948140,4877498,4665848,211650
01/05/2017,Minnesota,4351521,3051857,2945848,106009
01/05/2017,Mississippi,2290029,1276089,1208352,67737
01/05/2017,Missouri,4774274,3059510,2943719,115791
01/05/2017,Montana,833044,525640,504229,21411
01/05/2017,Nebraska,1460788,1016136,986512,29624
01/05/2017,Nevada,2319911,1447183,1373995,73188
01/05/2017,Ohio,9187468,5798349,5506621,291728
01/05/2017,Oklahoma,2998855,1828387,1754403,73984
01/05/2017,Oregon,3327202,2082873,2000363,82510
01/05/2017,Pennsylvania,10245398,6430882,6111812,319070
01/05/2017,Tennessee,5263952,3178589,3061471,117118
01/05/2017,Texas,21212877,13554747,12956771,597976
01/05/2017,Utah,2241236,1542965,1494109,48856
01/05/2017,Vermont,516395,347293,336775,10518
01/05/2017,Virginia,6592107,4334159,4171541,162618
01/05/2017,Washington,5831159,3717174,3548309,168865
01/05/2017,Wisconsin,4585572,3125083,3023465,101618
01/05/2017,Wyoming,448807,295897,283669,12228
01/06/2017,Alabama,3833212,2171313,2073459,97854
01/06/2017,Alaska,547498,361709,338239,23470
01/06/2017,Arizona,5484293,3328309,3165349,162960
01/06/2017,Arkansas,2323505,1352962,1302925,50037
01/06/2017,California,30785787,19188584,18258506,930078
01/06/2017,Colorado,4394135,2980602,2906089,74513
01/06/2017,Connecticut,2877943,1907293,1823366,83927
01/06/2017,Delaware,761894,475693,454570,21123
01/06/2017,Florida,16922604,10042754,9620715,422039
01/06/2017,Georgia,7991681,5108679,4864903,243776
01/06/2017,Hawaii,1094338,681277,666324,14953
01/06/2017,Idaho,1303917,832754,807001,25753
01/06/2017,Illinois,10040833,6482173,6161540,320633
01/06/2017,Indiana,5174848,3328244,3214341,113903
01/06/2017,Iowa,2452121,1688463,1635980,52483
01/06/2017,Kansas,2216714,1485827,1431955,53872
01/06/2017,Kentucky,3475403,2053206,1953465,99741
01/06/2017,Louisiana,3584978,2107644,2000528,107116
01/06/2017,Maine,1099367,700618,676626,23992
01/06/2017,Maryland,4735001,3206885,3077664,129221
01/06/2017,Massachusetts,5582922,3681881,3540960,140921
01/06/2017,Michigan,7951337,4883773,4669549,214224
01/06/2017,Minnesota,4354936,3054311,2949555,104756
01/06/2017,Mississippi,2290451,1275600,1208597,67003
01/06/2017,Missouri,4776343,3060109,2946086,114023
01/06/2017,Montana,833938,526118,504679,21439
01/06/2017,Nebraska,1461662,1017213,987682,29531
01/06/2017,Nevada,2323776,1451672,1378935,72737
01/06/2017,Ohio,9190673,5803149,5512740,290409
01/06/2017,Oklahoma,2999600,1832045,1758622,73423
01/06/2017,Oregon,3331658,2088296,2004680,83616
01/06/2017,Pennsylvania,10247076,6426822,6109464,317358
01/06/2017,Tennessee,5268917,3184073,3071416,112657
01/06/2017,Texas,21241618,13567834,12983477,584357
01/06/2017,Utah,2245932,1546385,1497558,48827
01/06/2017,Vermont,516530,347283,336961,10322
01/06/2017,Virginia,6596798,4340500,4180059,160441
01/06/2017,Washington,5840658,3725985,3555963,170022
01/06/2017,Wisconsin,4587663,3128427,3026599,101828
01/06/2017,Wyoming,448586,295839,283652,12187
01/07/2017,Alabama,3834828,2172434,2077532,94902
01/07/2017,Alaska,547459,361372,337880,23492
01/07/2017,Arizona,5493149,3333523,3171760,161763
01/07/2017,Arkansas,2324707,1353952,1303536,50416
01/07/2017,California,30803890,19201013,18279336,921677
01/07/2017,Colorado,4400398,2991064,2913469,77595
01/07/2017,Connecticut,2878402,1904292,1820854,83438
01/07/2017,Delaware,762579,476718,455623,21095
01/07/2017,Florida,16949383,10045858,9626706,419152
01/07/2017,Georgia,8000403,5117098,4876282,240816
01/07/2017,Hawaii,1094083,679818,665480,14338
01/07/2017,Idaho,1306643,835212,809546,25666
01/07/2017,Illinois,10040493,6485261,6163441,321820
01/07/2017,Indiana,5177619,3330989,3215762,115227
01/07/2017,Iowa,2453207,1688210,1636179,52031
01/07/2017,Kansas,2216971,1486048,1432274,53774
01/07/2017,Kentucky,3477035,2053360,1954844,98516
01/07/2017,Louisiana,3585050,2108807,2003873,104934
01/07/2017,Maine,1099895,700664,676579,24085
01/07/2017,Maryland,4737038,3210414,3080784,129630
01/07/2017,Massachusetts,5586853,3686544,3545472,141072
01/07/2017,Michigan,7954986,4891251,4671432,219819
01/07/2017,Minnesota,4358552,3056135,2952276,103859
01/07/2017,Mississippi,2291018,1274892,1208572,66320
01/07/2017,Missouri,4778332,3060236,2947425,112811
01/07/2017,Montana,834883,526397,504854,21543
01/07/2017,Nebraska,1462522,1018050,988499,29551
01/07/2017,Nevada,2327779,1456066,1383638,72428
01/07/2017,Ohio,9194409,5808288,5518553,289735
01/07/2017,Oklahoma,3000330,1835214,1762128,73086
01/07/2017,Oregon,3336293,2091404,2006490,84914
01/07/2017,Pennsylvania,10249321,6422159,6105265,316894
01/07/2017,Tennessee,5274154,3190171,3079880,110291
01/07/2017,Texas,21270568,13580571,13006707,573864
01/07/2017,Utah,2250729,1549348,1500540,48808
01/07/2017,Vermont,516703,347261,337065,10196
01/07/2017,Virginia,6601547,4345164,4186663,158501
01/07/2017,Washington,5850357,3733560,3561691,171869
01/07/2017,Wisconsin,4590052,3130392,3027959,102433
01/07/2017,Wyoming,448383,295849,283529,12320
01/08/2017,Alabama,3836284,2173420,2080982,92438
01/08/2017,Alaska,547544,360967,337476,23491
01/08/2017,Arizona,5503164,3338499,3177252,161247
01/08/2017,Arkansas,2325716,1354029,1303256,50773
01/08/2017,California,30819479,19207201,18295260,911941
01/08/2017,Colorado,4407473,3000310,2919729,80581
01/08/2017,Connecticut,2879206,1900892,1817915,82977
01/08/2017,Delaware,763394,477559,456485,21074
01/08/2017,Florida,16972737,10047193,9630155,417038
01/08/2017,Georgia,8008915,5123228,4885270,237958
01/08/2017,Hawaii,1094423,678281,664462,13819
01/08/2017,Idaho,1309260,837672,811937,25735
01/08/2017,Illinois,10039057,6487193,6165765,321428
01/08/2017,Indiana,5180760,3332632,3216545,116087
01/08/2017,Iowa,2453951,1687256,1635852,51404
01/08/2017,Kansas,2217666,1485446,1431965,53481
01/08/2017,Kentucky,3478094,2052817,1956097,96720
01/08/2017,Louisiana,3585268,2109984,2006905,103079
01/08/2017,Maine,1100450,700393,676405,23988
01/08/2017,Maryland,4738850,3212288,3081991,130297
01/08/2017,Massachusetts,5589635,3690538,3549475,141063
01/08/2017,Michigan,7957470,4897535,4671469,226066
01/08/2017,Minnesota,4361737,3056876,2954054,102822
01/08/2017,Mississippi,2290790,1273694,1208366,65328
01/08/2017,Missouri,4779763,3059314,2947410,111904
01/08/2017,Montana,835644,526441,504835,21606
01/08/2017,Nebraska,1463343,1018474,988890,29584
01/08/2017,Nevada,2332350,1460204,1388027,72177
01/08/2017,Ohio,9197134,5810790,5522691,288099
01/08/2017,Oklahoma,3001447,1837411,1764665,72746
01/08/2017,Oregon,3339709,2092306,2006395,85911
01/08/2017,Pennsylvania,10251862,6417593,6100495,317098
01/08/2017,Tennessee,5279315,3196140,3086679,109461
01/08/2017,Texas,21298416,13593327,13027129,566198
01/08/2017,Utah,2254998,1551755,1503031,48724
01/08/2017,Vermont,516820,347209,337067,10142
01/08/2017,Virginia,6605682,4347497,4191060,156437
01/08/2017,Washington,5858523,3739479,3565829,173650
01/08/2017,Wisconsin,4592196,3130281,3027790,102491
01/08/2017,Wyoming,448464,295767,283306,12461
01/09/2017,Alabama,3838035,2174284,2083955,90329
01/09/2017,Alaska,547502,360456,337018,23438
01/09/2017,Arizona,5513490,3343281,3181931,161350
01/09/2017,Arkansas,2326910,1353191,1302198,50993
01/09/2017,California,30836381,19205489,18305583,899906
01/09/2017,Colorado,4414637,3007904,2925084,82820
01/09/2017,Connecticut,2880192,1897481,1815026,82455
01/09/2017,Delaware,764246,478093,457096,20997
01/09/2017,Florida,16996993,10049386,9634812,414574
01/09/2017,Georgia,8017782,5126244,4891272,234972
01/09/2017,Hawaii,1094481,676852,663397,13455
01/09/2017,Idaho,1311939,839874,814038,25836
01/09/2017,Illinois,10038262,6486526,6167822,318704
01/09/2017,Indiana,5184267,3332796,3217165,115631
01/09/2017,Iowa,2454856,1685957,1635376,50581
01/09/2017,Kansas,2218423,1484004,1431031,52973
01/09/2017,Kentucky,3479282,2051538,1957165,94373
01/09/2017,Louisiana,3585673,2110547,2009169,101378
01/09/2017,Maine,1101052,699765,676114,23651
01/09/2017,Maryland,4740827,3212242,3081233,131009
01/09/2017,Massachusetts,5592879,3694046,3553339,140707
01/09/2017,Michigan,7960565,4900650,4670169,230481
01/09/2017,Minnesota,4365287,3056493,2955002,101491
01/09/2017,Mississippi,2290654,1272142,1207988,64154
01/09/2017,Missouri,4781508,3057184,2946127,111057
01/09/2017,Montana,836473,526314,504715,21599
01/09/2017,Nebraska,1464244,1018517,988939,29578
01/09/2017,Nevada,2337073,1463974,1392071,71903
01/09/2017,Ohio,9200536,5807977,5523756,284221
01/09/2017,Oklahoma,3002702,1838590,1766356,72234
01/09/2017,Oregon,3343356,2091858,2005446,86412
01/09/2017,Pennsylvania,10255068,6413273,6095963,317310
01/09/2017,Tennessee,5284708,3200884,3091335,109549
01/09/2017,Texas,21327298,13607109,13046231,560878
01/09/2017,Utah,2259385,1553597,1505038,48559
01/09/2017,Vermont,516929,347119,336971,10148
01/09/2017,Virginia,6609542,4347495,4193599,153896
01/09/2017,Washington,5866671,3743944,3569329,174615
01/09/2017,Wisconsin,4594649,3128052,3026722,101330
01/09/2017,Wyoming,448572,295569,282993,12576
01/10/2017,Alabama,3839599,2175287,2086645,88642
01/10/2017,Alaska,547573,359848,336528,23320
01/10/2017,Arizona,5523611,3348460,3186515,161945
01/10/2017,Arkansas,2327969,1351778,1300709,51069
01/10/2017,California,30852515,19197839,18311750,886089
01/10/2017,Colorado,4421760,3014208,2929814,84394
01/10/2017,Connecticut,2881056,1894614,1812716,81898
01/10/2017,Delaware,765073,478334,457505,20829
01/10/2017,Florida,17020550,10055130,9643784,411346
01/10/2017,Georgia,8026805,5126458,4894551,231907
01/10/2017,Hawaii,1094821,675743,662435,13308
01/10/2017,Idaho,1314549,841736,815904,25832
01/10/2017,Illinois,10037181,6484232,6169848,314384
01/10/2017,Indiana,5187398,3332592,3218745,113847
01/10/2017,Iowa,2455642,1684906,1635230,49676
01/10/2017,Kansas,2219134,1482030,1429661,52369
01/10/2017,Kentucky,3480379,2049805,1957957,91848
01/10/2017,Louisiana,3585905,2110276,2010339,99937
01/10/2017,Maine,1101594,698877,675770,23107
01/10/2017,Maryland,4742681,3210692,3079083,131609
01/10/2017,Massachusetts,5595748,3697825,3557753,140072
01/10/2017,Michigan,7963143,4900628,4668899,231729
01/10/2017,Minnesota,4368498,3055419,2955517,99902
01/10/2017,Mississippi,2290413,1270674,1207493,63181
01/10/2017,Missouri,4783136,3054135,2944066,110069
01/10/2017,Montana,837239,526175,504652,21523
01/10/2017,Nebraska,1465130,1018455,988846,29609
01/10/2017,Nevada,2341692,1467530,1395936,71594
01/10/2017,Ohio,9203275,5800315,5522183,278132
01/10/2017,Oklahoma,3003945,1839031,1767593,71438
01/10/2017,Oregon,3346759,2090739,2004265,86474
01/10/2017,Pennsylvania,10257611,6409099,6092440,316659
01/10/2017,Tennessee,5289889,3204138,3094084,110054
01/10/2017,Texas,21355857,13623107,13065751,557356
01/10/2017,Utah,2263655,1555070,1506746,48324
01/10/2017,Vermont,517040,347009,336825,10184
01/10/2017,Virginia,6613781,4345973,4195160,150813
01/10/2017,Washington,5874858,3748170,3573613,174557
01/10/2017,Wisconsin,4596797,3124552,3025510,99042
01/10/2017,Wyoming,448675,295266,282642,12624
01/11/2017,Alabama,3840846,2176815,2089251,87564
01/11/2017,Alaska,547493,359183,336030,23153
01/11/2017,Arizona,5533249,3354747,3191841,162906
01/11/2017,Arkansas,2328862,1350238,1299105,51133
01/11/2017,California,30866794,19188228,18315925,872303
01/11/2017,Colorado,4428527,3019710,2934083,85627
01/11/2017,Connecticut,2881667,1892550,1811201,81349
01/11/2017,Delaware,765819,478380,457801,20579
01/11/2017,Florida,17042366,10065132,9657617,407515
01/11/2017,Georgia,8035420,5124644,4895693,228951
01/11/2017,Hawaii,1094907,675091,661704,13387
01/11/2017,Idaho,1317091,843277,817568,25709
01/11/2017,Illinois,10035540,6480972,6172168,308804
01/11/2017,Indiana,5190316,3333287,3221704,111583
01/11/2017,Iowa,2456255,1684439,1635605,48834
01/11/2017,Kansas,2219649,1480090,1428313,51777
01/11/2017,Kentucky,3481197,2048118,1958520,89598
01/11/2017,Louisiana,3585883,2109668,2010670,98998
01/11/2017,Maine,1102055,697884,675446,22438
01/11/2017,Maryland,4744069,3208246,3076318,131928
01/11/2017,Massachusetts,5598288,3702569,3563231,139338
01/11/2017,Michigan,7965234,4899063,4668803,230260
01/11/2017,Minnesota,4371458,3053958,2955548,98410
01/11/2017,Mississippi,2289988,1269533,1206957,62576
01/11/2017,Missouri,4784494,3050948,2942075,108873
01/11/2017,Montana,837939,526100,504706,21394
01/11/2017,Nebraska,1465866,1018576,988849,29727
01/11/2017,Nevada,2346147,1471033,1399784,71249
01/11/2017,Ohio,9205445,5789953,5518469,271484
01/11/2017,Oklahoma,3005018,1839077,1768585,70492
01/11/2017,Oregon,3349993,2089217,2003003,86214
01/11/2017,Pennsylvania,10259423,6404762,6090015,314747
01/11/2017,Tennessee,5294714,3206656,3095949,110707
01/11/2017,Texas,21383059,13642082,13086199,555883
01/11/2017,Utah,2267884,1556391,1508305,48086
01/11/2017,Vermont,517098,346902,336660,10242
01/11/2017,Virginia,6617090,4344061,4196626,147435
01/11/2017,Washington,5882465,3753036,3579389,173647
01/11/2017,Wisconsin,4598712,3120718,3024296,96422
01/11/2017,Wyoming,448765,294918,282312,12606
01/12/2017,Alabama,3842023,2179230,2092237,86993
01/12/2017,Alaska,547432,358526,335617,22909
01/12/2017,Arizona,5542691,3362580,3199046,163534
01/12/2017,Arkansas,2329671,1349031,1297910,51121
01/12/2017,California,30879995,19182534,18323965,858569
01/12/2017,Colorado,4435085,3025458,2938973,86485
01/12/2017,Connecticut,2882187,1891578,1810954,80624
01/12/2017,Delaware,766575,478425,458213,20212
01/12/2017,Florida,17063554,10078698,9676332,402366
01/12/2017,Georgia,8043726,5122032,4896327,225705
01/12/2017,Hawaii,1094964,675014,661427,13587
01/12/2017,Idaho,1319571,844659,819217,25442
01/12/2017,Illinois,10033620,6477489,6175723,301766
01/12/2017,Indiana,5193094,3336523,3226789,109734
01/12/2017,Iowa,2456773,1684895,1636887,48008
01/12/2017,Kansas,2220045,1478871,1427761,51110
01/12/2017,Kentucky,3481919,2047042,1959220,87822
01/12/2017,Louisiana,3585740,2109360,2010854,98506
01/12/2017,Maine,1102473,697064,675379,21685
01/12/2017,Maryland,4745331,3205929,3074412,131517
01/12/2017,Massachusetts,5600704,3709437,3571124,138313
01/12/2017,Michigan,7967152,4898103,4671444,226659
01/12/2017,Minnesota,4374313,3052877,2955820,97057
01/12/2017,Mississippi,2289575,1268984,1206654,62330
01/12/2017,Missouri,4785721,3048580,2941381,107199
01/12/2017,Montana,838625,526159,504981,21178
01/12/2017,Nebraska,1466539,1019080,989285,29795
01/12/2017,Nevada,2350496,1474724,1404048,70676
01/12/2017,Ohio,9207338,5779940,5514338,265602
01/12/2017,Oklahoma,3005976,1839259,1769890,69369
01/12/2017,Oregon,3353105,2087613,2001932,85681
01/12/2017,Pennsylvania,10260876,6400997,6090204,310793
01/12/2017,Tennessee,5299362,3209518,3098335,111183
01/12/2017,Texas,21409531,13665077,13109868,555209
01/12/2017,Utah,2272008,1557913,1510140,47773
01/12/2017,Vermont,517141,346882,336590,10292
01/12/2017,Virginia,6620166,4343279,4199520,143759
01/12/2017,Washington,5889827,3759169,3587252,171917
01/12/2017,Wisconsin,4600474,3117484,3023479,94005
01/12/2017,Wyoming,448829,294626,282110,12516
01/01/2018,Alabama,3842844,2182961,2096016,86945
01/01/2018,Alaska,547313,357976,335376,22600
01/01/2018,Arizona,5551621,3371802,3208269,163533
01/01/2018,Arkansas,2330250,1348493,1297465,51028
01/01/2018,California,30890810,19186939,18340530,846409
01/01/2018,Colorado,4441224,3032602,2945476,87126
01/01/2018,Connecticut,2882546,1891941,1812205,79736
01/01/2018,Delaware,767213,478737,458994,19743
01/01/2018,Florida,17083177,10094868,9698758,396110
01/01/2018,Georgia,8051351,5120617,4898384,222233
01/01/2018,Hawaii,1094930,675532,661678,13854
01/01/2018,Idaho,1321923,846096,821038,25058
01/01/2018,Illinois,10030718,6474645,6180172,294473
01/01/2018,Indiana,5195245,3343628,3234462,109166
01/01/2018,Iowa,2457002,1686760,1639603,47157
01/01/2018,Kansas,2220190,1478888,1428440,50448
01/01/2018,Kentucky,3482222,2047270,1960528,86742
01/01/2018,Louisiana,3585241,2110256,2011412,98844
01/01/2018,Maine,1102745,696715,675727,20988
01/01/2018,Maryland,4746158,3204969,3074606,130363
01/01/2018,Massachusetts,5602485,3719210,3582134,137076
01/01/2018,Michigan,7968173,4899799,4677844,221955
01/01/2018,Minnesota,4376667,3052881,2957004,95877
01/01/2018,Mississippi,2288841,1269247,1206837,62410
01/01/2018,Missouri,4786436,3047945,2942676,105269
01/01/2018,Montana,839190,526475,505573,20902
01/01/2018,Nebraska,1467060,1020119,990360,29759
01/01/2018,Nevada,2354665,1478950,1409064,69886
01/01/2018,Ohio,9208200,5773937,5512010,261927
01/01/2018,Oklahoma,3006598,1840123,1772069,68054
01/01/2018,Oregon,3355813,2086480,2001475,85005
01/01/2018,Pennsylvania,10261172,6399720,6094610,305110
01/01/2018,Tennessee,5303405,3214031,3102578,111453
01/01/2018,Texas,21434170,13693123,13138321,554802
01/01/2018,Utah,2275847,1559995,1512589,47406
01/01/2018,Vermont,517147,347008,336691,10317
01/01/2018,Virginia,6622634,4345082,4204892,140190
01/01/2018,Washington,5896573,3766857,3597102,169755
01/01/2018,Wisconsin,4601689,3115813,3023388,92425
01/01/2018,Wyoming,448752,294468,282098,12370
01/02/2018,Alabama,3843324,2188262,2100950,87312
01/02/2018,Alaska,547162,357584,335332,22252
01/02/2018,Arizona,5560108,3382193,3219201,162992
01/02/2018,Arkansas,2330637,1348774,1297946,50828
01/02/2018,California,30899826,19204510,18367883,836627
01/02/2018,Colorado,4447177,3041757,2953788,87969
01/02/2018,Connecticut,2882640,1893797,1815043,78754
01/02/2018,Delaware,767793,479452,460238,19214
01/02/2018,Florida,17100836,10112442,9722964,389478
01/02/2018,Georgia,8058536,5121972,4903215,218757
01/02/2018,Hawaii,1094855,676487,662313,14174
01/02/2018,Idaho,1324143,847823,823192,24631
01/02/2018,Illinois,10027117,6473960,6185619,288341
01/02/2018,Indiana,5197039,3354808,3244681,110127
01/02/2018,Iowa,2457017,1690160,1643877,46283
01/02/2018,Kansas,2220217,1480139,1430270,49869
01/02/2018,Kentucky,3482315,2049235,1962904,86331
01/02/2018,Louisiana,3584500,2112853,2012697,100156
01/02/2018,Maine,1102935,697051,676495,20556
01/02/2018,Maryland,4746675,3206152,3077411,128741
01/02/2018,Massachusetts,5604017,3731705,3595898,135807
01/02/2018,Michigan,7968592,4905018,4687974,217044
01/02/2018,Minnesota,4378743,3054190,2959364,94826
01/02/2018,Mississippi,2287915,1270291,1207670,62621
01/02/2018,Missouri,4786746,3049442,2945977,103465
01/02/2018,Montana,839690,527129,506506,20623
01/02/2018,Nebraska,1467492,1021728,992075,29653
01/02/2018,Nevada,2358680,1483928,1414984,68944
01/02/2018,Ohio,9208371,5773989,5513002,260987
01/02/2018,Oklahoma,3007027,1841719,1775155,66564
01/02/2018,Oregon,3358353,2086099,2001846,84253
01/02/2018,Pennsylvania,10260662,6402748,6103969,298779
01/02/2018,Tennessee,5307103,3221015,3109516,111499
01/02/2018,Texas,21457851,13726198,13171861,554337
01/02/2018,Utah,2279686,1562818,1515805,47013
01/02/2018,Vermont,517110,347283,336985,10298
01/02/2018,Virginia,6624733,4350085,4213072,137013
01/02/2018,Washington,5903000,3775904,3608234,167670
01/02/2018,Wisconsin,4602577,3116020,3023966,92054
01/02/2018,Wyoming,448751,294517,282309,12208
01/03/2018,Alabama,3844151,2194413,2106567,87846
01/03/2018,Alaska,547013,357334,335453,21881
01/03/2018,Arizona,5568852,3393031,3230988,162043
01/03/2018,Arkansas,2331244,1349706,1299277,50429
01/03/2018,California,30909161,19230515,18402166,828349
01/03/2018,Colorado,4453360,3052129,2962859,89270
01/03/2018,Connecticut,2882894,1896858,1819188,77670
01/03/2018,Delaware,768427,480397,461728,18669
01/03/2018,Florida,17119346,10129065,9746259,382806
01/03/2018,Georgia,8066189,5125263,4910072,215191
01/03/2018,Hawaii,1094601,677536,663025,14511
01/03/2018,Idaho,1326556,849801,825587,24214
01/03/2018,Illinois,10024274,6475075,6191213,283862
01/03/2018,Indiana,5199477,3368255,3256239,112016
01/03/2018,Iowa,2457371,1694429,1649080,45349
01/03/2018,Kansas,2220385,1482004,1432705,49299
01/03/2018,Kentucky,3482775,2052231,1966007,86224
01/03/2018,Louisiana,3584009,2116436,2014495,101941
01/03/2018,Maine,1103257,697913,677414,20499
01/03/2018,Maryland,4747351,3209128,3082124,127004
01/03/2018,Massachusetts,5605957,3745005,3610502,134503
01/03/2018,Michigan,7969842,4911910,4699988,211922
01/03/2018,Minnesota,4381261,3056279,2962612,93667
01/03/2018,Mississippi,2287263,1271591,1208890,62701
01/03/2018,Missouri,4787572,3051958,2950244,101714
01/03/2018,Montana,840283,528027,507660,20367
01/03/2018,Nebraska,1468056,1023608,994139,29469
01/03/2018,Nevada,2362787,1489418,1421502,67916
01/03/2018,Ohio,9209589,5778905,5516995,261910
01/03/2018,Oklahoma,3007661,1843317,1778506,64811
01/03/2018,Oregon,3361174,2086069,2002748,83321
01/03/2018,Pennsylvania,10261195,6409669,6116996,292673
01/03/2018,Tennessee,5311385,3229830,3118348,111482
01/03/2018,Texas,21481979,13760252,13207711,552541
01/03/2018,Utah,2283762,1566099,1519478,46621
01/03/2018,Vermont,517126,347602,337411,10191
01/03/2018,Virginia,6627094,4357000,4222810,134190
01/03/2018,Washington,5909842,3785391,3619556,165835
01/03/2018,Wisconsin,4603990,3117125,3024438,92687
01/03/2018,Wyoming,448769,294716,282659,12057
01/04/2018,Alabama,3845163,2199908,2111657,88251
01/04/2018,Alaska,546953,357074,335568,21506
01/04/2018,Arizona,5577991,3403018,3242081,160937
01/04/2018,Arkansas,2331994,1350582,1300793,49789
01/04/2018,California,30920923,19253408,18432929,820479
01/04/2018,Colorado,4459903,3061667,2970736,90931
01/04/2018,Connecticut,2883318,1900268,1823822,76446
01/04/2018,Delaware,769129,481109,462946,18163
01/04/2018,Florida,17138968,10142429,9766492,375937
01/04/2018,Georgia,8074439,5126921,4915738,211183
01/04/2018,Hawaii,1094559,678188,663346,14842
01/04/2018,Idaho,1329009,851659,827821,23838
01/04/2018,Illinois,10022064,6475418,6194840,280578
01/04/2018,Indiana,5202122,3380235,3266486,113749
01/04/2018,Iowa,2457850,1698163,1653820,44343
01/04/2018,Kansas,2220716,1483562,1434887,48675
01/04/2018,Kentucky,3483458,2054773,1968609,86164
01/04/2018,Louisiana,3583789,2119160,2015748,103412
01/04/2018,Maine,1103646,698806,677999,20807
01/04/2018,Maryland,4748453,3211975,3086643,125332
01/04/2018,Massachusetts,5608217,3756373,3623302,133071
01/04/2018,Michigan,7971408,4916643,4710297,206346
01/04/2018,Minnesota,4384009,3057591,2965374,92217
01/04/2018,Mississippi,2286692,1272237,1209728,62509
01/04/2018,Missouri,4788659,3053598,2953666,99932
01/04/2018,Montana,840926,528864,508721,20143
01/04/2018,Nebraska,1468702,1025187,996003,29184
01/04/2018,Nevada,2367014,1494703,1427845,66858
01/04/2018,Ohio,9211216,5784668,5521643,263025
01/04/2018,Oklahoma,3008550,1843631,1780922,62709
01/04/2018,Oregon,3364161,2085619,2003488,82131
01/04/2018,Pennsylvania,10262265,6417656,6130260,287396
01/04/2018,Tennessee,5315866,3238203,3126526,111677
01/04/2018,Texas,21507743,13787345,13239109,548236
01/04/2018,Utah,2287936,1569078,1522836,46242
01/04/2018,Vermont,517166,347794,337818,9976
01/04/2018,Virginia,6630075,4362275,4230745,131530
01/04/2018,Washington,5917125,3793493,3629330,164163
01/04/2018,Wisconsin,4605623,3117197,3023573,93624
01/04/2018,Wyoming,448778,294881,282952,11929
01/05/2018,Alabama,3846214,2204018,2115600,88418
01/05/2018,Alaska,546849,356751,335562,21189
01/05/2018,Arizona,5587102,3411942,3251635,160307
01/05/2018,Arkansas,2332706,1350984,1301886,49098
01/05/2018,California,30932127,19266305,18452187,814118
01/05/2018,Colorado,4466430,3069014,2976321,92693
01/05/2018,Connecticut,2883769,1903173,1827941,75232
01/05/2018,Delaware,769793,481368,463601,17767
01/05/2018,Florida,17159029,10152646,9783249,369397
01/05/2018,Georgia,8082472,5124874,4917827,207047
01/05/2018,Hawaii,1094494,678080,662878,15202
01/05/2018,Idaho,1331478,853206,829637,23569
01/05/2018,Illinois,10019843,6474084,6195369,278715
01/05/2018,Indiana,5204828,3388093,3273253,114840
01/05/2018,Iowa,2458351,1700602,1657136,43466
01/05/2018,Kansas,2221142,1484310,1436137,48173
01/05/2018,Kentucky,3484178,2055956,1969707,86249
01/05/2018,Louisiana,3583521,2120097,2015790,104307
01/05/2018,Maine,1104078,699368,677975,21393
01/05/2018,Maryland,4749436,3213273,3089369,123904
01/05/2018,Massachusetts,5610576,3764502,3632876,131626
01/05/2018,Michigan,7973138,4917756,4716518,201238
01/05/2018,Minnesota,4386886,3057515,2966661,90854
01/05/2018,Mississippi,2286106,1271766,1209656,62110
01/05/2018,Missouri,4789836,3053492,2955112,98380
01/05/2018,Montana,841612,529432,509458,19974
01/05/2018,Nebraska,1469394,1026190,997262,28928
01/05/2018,Nevada,2371246,1499417,1433492,65925
01/05/2018,Ohio,9212935,5788378,5524996,263382
01/05/2018,Oklahoma,3009443,1842245,1781734,60511
01/05/2018,Oregon,3367204,2084570,2003509,81061
01/05/2018,Pennsylvania,10263521,6424860,6140956,283904
01/05/2018,Tennessee,5320415,3244648,3132230,112418
01/05/2018,Texas,21533031,13804383,13261553,542830
01/05/2018,Utah,2292135,1571338,1525399,45939
01/05/2018,Vermont,517233,347768,338091,9677
01/05/2018,Virginia,6632998,4363522,4234415,129107
01/05/2018,Washington,5924416,3799729,3636666,163063
01/05/2018,Wisconsin,4607399,3115023,3020609,94414
01/05/2018,Wyoming,448836,294922,283074,11848
01/06/2018,Alabama,3847544,2207073,2118912,88161
01/06/2018,Alaska,546842,356386,335437,20949
01/06/2018,Arizona,5596687,3420589,3260103,160486
01/06/2018,Arkansas,2333693,1351120,1302603,48517
01/06/2018,California,30945958,19270242,18460417,809825
01/06/2018,Colorado,4473320,3074101,2979881,94220
01/06/2018,Connecticut,2884412,1905435,1831333,74102
01/06/2018,Delaware,770534,481274,463790,17484
01/06/2018,Florida,17180446,10160799,9797419,363380
01/06/2018,Georgia,8091122,5120023,4916843,203180
01/06/2018,Hawaii,1094527,677250,661656,15594
01/06/2018,Idaho,1334068,854488,831059,23429
01/06/2018,Illinois,10018412,6471829,6193825,278004
01/06/2018,Indiana,5207986,3391359,3276087,115272
01/06/2018,Iowa,2459105,1701899,1659049,42850
01/06/2018,Kansas,2221740,1484247,1436387,47860
01/06/2018,Kentucky,3485194,2055805,1969481,86324
01/06/2018,Louisiana,3583497,2119425,2014944,104481
01/06/2018,Maine,1104553,699517,677472,22045
01/06/2018,Maryland,4750835,3213197,3090654,122543
01/06/2018,Massachusetts,5613358,3769575,3639452,130123
01/06/2018,Michigan,7975494,4916598,4718713,197885
01/06/2018,Minnesota,4390089,3056725,2966924,89801
01/06/2018,Mississippi,2285729,1270400,1208844,61556
01/06/2018,Missouri,4791444,3051919,2954854,97065
01/06/2018,Montana,842349,529731,509881,19850
01/06/2018,Nebraska,1470220,1026709,997935,28774
01/06/2018,Nevada,2375683,1503645,1438463,65182
01/06/2018,Ohio,9215446,5789189,5526823,262366
01/06/2018,Oklahoma,3010581,1839765,1781269,58496
01/06/2018,Oregon,3370550,2083578,2003041,80537
01/06/2018,Pennsylvania,10265616,6430815,6148676,282139
01/06/2018,Tennessee,5325367,3249692,3136100,113592
01/06/2018,Texas,21560149,13813952,13276750,537202
01/06/2018,Utah,2296468,1573018,1527284,45734
01/06/2018,Vermont,517318,347508,338197,9311
01/06/2018,Virginia,6636443,4361696,4234693,127003
01/06/2018,Washington,5932181,3805332,3642504,162828
01/06/2018,Wisconsin,4609561,3110709,3015956,94753
01/06/2018,Wyoming,448910,294888,283058,11830
01/07/2018,Alabama,3848927,2209486,2122081,87405
01/07/2018,Alaska,546800,355997,335238,20759
01/07/2018,Arizona,5606364,3429631,3268114,161517
01/07/2018,Arkansas,2334646,1351324,1303180,48144
01/07/2018,California,30959830,19268853,18461524,807329
01/07/2018,Colorado,4480233,3077524,2982172,95352
01/07/2018,Connecticut,2885151,1907281,1834216,73065
01/07/2018,Delaware,771294,481027,463754,17273
01/07/2018,Florida,17202053,10168495,9810226,358269
01/07/2018,Georgia,8099961,5114194,4914255,199939
01/07/2018,Hawaii,1094542,675970,659970,16000
01/07/2018,Idaho,1336679,855618,832227,23391
01/07/2018,Illinois,10017132,6469057,6191198,277859
01/07/2018,Indiana,5211178,3390366,3275234,115132
01/07/2018,Iowa,2459864,1702498,1659981,42517
01/07/2018,Kansas,2222318,1483713,1435984,47729
01/07/2018,Kentucky,3486211,2054538,1968263,86275
01/07/2018,Louisiana,3583576,2117389,2013613,103776
01/07/2018,Maine,1105094,699250,676703,22547
01/07/2018,Maryland,4752274,3212560,3091527,121033
01/07/2018,Massachusetts,5616196,3772277,3643761,128516
01/07/2018,Michigan,7977918,4914886,4718428,196458
01/07/2018,Minnesota,4393361,3056034,2966981,89053
01/07/2018,Mississippi,2285366,1268712,1207617,61095
01/07/2018,Missouri,4793072,3049568,2953691,95877
01/07/2018,Montana,843114,529899,510161,19738
01/07/2018,Nebraska,1471009,1027013,998342,28671
01/07/2018,Nevada,2380077,1507577,1442964,64613
01/07/2018,Ohio,9218047,5788201,5527800,260401
01/07/2018,Oklahoma,3011765,1836927,1780107,56820
01/07/2018,Oregon,3373930,2083007,2002204,80803
01/07/2018,Pennsylvania,10267863,6435383,6154147,281236
01/07/2018,Tennessee,5330423,3253735,3139083,114652
01/07/2018,Texas,21587399,13820010,13288411,531599
01/07/2018,Utah,2300883,1574389,1528807,45582
01/07/2018,Vermont,517426,347042,338124,8918
01/07/2018,Virginia,6639962,4358677,4233607,125070
01/07/2018,Washington,5940044,3811529,3648109,163420
01/07/2018,Wisconsin,4611747,3105219,3010677,94542
01/07/2018,Wyoming,448998,294834,282972,11862
01/08/2018,Alabama,3850814,2212016,2125526,86490
01/08/2018,Alaska,546781,355617,334975,20642
01/08/2018,Arizona,5617446,3440243,3276561,163682
01/08/2018,Arkansas,2335827,1352139,1303997,48142
01/08/2018,California,30970329,19270079,18461462,808617
01/08/2018,Colorado,4486530,3080565,2984346,96219
01/08/2018,Connecticut,2885383,1909124,1836818,72306
01/08/2018,Delaware,772185,480933,463791,17142
01/08/2018,Florida,17223189,10178508,9823085,355423
01/08/2018,Georgia,8109883,5110058,4911908,198150
01/08/2018,Hawaii,1094296,674563,658106,16457
01/08/2018,Idaho,1339682,856913,833422,23491
01/08/2018,Illinois,10016480,6467671,6188958,278713
01/08/2018,Indiana,5214498,3387434,3272499,114935
01/08/2018,Iowa,2461141,1703333,1660747,42586
01/08/2018,Kansas,2223002,1483428,1435542,47886
01/08/2018,Kentucky,3487490,2053047,1966805,86242
01/08/2018,Louisiana,3584025,2114941,2012209,102732
01/08/2018,Maine,1105765,698811,675981,22830
01/08/2018,Maryland,4753977,3213051,3093337,119714
01/08/2018,Massachusetts,5618480,3774325,3647139,127186
01/08/2018,Michigan,7979891,4915118,4718222,196896
01/08/2018,Minnesota,4396490,3056843,2967632,89211
01/08/2018,Mississippi,2285791,1267636,1206365,61271
01/08/2018,Missouri,4795418,3047803,2952775,95028
01/08/2018,Montana,843928,530192,510521,19671
01/08/2018,Nebraska,1471841,1027610,998876,28734
01/08/2018,Nevada,2384929,1511751,1447388,64363
01/08/2018,Ohio,9221239,5789478,5530446,259032
01/08/2018,Oklahoma,3013749,1834604,1778785,55819
01/08/2018,Oregon,3377359,2083770,2001773,81997
01/08/2018,Pennsylvania,10269662,6439999,6159078,280921
01/08/2018,Tennessee,5335262,3258019,3142661,115358
01/08/2018,Texas,21619194,13828877,13300862,528015
01/08/2018,Utah,2305312,1575998,1530465,45533
01/08/2018,Vermont,517535,346511,337949,8562
01/08/2018,Virginia,6644538,4357084,4233403,123681
01/08/2018,Washington,5947638,3819548,3654812,164736
01/08/2018,Wisconsin,4614177,3100243,3006087,94156
01/08/2018,Wyoming,449256,294837,282913,11924
01/09/2018,Alabama,3852862,2215093,2129494,85599
01/09/2018,Alaska,546810,355262,334648,20614
01/09/2018,Arizona,5628819,3452490,3285694,166796
01/09/2018,Arkansas,2337119,1353808,1305242,48566
01/09/2018,California,30982488,19278256,18464140,814116
01/09/2018,Colorado,4493046,3084266,2987503,96763
01/09/2018,Connecticut,2885801,1911006,1839115,71891
01/09/2018,Delaware,773154,481160,464075,17085
01/09/2018,Florida,17245228,10191438,9836152,355286
01/09/2018,Georgia,8120220,5108726,4910760,197966
01/09/2018,Hawaii,1094105,673225,656251,16974
01/09/2018,Idaho,1342766,858575,834807,23768
01/09/2018,Illinois,10016318,6468643,6187856,280787
01/09/2018,Indiana,5218075,3384907,3269816,115091
01/09/2018,Iowa,2462548,1704965,1662001,42964
01/09/2018,Kansas,2223814,1483781,1435489,48292
01/09/2018,Kentucky,3488910,2052059,1965835,86224
01/09/2018,Louisiana,3584643,2113166,2011109,102057
01/09/2018,Maine,1106507,698422,675550,22872
01/09/2018,Maryland,4755987,3215658,3096714,118944
01/09/2018,Massachusetts,5621085,3776708,3650408,126300
01/09/2018,Michigan,7982196,4918359,4719671,198688
01/09/2018,Minnesota,4399843,3059533,2968877,90656
01/09/2018,Mississippi,2286353,1267533,1205274,62259
01/09/2018,Missouri,4797969,3047698,2952946,94752
01/09/2018,Montana,844790,530703,511062,19641
01/09/2018,Nebraska,1472783,1028717,999678,29039
01/09/2018,Nevada,2389933,1516485,1452009,64476
01/09/2018,Ohio,9224861,5795216,5535911,259305
01/09/2018,Oklahoma,3015886,1833310,1777570,55740
01/09/2018,Oregon,3380908,2086354,2002439,83915
01/09/2018,Pennsylvania,10271919,6445572,6164598,280974
01/09/2018,Tennessee,5340338,3263749,3148219,115530
01/09/2018,Texas,21652158,13843885,13316200,527685
01/09/2018,Utah,2309837,1578152,1532590,45562
01/09/2018,Vermont,517681,346038,337762,8276
01/09/2018,Virginia,6649427,4358761,4235458,123303
01/09/2018,Washington,5955494,3829378,3662492,166886
01/09/2018,Wisconsin,4616745,3096571,3002676,93895
01/09/2018,Wyoming,449533,294898,282959,11939
01/10/2018,Alabama,3854756,2218770,2134057,84713
01/10/2018,Alaska,546788,354987,334327,20660
01/10/2018,Arizona,5639899,3465247,3294961,170286
01/10/2018,Arkansas,2338313,1356111,1306904,49207
01/10/2018,California,30992869,19293358,18471026,822332
01/10/2018,Colorado,4499357,3088998,2992253,96745
01/10/2018,Connecticut,2886031,1912705,1840959,71746
01/10/2018,Delaware,774073,481767,464695,17072
01/10/2018,Florida,17266363,10205938,9848907,357031
01/10/2018,Georgia,8130168,5109997,4911177,198820
01/10/2018,Hawaii,1093829,672060,654568,17492
01/10/2018,Idaho,1345769,860610,836399,24211
01/10/2018,Illinois,10015684,6471017,6187236,283781
01/10/2018,Indiana,5221428,3384050,3268290,115760
01/10/2018,Iowa,2463857,1707672,1664072,43600
01/10/2018,Kansas,2224508,1484784,1435982,48802
01/10/2018,Kentucky,3490193,2051989,1965753,86236
01/10/2018,Louisiana,3585062,2112204,2010424,101780
01/10/2018,Maine,1107211,698151,675484,22667
01/10/2018,Maryland,4757696,3220485,3101703,118782
01/10/2018,Massachusetts,5623415,3779466,3653764,125702
01/10/2018,Michigan,7984164,4924179,4722933,201246
01/10/2018,Minnesota,4402999,3063412,2970270,93142
01/10/2018,Mississippi,2286775,1268334,1204462,63872
01/10/2018,Missouri,4800342,3049782,2954580,95202
01/10/2018,Montana,845583,531356,511722,19634
01/10/2018,Nebraska,1473613,1030316,1000760,29556
01/10/2018,Nevada,2394798,1521728,1456914,64814
01/10/2018,Ohio,9228042,5804046,5543346,260700
01/10/2018,Oklahoma,3017853,1833190,1776737,56453
01/10/2018,Oregon,3384353,2090454,2004408,86046
01/10/2018,Pennsylvania,10273714,6452492,6171169,281323
01/10/2018,Tennessee,5345197,3271345,3156200,115145
01/10/2018,Texas,21683967,13864768,13335259,529509
01/10/2018,Utah,2314283,1580850,1535286,45564
01/10/2018,Vermont,517774,345660,337597,8063
01/10/2018,Virginia,6654002,4364231,4240248,123983
01/10/2018,Washington,5963059,3840188,3670355,169833
01/10/2018,Wisconsin,4619204,3094379,3000471,93908
01/10/2018,Wyoming,449778,294995,283131,11864
01/11/2018,Alabama,3856154,2222802,2139030,83772
01/11/2018,Alaska,546733,354791,334087,20704
01/11/2018,Arizona,5650376,3477513,3304082,173431
01/11/2018,Arkansas,2339226,1358656,1308923,49733
01/11/2018,California,31000966,19311991,18481262,830729
01/11/2018,Colorado,4505271,3094552,2998449,96103
01/11/2018,Connecticut,2885954,1914128,1842422,71706
01/11/2018,Delaware,774895,482709,465633,17076
01/11/2018,Florida,17285441,10220222,9861136,359086
01/11/2018,Georgia,8139345,5113084,4913287,199797
01/11/2018,Hawaii,1093583,671088,653151,17937
01/11/2018,Idaho,1348642,862994,838269,24725
01/11/2018,Illinois,10013950,6474852,6187073,287779
01/11/2018,Indiana,5224176,3385579,3268810,116769
01/11/2018,Iowa,2464858,1711649,1667225,44424
01/11/2018,Kansas,2224934,1486153,1436908,49245
01/11/2018,Kentucky,3491101,2052885,1966565,86320
01/11/2018,Louisiana,3585137,2111546,2010065,101481
01/11/2018,Maine,1107768,697896,675669,22227
01/11/2018,Maryland,4758978,3227063,3107999,119064
01/11/2018,Massachusetts,5625242,3782165,3657030,125135
01/11/2018,Michigan,7985290,4931644,4727384,204260
01/11/2018,Minnesota,4405705,3067728,2971706,96022
01/11/2018,Mississippi,2286954,1269864,1203942,65922
01/11/2018,Missouri,4802145,3053543,2957393,96150
01/11/2018,Montana,846300,532085,512437,19648
01/11/2018,Nebraska,1474305,1032250,1002062,30188
01/11/2018,Nevada,2399462,1527304,1462170,65134
01/11/2018,Ohio,9230154,5813355,5552197,261158
01/11/2018,Oklahoma,3019516,1834179,1776669,57510
01/11/2018,Oregon,3387402,2095533,2007705,87828
01/11/2018,Pennsylvania,10274249,6460337,6178551,281786
01/11/2018,Tennessee,5349521,3280821,3166444,114377
01/11/2018,Texas,21713757,13888671,13357878,530793
01/11/2018,Utah,2318480,1584026,1538597,45429
01/11/2018,Vermont,517846,345389,337476,7913
01/11/2018,Virginia,6657983,4372860,4247614,125246
01/11/2018,Washington,5970124,3851215,3678279,172936
01/11/2018,Wisconsin,4621113,3093703,2999369,94334
01/11/2018,Wyoming,449941,295102,283416,11686
01/12/2018,Alabama,3857442,2226751,2144197,82554
01/12/2018,Alaska,546663,354566,333931,20635
01/12/2018,Arizona,5660505,3488395,3312873,175522
01/12/2018,Arkansas,2340021,1360949,1311102,49847
01/12/2018,California,31007415,19327664,18492465,835199
01/12/2018,Colorado,4510886,3099887,3005135,94752
01/12/2018,Connecticut,2885775,1915020,1843489,71531
01/12/2018,Delaware,775662,483777,466721,17056
01/12/2018,Florida,17303538,10232330,9872842,359488
01/12/2018,Georgia,8148150,5116798,4916885,199913
01/12/2018,Hawaii,1093269,670180,651974,18206
01/12/2018,Idaho,1351412,865525,840393,25132
01/12/2018,Illinois,10011743,6479035,6187431,291604
01/12/2018,Indiana,5226671,3388040,3270676,117364
01/12/2018,Iowa,2465707,1716455,1671199,45256
01/12/2018,Kansas,2225238,1487403,1437993,49410
01/12/2018,Kentucky,3491863,2054479,1968189,86290
01/12/2018,Louisiana,3585010,2110632,2009979,100653
01/12/2018,Maine,1108245,697440,675886,21554
01/12/2018,Maryland,4760033,3234226,3114968,119258
01/12/2018,Massachusetts,5626729,3784000,3659729,124271
01/12/2018,Michigan,7986018,4938752,4731861,206891
01/12/2018,Minnesota,4408141,3071438,2973113,98325
01/12/2018,Mississippi,2287035,1271512,1203781,67731
01/12/2018,Missouri,4803671,3057685,2960620,97065
01/12/2018,Montana,846955,532808,513165,19643
01/12/2018,Nebraska,1474901,1034171,1003405,30766
01/12/2018,Nevada,2403986,1532865,1467684,65181
01/12/2018,Ohio,9231796,5820069,5561420,258649
01/12/2018,Oklahoma,3020959,1835859,1777527,58332
01/12/2018,Oregon,3390287,2100526,2011924,88602
01/12/2018,Pennsylvania,10274249,6467194,6185428,281766
01/12/2018,Tennessee,5353537,3291684,3178225,113459
01/12/2018,Texas,21742357,13910127,13382106,528021
01/12/2018,Utah,2322551,1587436,1542359,45077
01/12/2018,Vermont,517887,345196,337387,7809
01/12/2018,Virginia,6661589,4383123,4256692,126431
01/12/2018,Washington,5976850,3861335,3686272,175063
01/12/2018,Wisconsin,4622766,3093618,2998620,94998
01/12/2018,Wyoming,450154,295151,283759,11392
01/01/2019,Alabama,3858512,2229899,2149188,80711
01/01/2019,Alaska,546579,354226,333822,20404
01/01/2019,Arizona,5670393,3497563,3321318,176245
01/01/2019,Arkansas,2340710,1362495,1313091,49404
01/01/2019,California,31012788,19334306,18501317,832989
01/01/2019,Colorado,4516317,3104049,3011353,92696
01/01/2019,Connecticut,2885407,1915116,1844065,71051
01/01/2019,Delaware,776420,484604,467642,16962
01/01/2019,Florida,17320950,10240878,9884007,356871
01/01/2019,Georgia,8156579,5119814,4921294,198520
01/01/2019,Hawaii,1092891,669216,650983,18233
01/01/2019,Idaho,1354143,867880,842597,25283
01/01/2019,Illinois,10009039,6481193,6188462,292731
01/01/2019,Indiana,5228912,3389065,3272106,116959
01/01/2019,Iowa,2466434,1720862,1674943,45919
01/01/2019,Kansas,2225406,1488175,1439031,49144
01/01/2019,Kentucky,3492386,2056192,1970166,86026
01/01/2019,Louisiana,3584760,2109231,2010280,98951
01/01/2019,Maine,1108679,696627,675932,20695
01/01/2019,Maryland,4760866,3240729,3121909,118820
01/01/2019,Massachusetts,5627960,3784356,3661520,122836
01/01/2019,Michigan,7986297,4943420,4735037,208383
01/01/2019,Minnesota,4410297,3073895,2974372,99523
01/01/2019,Mississippi,2287007,1272778,1203954,68824
01/01/2019,Missouri,4804992,3061111,2963576,97535
01/01/2019,Montana,847596,533342,513765,19577
01/01/2019,Nebraska,1475406,1035771,1004580,31191
01/01/2019,Nevada,2408437,1538037,1473244,64793
01/01/2019,Ohio,9232906,5821680,5569078,252602
01/01/2019,Oklahoma,3022283,1837515,1778982,58533
01/01/2019,Oregon,3392962,2104052,2016017,88035
01/01/2019,Pennsylvania,10273786,6471515,6190529,280986
01/01/2019,Tennessee,5357263,3302421,3189960,112461
01/01/2019,Texas,21770174,13925005,13405426,519579
01/01/2019,Utah,2326530,1590728,1546260,44468
01/01/2019,Vermont,517878,345044,337315,7729
01/01/2019,Virginia,6664897,4392956,4266093,126863
01/01/2019,Washington,5983264,3869370,3694099,175271
01/01/2019,Wisconsin,4624157,3093213,2997422,95791
01/01/2019,Wyoming,450258,295087,284091,10996
01/02/2019,Alabama,3859089,2231539,2153542,77997
01/02/2019,Alaska,546404,353848,333818,20030
01/02/2019,Arizona,5679559,3505030,3329490,175540
01/02/2019,Arkansas,2341109,1363048,1314551,48497
01/02/2019,California,31014817,19329357,18505844,823513
01/02/2019,Colorado,4521344,3106730,3016857,89873
01/02/2019,Connecticut,2884720,1914273,1844132,70141
01/02/2019,Delaware,777040,485013,468253,16760
01/02/2019,Florida,17335625,10246115,9895249,350866
01/02/2019,Georgia,8164162,5121124,4925912,195212
01/02/2019,Hawaii,1092373,668172,650161,18011
01/02/2019,Idaho,1356695,869873,844753,25120
01/02/2019,Illinois,10005294,6479413,6189942,289471
01/02/2019,Indiana,5230605,3387179,3271793,115386
01/02/2019,Iowa,2466914,1724077,1677806,46271
01/02/2019,Kansas,2225385,1488377,1439945,48432
01/02/2019,Kentucky,3492597,2057471,1971899,85572
01/02/2019,Louisiana,3584066,2107156,2010838,96318
01/02/2019,Maine,1108981,695458,675738,19720
01/02/2019,Maryland,4761146,3245796,3128338,117458
01/02/2019,Massachusetts,5628669,3783198,3662566,120632
01/02/2019,Michigan,7985730,4945098,4736749,208349
01/02/2019,Minnesota,4412091,3075308,2975818,99490
01/02/2019,Mississippi,2286684,1273521,1204365,69156
01/02/2019,Missouri,4805762,3063239,2965866,97373
01/02/2019,Montana,848103,533591,514177,19414
01/02/2019,Nebraska,1475799,1036833,1005468,31365
01/02/2019,Nevada,2412610,1542686,1478727,63959
01/02/2019,Ohio,9233071,5818965,5574672,244293
01/02/2019,Oklahoma,3023300,1838736,1780731,58005
01/02/2019,Oregon,3395298,2105435,2019199,86236
01/02/2019,Pennsylvania,10272066,6472348,6193118,279230
01/02/2019,Tennessee,5360432,3311358,3200006,111352
01/02/2019,Texas,21795969,13933148,13426644,506504
01/02/2019,Utah,2330395,1593690,1550084,43606
01/02/2019,Vermont,517850,344853,337215,7638
01/02/2019,Virginia,6667480,4400891,4274830,126061
01/02/2019,Washington,5989125,3875239,3702019,173220
01/02/2019,Wisconsin,4625075,3092376,2995774,96602
01/02/2019,Wyoming,450382,294948,284366,10582
01/03/2019,Alabama,3860039,2231949,2157197,74752
01/03/2019,Alaska,546284,353549,333909,19640
01/03/2019,Arizona,5689006,3511703,3337412,174291
01/03/2019,Arkansas,2341740,1362776,1315205,47571
01/03/2019,California,31017497,19317936,18507077,810859
01/03/2019,Colorado,4526747,3108718,3022045,86673
01/03/2019,Connecticut,2884267,1913006,1843951,69055
01/03/2019,Delaware,777740,485202,468646,16556
01/03/2019,Florida,17351326,10251856,9908175,343681
01/03/2019,Georgia,8172347,5121857,4930893,190964
01/03/2019,Hawaii,1091842,667192,649533,17659
01/03/2019,Idaho,1359388,871655,846865,24790
01/03/2019,Illinois,10002260,6474417,6192065,282352
01/03/2019,Indiana,5232865,3382749,3269690,113059
01/03/2019,Iowa,2467642,1726422,1679946,46476
01/03/2019,Kansas,2225581,1488364,1440776,47588
01/03/2019,Kentucky,3493161,2058799,1973474,85325
01/03/2019,Louisiana,3583666,2105146,2011546,93600
01/03/2019,Maine,1109377,694264,675443,18821
01/03/2019,Maryland,4761718,3249927,3134185,115742
01/03/2019,Massachusetts,5629802,3781651,3663545,118106
01/03/2019,Michigan,7985849,4945693,4737913,207780
01/03/2019,Minnesota,4414293,3076838,2978103,98735
01/03/2019,Mississippi,2286551,1274119,1204988,69131
01/03/2019,Missouri,4807015,3064481,2967585,96896
01/03/2019,Montana,848735,533751,514527,19224
01/03/2019,Nebraska,1476308,1037455,1006093,31362
01/03/2019,Nevada,2416855,1547115,1484140,62975
01/03/2019,Ohio,9234157,5816150,5579091,237059
01/03/2019,Oklahoma,3024561,1839713,1782614,57099
01/03/2019,Oregon,3397908,2105348,2021425,83923
01/03/2019,Pennsylvania,10271309,6471650,6193849,277801
01/03/2019,Tennessee,5364123,3318354,3207976,110378
01/03/2019,Texas,21822493,13939862,13446764,493098
01/03/2019,Utah,2334391,1596458,1553781,42677
01/03/2019,Vermont,517867,344585,337039,7546
01/03/2019,Virginia,6670614,4406888,4282641,124247
01/03/2019,Washington,5995444,3880632,3710734,169898
01/03/2019,Wisconsin,4626472,3091788,2994026,97762
01/03/2019,Wyoming,450554,294879,284585,10294
01/04/2019,Alabama,3861170,2231885,2160522,71363
01/04/2019,Alaska,546243,353455,334118,19337
01/04/2019,Arizona,5698836,3518531,3345552,172979
01/04/2019,Arkansas,2342453,1362147,1315218,46929
01/04/2019,California,31022564,19307869,18509723,798146
01/04/2019,Colorado,4532350,3111401,3027728,83673
01/04/2019,Connecticut,2883945,1912141,1844115,68026
01/04/2019,Delaware,778516,485472,469010,16462
01/04/2019,Florida,17368100,10262411,9924815,337596
01/04/2019,Georgia,8180996,5124177,4937384,186793
01/04/2019,Hawaii,1091436,666492,649218,17274
01/04/2019,Idaho,1362162,873540,849086,24454
01/04/2019,Illinois,9999793,6468028,6195174,272854
01/04/2019,Indiana,5235328,3377518,3267048,110470
01/04/2019,Iowa,2468454,1728498,1681846,46652
01/04/2019,Kansas,2225860,1488596,1441764,46832
01/04/2019,Kentucky,3493890,2060715,1975453,85262
01/04/2019,Louisiana,3583469,2104457,2012866,91591
01/04/2019,Maine,1109866,693551,675339,18212
01/04/2019,Maryland,4762584,3254220,3139974,114246
01/04/2019,Massachusetts,5631202,3780674,3664967,115707
01/04/2019,Michigan,7986340,4947165,4739875,207290
01/04/2019,Minnesota,4416696,3079545,2981872,97673
01/04/2019,Mississippi,2286578,1275117,1205974,69143
01/04/2019,Missouri,4808486,3065787,2969425,96362
01/04/2019,Montana,849362,534099,515027,19072
01/04/2019,Nebraska,1476899,1037923,1006710,31213
01/04/2019,Nevada,2421273,1551757,1489729,62028
01/04/2019,Ohio,9235661,5816663,5583268,233395
01/04/2019,Oklahoma,3025979,1840830,1784644,56186
01/04/2019,Oregon,3400710,2104724,2023005,81719
01/04/2019,Pennsylvania,10271002,6472106,6194704,277402
01/04/2019,Tennessee,5368049,3324074,3214505,109569
01/04/2019,Texas,21850614,13951498,13468880,482618
01/04/2019,Utah,2338541,1599362,1557593,41769
01/04/2019,Vermont,517854,344265,336792,7473
01/04/2019,Virginia,6674083,4411682,4289972,121710
01/04/2019,Washington,6002058,3887284,3720954,166330
01/04/2019,Wisconsin,4628057,3091979,2992614,99365
01/04/2019,Wyoming,450675,294998,284810,10188
01/05/2019,Alabama,3862424,2232174,2163952,68222
01/05/2019,Alaska,546150,353548,334381,19167
01/05/2019,Arizona,5708829,3525840,3353848,171992
01/05/2019,Arkansas,2343292,1361669,1314928,46741
01/05/2019,California,31027526,19304550,18515934,788616
01/05/2019,Colorado,4538098,3115281,3033852,81429
01/05/2019,Connecticut,2883745,1912281,1844977,67304
01/05/2019,Delaware,779251,485988,469399,16589
01/05/2019,Florida,17385414,10279930,9945628,334302
01/05/2019,Georgia,8189728,5129326,4945860,183466
01/05/2019,Hawaii,1091012,666331,649390,16941
01/05/2019,Idaho,1364985,875679,851447,24232
01/05/2019,Illinois,9997605,6460957,6197805,263152
01/05/2019,Indiana,5238060,3373177,3264961,108216
01/05/2019,Iowa,2469440,1730668,1683725,46943
01/05/2019,Kansas,2226234,1489343,1443000,46343
01/05/2019,Kentucky,3494766,2063398,1978208,85190
01/05/2019,Louisiana,3583350,2105899,2014912,90987
01/05/2019,Maine,1110412,693551,675536,18015
01/05/2019,Maryland,4763531,3259436,3146040,113396
01/05/2019,Massachusetts,5632822,3780393,3666566,113827
01/05/2019,Michigan,7987208,4949277,4742543,206734
01/05/2019,Minnesota,4419361,3083737,2987022,96715
01/05/2019,Mississippi,2286635,1276925,1207363,69562
01/05/2019,Missouri,4810200,3067922,2971711,96211
01/05/2019,Montana,850047,534802,515782,19020
01/05/2019,Nebraska,1477544,1038432,1007448,30984
01/05/2019,Nevada,2425739,1556867,1495541,61326
01/05/2019,Ohio,9237539,5821487,5587417,234070
01/05/2019,Oklahoma,3027519,1842273,1786601,55672
01/05/2019,Oregon,3403640,2104117,2024197,79920
01/05/2019,Pennsylvania,10271186,6475481,6196790,278691
01/05/2019,Tennessee,5372175,3328478,3219371,109107
01/05/2019,Texas,21878787,13971880,13494116,477764
01/05/2019,Utah,2342806,1602567,1561589,40978
01/05/2019,Vermont,517915,343936,336481,7455
01/05/2019,Virginia,6677682,4416125,4297055,119070
01/05/2019,Washington,6008920,3895753,3732380,163373
01/05/2019,Wisconsin,4629921,3092979,2991772,101207
01/05/2019,Wyoming,450891,295316,285047,10269
01/06/2019,Alabama,3863995,2233402,2167676,65726
01/06/2019,Alaska,546141,353731,334599,19132
01/06/2019,Arizona,5719237,3533838,3362138,171700
01/06/2019,Arkansas,2344321,1361790,1314740,47050
01/06/2019,California,31035051,19311393,18526089,785304
01/06/2019,Colorado,4544250,3120345,3040081,80264
01/06/2019,Connecticut,2883772,1913645,1846526,67119
01/06/2019,Delaware,780094,486815,469813,17002
01/06/2019,Florida,17404169,10304147,9970073,334074
01/06/2019,Georgia,8199141,5137205,4955924,181281
01/06/2019,Hawaii,1090709,666771,650122,16649
01/06/2019,Idaho,1367964,878119,853906,24213
01/06/2019,Illinois,9996220,6453401,6198247,255154
01/06/2019,Indiana,5241157,3371205,3264478,106727
01/06/2019,Iowa,2470620,1733102,1685595,47507
01/06/2019,Kansas,2226826,1490822,1444540,46282
01/06/2019,Kentucky,3495916,2066908,1981633,85275
01/06/2019,Louisiana,3583530,2109754,2017549,92205
01/06/2019,Maine,1111030,694253,676002,18251
01/06/2019,Maryland,4764863,3265661,3152291,113370
01/06/2019,Massachusetts,5634880,3780828,3668102,112726
01/06/2019,Michigan,7988642,4951350,4745349,206001
01/06/2019,Minnesota,4422372,3089207,2992843,96364
01/06/2019,Mississippi,2286865,1279530,1208933,70597
01/06/2019,Missouri,4812270,3071618,2974560,97058
01/06/2019,Montana,850830,535862,516760,19102
01/06/2019,Nebraska,1478351,1039213,1008354,30859
01/06/2019,Nevada,2430418,1562556,1501566,60990
01/06/2019,Ohio,9240152,5830138,5591950,238188
01/06/2019,Oklahoma,3029295,1843994,1788112,55882
01/06/2019,Oregon,3406868,2104097,2025554,78543
01/06/2019,Pennsylvania,10272181,6482360,6200143,282217
01/06/2019,Tennessee,5376724,3331228,3221931,109297
01/06/2019,Texas,21908726,14001987,13521952,480035
01/06/2019,Utah,2347248,1606145,1565787,40358
01/06/2019,Vermont,518005,343701,336152,7549
01/06/2019,Virginia,6681878,4421093,4304002,117091
01/06/2019,Washington,6016231,3905366,3743850,161516
01/06/2019,Wisconsin,4632110,3094520,2991596,102924
01/06/2019,Wyoming,451126,295794,285278,10516
01/07/2019,Alabama,3865605,2235879,2171719,64160
01/07/2019,Alaska,546124,353957,334776,19181
01/07/2019,Arizona,5729725,3542350,3370439,171911
01/07/2019,Arkansas,2345384,1362767,1315064,47703
01/07/2019,California,31042729,19328532,18540122,788410
01/07/2019,Colorado,4550388,3126269,3046294,79975
01/07/2019,Connecticut,2883814,1915887,1848378,67509
01/07/2019,Delaware,780911,487919,470296,17623
01/07/2019,Florida,17423120,10332690,9996851,335839
01/07/2019,Georgia,8208646,5146869,4966970,179899
01/07/2019,Hawaii,1090419,667702,651326,16376
01/07/2019,Idaho,1370929,880762,856393,24369
01/07/2019,Illinois,9994924,6445778,6196074,249704
01/07/2019,Indiana,5244373,3372715,3266416,106299
01/07/2019,Iowa,2471822,1735802,1687468,48334
01/07/2019,Kansas,2227416,1493014,1446400,46614
01/07/2019,Kentucky,3497135,2071101,1985516,85585
01/07/2019,Louisiana,3583771,2115698,2020553,95145
01/07/2019,Maine,1111651,695443,676713,18730
01/07/2019,Maryland,4766235,3272522,3158624,113898
01/07/2019,Massachusetts,5637007,3781940,3669520,112420
01/07/2019,Michigan,7990228,4953147,4748325,204822
01/07/2019,Minnesota,4425397,3095230,2998435,96795
01/07/2019,Mississippi,2287134,1282461,1210441,72020
01/07/2019,Missouri,4814438,3077086,2978080,99006
01/07/2019,Montana,851600,537145,517862,19283
01/07/2019,Nebraska,1479137,1040368,1009438,30930
01/07/2019,Nevada,2435079,1568679,1507794,60885
01/07/2019,Ohio,9242913,5840899,5597492,243407
01/07/2019,Oklahoma,3031109,1845998,1789265,56733
01/07/2019,Oregon,3410117,2105063,2027770,77293
01/07/2019,Pennsylvania,10273325,6492519,6204677,287842
01/07/2019,Tennessee,5381375,3333056,3222787,110269
01/07/2019,Texas,21938858,14039457,13551722,487735
01/07/2019,Utah,2351704,1610100,1570182,39918
01/07/2019,Vermont,518111,343661,335893,7768
01/07/2019,Virginia,6686119,4427256,4311089,116167
01/07/2019,Washington,6023628,3915017,3754579,160438
01/07/2019,Wisconsin,4634420,3096087,2991888,104199
01/07/2019,Wyoming,451343,296350,285492,10858
01/08/2019,Alabama,3867674,2239172,2175837,63335
01/08/2019,Alaska,546150,354167,335004,19163
01/08/2019,Arizona,5742211,3550819,3378991,171828
01/08/2019,Arkansas,2346922,1364569,1316245,48324
01/08/2019,California,31051769,19352881,18558815,794066
01/08/2019,Colorado,4556290,3132792,3052730,80062
01/08/2019,Connecticut,2884364,1918619,1850457,68162
01/08/2019,Delaware,781909,489118,470836,18282
01/08/2019,Florida,17446500,10362186,10024780,337406
01/08/2019,Georgia,8217762,5157087,4978768,178319
01/08/2019,Hawaii,1090268,669054,652992,16062
01/08/2019,Idaho,1374226,883352,858885,24467
01/08/2019,Illinois,9993687,6437758,6192198,245560
01/08/2019,Indiana,5247759,3377418,3270800,106618
01/08/2019,Iowa,2472948,1738561,1689416,49145
01/08/2019,Kansas,2228430,1495521,1448506,47015
01/08/2019,Kentucky,3498575,2075521,1989597,85924
01/08/2019,Louisiana,3584102,2122853,2023921,98932
01/08/2019,Maine,1112377,696744,677613,19131
01/08/2019,Maryland,4767772,3279210,3165105,114105
01/08/2019,Massachusetts,5639040,3783223,3670782,112441
01/08/2019,Michigan,7992084,4954309,4751549,202760
01/08/2019,Minnesota,4428165,3100765,3003367,97398
01/08/2019,Mississippi,2287500,1285009,1211834,73175
01/08/2019,Missouri,4817071,3083765,2982141,101624
01/08/2019,Montana,852602,538480,519016,19464
01/08/2019,Nebraska,1480038,1041747,1010685,31062
01/08/2019,Nevada,2439491,1574877,1514207,60670
01/08/2019,Ohio,9245841,5851393,5604276,247117
01/08/2019,Oklahoma,3033521,1848246,1790611,57635
01/08/2019,Oregon,3413384,2106623,2030826,75797
01/08/2019,Pennsylvania,10275707,6504482,6210321,294161
01/08/2019,Tennessee,5387165,3335043,3223344,111699
01/08/2019,Texas,21973020,14078792,13582783,496009
01/08/2019,Utah,2356169,1614348,1574747,39601
01/08/2019,Vermont,518273,343841,335776,8065
01/08/2019,Virginia,6690638,4434846,4319000,115846
01/08/2019,Washington,6031259,3923782,3764361,159421
01/08/2019,Wisconsin,4636987,3097266,2992435,104831
01/08/2019,Wyoming,451683,296892,285705,11187
01/09/2019,Alabama,3869937,2242568,2179776,62792
01/09/2019,Alaska,546193,354265,335381,18884
01/09/2019,Arizona,5754979,3559219,3388474,170745
01/09/2019,Arkansas,2348558,1367000,1318483,48517
01/09/2019,California,31062463,19381576,18584676,796900
01/09/2019,Colorado,4562413,3139764,3059740,80024
01/09/2019,Connecticut,2885043,1921554,1852927,68627
01/09/2019,Delaware,782978,490313,471510,18803
01/09/2019,Florida,17470770,10391422,10054571,336851
01/09/2019,Georgia,8227288,5167986,4992227,175759
01/09/2019,Hawaii,1090192,670771,655171,15600
01/09/2019,Idaho,1377619,885757,861511,24246
01/09/2019,Illinois,9992956,6429207,6188739,240468
01/09/2019,Indiana,5251359,3384123,3277361,106762
01/09/2019,Iowa,2474160,1741239,1691639,49600
01/09/2019,Kansas,2229568,1498108,1450972,47136
01/09/2019,Kentucky,3500176,2079723,1993779,85944
01/09/2019,Louisiana,3584700,2130301,2028230,102071
01/09/2019,Maine,1113156,697848,678669,19179
01/09/2019,Maryland,4769535,3285417,3172340,113077
01/09/2019,Massachusetts,5641308,3784702,3672571,112131
01/09/2019,Michigan,7994298,4954741,4755863,198878
01/09/2019,Minnesota,4431178,3105451,3008299,97152
01/09/2019,Mississippi,2287965,1286610,1213257,73353
01/09/2019,Missouri,4819891,3090723,2986755,103968
01/09/2019,Montana,853702,539844,520319,19525
01/09/2019,Nebraska,1481039,1043236,1012221,31015
01/09/2019,Nevada,2443975,1581000,1520987,60013
01/09/2019,Ohio,9249209,5860933,5613289,247644
01/09/2019,Oklahoma,3036112,1850817,1792888,57929
01/09/2019,Oregon,3416813,2108206,2034404,73802
01/09/2019,Pennsylvania,10278544,6516504,6217673,298831
01/09/2019,Tennessee,5393158,3338025,3225049,112976
01/09/2019,Texas,22008347,14115779,13616230,499549
01/09/2019,Utah,2360793,1618931,1579660,39271
01/09/2019,Vermont,518428,344211,335862,8349
01/09/2019,Virginia,6695531,4443686,4328656,115030
01/09/2019,Washington,6039196,3931891,3774351,157540
01/09/2019,Wisconsin,4639751,3098154,2993572,104582
01/09/2019,Wyoming,452040,297378,285966,11412
01/10/2019,Alabama,3872005,2245134,2182927,62207
01/10/2019,Alaska,546253,354160,335789,18371
01/10/2019,Arizona,5767426,3567196,3398108,169088
01/10/2019,Arkansas,2350098,1369548,1321163,48385
01/10/2019,California,31071318,19409073,18611910,797163
01/10/2019,Colorado,4568307,3146155,3066205,79950
01/10/2019,Connecticut,2885631,1923882,1855057,68825
01/10/2019,Delaware,783996,491392,472205,19187
01/10/2019,Florida,17494169,10417919,10083201,334718
01/10/2019,Georgia,8236438,5178965,5006146,172819
01/10/2019,Hawaii,1090017,672425,657423,15002
01/10/2019,Idaho,1380905,887783,864059,23724
01/10/2019,Illinois,9991696,6419051,6185129,233922
01/10/2019,Indiana,5254766,3389710,3283284,106426
01/10/2019,Iowa,2475313,1742983,1693374,49609
01/10/2019,Kansas,2230598,1500323,1453350,46973
01/10/2019,Kentucky,3501637,2082967,1997368,85599
01/10/2019,Louisiana,3585062,2137472,2033350,104122
01/10/2019,Maine,1113920,698672,679614,19058
01/10/2019,Maryland,4771088,3290807,3179659,111148
01/10/2019,Massachusetts,5643397,3785377,3674106,111271
01/10/2019,Michigan,7996150,4953762,4760278,193484
01/10/2019,Minnesota,4434016,3109362,3013162,96200
01/10/2019,Mississippi,2288305,1287058,1214486,72572
01/10/2019,Missouri,4822582,3096557,2990876,105681
01/10/2019,Montana,854715,541118,521645,19473
01/10/2019,Nebraska,1481955,1044517,1013744,30773
01/10/2019,Nevada,2448374,1586738,1527688,59050
01/10/2019,Ohio,9252182,5869890,5623254,246636
01/10/2019,Oklahoma,3038533,1853060,1795497,57563
01/10/2019,Oregon,3420102,2109607,2037899,71708
01/10/2019,Pennsylvania,10280988,6526543,6224885,301658
01/10/2019,Tennessee,5398996,3341366,3227055,114311
01/10/2019,Texas,22042462,14145807,13647759,498048
01/10/2019,Utah,2365287,1623452,1584461,38991
01/10/2019,Vermont,518595,344591,336052,8539
01/10/2019,Virginia,6700112,4452045,4338608,113437
01/10/2019,Washington,6046858,3939393,3784478,154915
01/10/2019,Wisconsin,4642347,3098170,2994445,103725
01/10/2019,Wyoming,452379,297774,286188,11586
01/11/2019,Alabama,3873710,2245681,2184363,61318
01/11/2019,Alaska,546204,353902,336054,17848
01/11/2019,Arizona,5779302,3573493,3405586,167907
01/11/2019,Arkansas,2351416,1371392,1323096,48296
01/11/2019,California,31078032,19428005,18629523,798482
01/11/2019,Colorado,4573834,3150945,3070651,80294
01/11/2019,Connecticut,2885855,1924643,1855727,68916
01/11/2019,Delaware,784946,492180,472634,19546
01/11/2019,Florida,17515663,10438251,10104965,333286
01/11/2019,Georgia,8244931,5188077,5017472,170605
01/11/2019,Hawaii,1089866,673465,659069,14396
01/11/2019,Idaho,1384052,889088,866032,23056
01/11/2019,Illinois,9989539,6405026,6178403,226623
01/11/2019,Indiana,5257617,3390052,3284278,105774
01/11/2019,Iowa,2476140,1742464,1693168,49296
01/11/2019,Kansas,2231343,1501501,1454798,46703
01/11/2019,Kentucky,3502739,2084262,1999126,85136
01/11/2019,Louisiana,3585109,2143640,2038123,105517
01/11/2019,Maine,1114519,699245,680075,19170
01/11/2019,Maryland,4772202,3294632,3185322,109310
01/11/2019,Massachusetts,5644916,3783053,3673157,109896
01/11/2019,Michigan,7997211,4949900,4762274,187626
01/11/2019,Minnesota,4436354,3112333,3016931,95402
01/11/2019,Mississippi,2288427,1286445,1214960,71485
01/11/2019,Missouri,4824710,3099989,2992970,107019
01/11/2019,Montana,855635,542047,522638,19409
01/11/2019,Nebraska,1482720,1045143,1014641,30502
01/11/2019,Nevada,2452584,1591578,1533376,58202
01/11/2019,Ohio,9254101,5878907,5630337,248570
01/11/2019,Oklahoma,3040628,1853848,1797021,56827
01/11/2019,Oregon,3423008,2110217,2040020,70197
01/11/2019,Pennsylvania,10282189,6532247,6228361,303886
01/11/2019,Tennessee,5404250,3342928,3226750,116178
01/11/2019,Texas,22074778,14164707,13669808,494899
01/11/2019,Utah,2369514,1627137,1588237,38900
01/11/2019,Vermont,518664,344687,336111,8576
01/11/2019,Virginia,6704073,4457320,4345864,111456
01/11/2019,Washington,6053960,3945768,3792879,152889
01/11/2019,Wisconsin,4644458,3096036,2993399,102637
01/11/2019,Wyoming,452666,298072,286213,11859
01/12/2019,Alabama,3875217,2243805,2183474,60331
01/12/2019,Alaska,546167,353626,336041,17585
01/12/2019,Arizona,5790821,3577998,3409326,168672
01/12/2019,Arkansas,2352592,1372227,1323423,48804
01/12/2019,California,31082947,19436766,18629682,807084
01/12/2019,Colorado,4579096,3153757,3072012,81745
01/12/2019,Connecticut,2885994,1923545,1854195,69350
01/12/2019,Delaware,785852,492735,472624,20111
01/12/2019,Florida,17536150,10451550,10115912,335638
01/12/2019,Georgia,8252983,5194430,5023703,170727
01/12/2019,Hawaii,1089657,673650,659676,13974
01/12/2019,Idaho,1387150,889686,867044,22642
01/12/2019,Illinois,9986797,6387664,6166253,221411
01/12/2019,Indiana,5260181,3384041,3278446,105595
01/12/2019,Iowa,2476859,1739293,1690212,49081
01/12/2019,Kansas,2232017,1501433,1454675,46758
01/12/2019,Kentucky,3503649,2083463,1998285,85178
01/12/2019,Louisiana,3584977,2148287,2041203,107084
01/12/2019,Maine,1115080,699593,679814,19779
01/12/2019,Maryland,4773117,3296994,3187889,109105
01/12/2019,Massachusetts,5646173,3776027,3667667,108360
01/12/2019,Michigan,7997875,4943738,4759897,183841
01/12/2019,Minnesota,4438470,3114576,3018498,96078
01/12/2019,Mississippi,2288447,1285312,1214113,71199
01/12/2019,Missouri,4826623,3100780,2992178,108602
01/12/2019,Montana,856541,542499,522984,19515
01/12/2019,Nebraska,1483375,1044977,1014498,30479
01/12/2019,Nevada,2456633,1595314,1537291,58023
01/12/2019,Ohio,9255603,5887786,5631692,256094
01/12/2019,Oklahoma,3042581,1852804,1796353,56451
01/12/2019,Oregon,3425727,2109883,2039745,70138
01/12/2019,Pennsylvania,10282920,6533827,6225747,308080
01/12/2019,Tennessee,5409243,3341819,3222404,119415
01/12/2019,Texas,22105815,14174181,13677859,496322
01/12/2019,Utah,2373687,1629570,1590354,39216
01/12/2019,Vermont,518756,344333,335826,8507
01/12/2019,Virginia,6707692,4457736,4347665,110071
01/12/2019,Washington,6060751,3951421,3798056,153365
01/12/2019,Wisconsin,4646321,3091661,2989464,102197
01/12/2019,Wyoming,452928,298339,285925,12414
01/01/2020,Alabama,3876526,2240277,2180872,59405
01/01/2020,Alaska,546109,353349,335692,17657
01/01/2020,Arizona,5802213,3581294,3409624,171670
01/01/2020,Arkansas,2353674,1372291,1322159,50132
01/01/2020,California,31086836,19437115,18613291,823824
01/01/2020,Colorado,4584112,3154544,3070164,84380
01/01/2020,Connecticut,2885953,1921041,1850746,70295
01/01/2020,Delaware,786721,493327,472306,21021
01/01/2020,Florida,17555962,10458937,10116910,342027
01/01/2020,Georgia,8260627,5198431,5024604,173827
01/01/2020,Hawaii,1089395,673017,659237,13780
01/01/2020,Idaho,1390161,889944,867117,22827
01/01/2020,Illinois,9983613,6370035,6149010,221025
01/01/2020,Indiana,5262529,3372996,3266538,106458
01/01/2020,Iowa,2477479,1734173,1684860,49313
01/01/2020,Kansas,2232550,1500177,1453029,47148
01/01/2020,Kentucky,3504469,2081086,1995321,85765
01/01/2020,Louisiana,3584646,2150907,2041637,109270
01/01/2020,Maine,1115592,699646,678873,20773
01/01/2020,Maryland,4773748,3298221,3187160,111061
01/01/2020,Massachusetts,5647161,3763790,3657139,106651
01/01/2020,Michigan,7998157,4936707,4753182,183525
01/01/2020,Minnesota,4440365,3116174,3017331,98843
01/01/2020,Mississippi,2288349,1284171,1211954,72217
01/01/2020,Missouri,4828271,3099592,2989051,110541
01/01/2020,Montana,857398,542553,522727,19826
01/01/2020,Nebraska,1484013,1044199,1013444,30755
01/01/2020,Nevada,2460603,1597920,1539287,58633
01/01/2020,Ohio,9256594,5895125,5627571,267554
01/01/2020,Oklahoma,3044378,1850300,1793406,56894
01/01/2020,Oregon,3428283,2108977,2037231,71746
01/01/2020,Pennsylvania,10283103,6532104,6216949,315155
01/01/2020,Tennessee,5413972,3338446,3214183,124263
01/01/2020,Texas,22136086,14178765,13673709,505056
01/01/2020,Utah,2377669,1630818,1590908,39910
01/01/2020,Vermont,518807,343628,335164,8464
01/01/2020,Virginia,6711014,4453855,4343866,109989
01/01/2020,Washington,6067267,3957004,3799953,157051
01/01/2020,Wisconsin,4647953,3084954,2982788,102166
01/01/2020,Wyoming,453129,298600,285320,13280
01/02/2020,Alabama,3877055,2236491,2177852,58639
01/02/2020,Alaska,545922,352940,335023,17917
01/02/2020,Arizona,5812433,3584045,3407756,176289
01/02/2020,Arkansas,2354279,1371944,1319917,52027
01/02/2020,California,31086594,19433049,18587756,845293
01/02/2020,Colorado,4588565,3153582,3065913,87669
01/02/2020,Connecticut,2885386,1917993,1846218,71775
01/02/2020,Delaware,787402,494035,471865,22170
01/02/2020,Florida,17571923,10461404,10111574,349830
01/02/2020,Georgia,8266924,5201435,5021666,179769
01/02/2020,Hawaii,1088920,671901,658112,13789
01/02/2020,Idaho,1392964,890044,866502,23542
01/02/2020,Illinois,9978724,6355061,6128641,226420
01/02/2020,Indiana,5263980,3359160,3250571,108589
01/02/2020,Iowa,2477569,1727949,1678066,49883
01/02/2020,Kansas,2232676,1498044,1450486,47558
01/02/2020,Kentucky,3504588,2077898,1991434,86464
01/02/2020,Louisiana,3583665,2151507,2039411,112096
01/02/2020,Maine,1115854,699067,677448,21619
01/02/2020,Maryland,4773523,3298443,3184239,114204
01/02/2020,Massachusetts,5647178,3747222,3642616,104606
01/02/2020,Michigan,7996913,4927949,4743379,184570
01/02/2020,Minnesota,4441480,3117081,3013513,103568
01/02/2020,Mississippi,2287820,1283304,1209022,74282
01/02/2020,Missouri,4828978,3097559,2984967,112592
01/02/2020,Montana,858070,542368,522142,20226
01/02/2020,Nebraska,1484359,1043340,1012002,31338
01/02/2020,Nevada,2464244,1599451,1539656,59795
01/02/2020,Ohio,9255817,5899009,5619606,279403
01/02/2020,Oklahoma,3045622,1847072,1788930,58142
01/02/2020,Oregon,3430274,2107699,2033344,74355
01/02/2020,Pennsylvania,10281185,6528498,6204448,324050
01/02/2020,Tennessee,5417729,3333471,3203564,129907
01/02/2020,Texas,22163701,14182317,13662942,519375
01/02/2020,Utah,2381430,1631216,1590455,40761
01/02/2020,Vermont,518755,342887,334270,8617
01/02/2020,Virginia,6713131,4448623,4337089,111534
01/02/2020,Washington,6072840,3961975,3799304,162671
01/02/2020,Wisconsin,4648731,3075655,2974233,101422
01/02/2020,Wyoming,453321,298818,284507,14311
01/03/2020,Alabama,3878006,2234170,2176275,57895
01/03/2020,Alaska,545866,352404,334331,18073
01/03/2020,Arizona,5823018,3587701,3406748,180953
01/03/2020,Arkansas,2355118,1372102,1318251,53851
01/03/2020,California,31087184,19168665,18304574,864091
01/03/2020,Colorado,4593310,3099232,2953112,146120
01/03/2020,Connecticut,2885051,1915644,1842200,73444
01/03/2020,Delaware,788163,481344,458200,23144
01/03/2020,Florida,17589075,10629624,10106833,522791
01/03/2020,Georgia,8273938,5205472,5018477,186995
01/03/2020,Hawaii,1088470,671079,657086,13993
01/03/2020,Idaho,1395898,890190,865860,24330
01/03/2020,Illinois,9974673,6345433,6109809,235624
01/03/2020,Indiana,5265950,3346411,3235038,111373
01/03/2020,Iowa,2477947,1721723,1671622,50101
01/03/2020,Kansas,2233058,1495882,1448406,47476
01/03/2020,Kentucky,3505113,2075112,1988308,86804
01/03/2020,Louisiana,3583040,2150787,2036022,114765
01/03/2020,Maine,1116239,697728,676175,21553
01/03/2020,Maryland,4773662,3298663,3181957,116706
01/03/2020,Massachusetts,5647723,3728887,3627179,101708
01/03/2020,Michigan,7996478,4917789,4734860,182929
01/03/2020,Minnesota,4443088,3118380,3008879,109501
01/03/2020,Mississippi,2287475,1283188,1206406,76782
01/03/2020,Missouri,4830226,3096593,2982405,114188
01/03/2020,Montana,858828,542146,521657,20489
01/03/2020,Nebraska,1484852,1043236,1011133,32103
01/03/2020,Nevada,2467941,1587900,1485811,102089
01/03/2020,Ohio,9256097,5836682,5549718,286964
01/03/2020,Oklahoma,3047166,1844387,1784671,59716
01/03/2020,Oregon,3432553,2106741,2030098,76643
01/03/2020,Pennsylvania,10280347,6525913,6194061,331852
01/03/2020,Tennessee,5422052,3328051,3193850,134201
01/03/2020,Texas,22192219,13986789,13306781,680008
01/03/2020,Utah,2385460,1631706,1590309,41397
01/03/2020,Vermont,518754,342487,333471,9016
01/03/2020,Virginia,6715837,4447482,4333184,114298
01/03/2020,Washington,6078919,3932003,3724793,207210
01/03/2020,Wisconsin,4649987,3065273,2966524,98749
01/03/2020,Wyoming,453558,299040,283757,15283
01/04/2020,Alabama,3879108,2187272,1899019,288253
01/04/2020,Alaska,545788,345671,304991,40680
01/04/2020,Arizona,5834004,3545107,3040409,504698
01/04/2020,Arkansas,2356097,1371571,1234204,137367
01/04/2020,California,31090131,18590864,15624429,2966435
01/04/2020,Colorado,4598343,2983132,2621363,361769
01/04/2020,Connecticut,2884884,1826611,1669743,156868
01/04/2020,Delaware,788966,474498,411017,63481
01/04/2020,Florida,17607252,9765316,8400513,1364803
01/04/2020,Georgia,8281411,4985895,4365055,620840
01/04/2020,Hawaii,1088090,637563,497928,139635
01/04/2020,Idaho,1398886,876528,775219,101309
01/04/2020,Illinois,9971141,6026243,5029765,996478
01/04/2020,Indiana,5268170,3225032,2680097,544935
01/04/2020,Iowa,2478425,1712557,1522362,190195
01/04/2020,Kansas,2233522,1485985,1298910,187075
01/04/2020,Kentucky,3505783,2087483,1734915,352568
01/04/2020,Louisiana,3582557,2041667,1773471,268196
01/04/2020,Maine,1116663,654335,594673,59662
01/04/2020,Maryland,4774055,3131058,2848836,282222
01/04/2020,Massachusetts,5648468,3409863,2851481,558382
01/04/2020,Michigan,7996378,4586421,3502065,1084356
01/04/2020,Minnesota,4444837,3012976,2740570,272406
01/04/2020,Mississippi,2287269,1218052,1027052,191000
01/04/2020,Missouri,4831693,2980434,2606915,373519
01/04/2020,Montana,859622,543608,479153,64455
01/04/2020,Nebraska,1485441,1051562,973730,77832
01/04/2020,Nevada,2471833,1497652,1055435,442217
01/04/2020,Ohio,9256776,5539776,4630914,908862
01/04/2020,Oklahoma,3048864,1821680,1585139,236541
01/04/2020,Oregon,3434992,2049533,1778695,270838
01/04/2020,Pennsylvania,10279924,6313806,5290771,1023035
01/04/2020,Tennessee,5426617,3183054,2679469,503585
01/04/2020,Texas,22222320,13368039,11640170,1727869
01/04/2020,Utah,2389585,1624093,1460079,164014
01/04/2020,Vermont,518778,353857,301638,52219
01/04/2020,Virginia,6718918,4391242,3895532,495710
01/04/2020,Washington,6085331,3988363,3336286,652077
01/04/2020,Wisconsin,4651479,3061130,2607992,453138
01/04/2020,Wyoming,453794,290960,274922,16038
01/05/2020,Alabama,3879383,2218789,2044109,174680
01/05/2020,Alaska,545650,345359,305247,40112
01/05/2020,Arizona,5843415,3619124,3236482,382642
01/05/2020,Arkansas,2356584,1352008,1237273,114735
01/05/2020,California,31081351,18392528,15529319,2863209
01/05/2020,Colorado,4602402,3105848,2744873,360975
01/05/2020,Connecticut,2883940,1886540,1671130,215410
01/05/2020,Delaware,789583,475201,412227,62974
01/05/2020,Florida,17620672,9949585,8533164,1416421
01/05/2020,Georgia,8286668,5030665,4558036,472629
01/05/2020,Hawaii,1087260,638894,498685,140209
01/05/2020,Idaho,1401631,882245,808995,73250
01/05/2020,Illinois,9965041,6158659,5211779,946880
01/05/2020,Indiana,5269325,3264747,2874299,390448
01/05/2020,Iowa,2478455,1660842,1523062,137780
01/05/2020,Kansas,2233534,1488938,1354666,134272
01/05/2020,Kentucky,3505869,2073314,1846754,226560
01/05/2020,Louisiana,3581304,2039684,1771746,267938
01/05/2020,Maine,1116950,681019,624764,56255
01/05/2020,Maryland,4773107,3135302,2854474,280828
01/05/2020,Massachusetts,5647805,3609060,3056433,552627
01/05/2020,Michigan,7994582,4695183,3718354,976829
01/05/2020,Minnesota,4445755,3087954,2739692,348262
01/05/2020,Mississippi,2286517,1227107,1091934,135173
01/05/2020,Missouri,4832218,2891970,2613065,278905
01/05/2020,Montana,860294,528223,480130,48093
01/05/2020,Nebraska,1485719,1031661,975917,55744
01/05/2020,Nevada,2474993,1435029,1083335,351694
01/05/2020,Ohio,9255576,5831829,4965227,866602
01/05/2020,Oklahoma,3049957,1831486,1657368,174118
01/05/2020,Oregon,3436725,2121025,1873383,247642
01/05/2020,Pennsylvania,10277311,6412123,5549484,862639
01/05/2020,Tennessee,5430156,3150509,2848150,302359
01/05/2020,Texas,22245728,13567930,11992731,1575199
01/05/2020,Utah,2393257,1583682,1463992,119690
01/05/2020,Vermont,518699,332962,301923,31039
01/05/2020,Virginia,6720219,4274171,3912282,361889
01/05/2020,Washington,6090159,3904883,3417587,487296
01/05/2020,Wisconsin,4652037,3052908,2736271,316637
01/05/2020,Wyoming,453942,300611,275096,25515
01/06/2020,Alabama,3879980,2221436,2049715,171721
01/06/2020,Alaska,545489,345254,306122,39132
01/06/2020,Arizona,5853318,3561870,3180733,381137
01/06/2020,Arkansas,2357230,1347387,1242595,104792
01/06/2020,California,31075328,18813142,16161036,2652106
01/06/2020,Colorado,4606805,3154711,2796909,357802
01/06/2020,Connecticut,2883299,1890666,1675483,215183
01/06/2020,Delaware,790266,475871,414294,61577
01/06/2020,Florida,17635636,9898486,8749388,1149098
01/06/2020,Georgia,8292650,4990499,4569851,420648
01/06/2020,Hawaii,1086459,639357,549249,90108
01/06/2020,Idaho,1404514,884808,822839,61969
01/06/2020,Illinois,9959743,6356264,5452932,903332
01/06/2020,Indiana,5270927,3284240,2950944,333296
01/06/2020,Iowa,2478689,1645540,1528543,116997
01/06/2020,Kansas,2233723,1481232,1377977,103255
01/06/2020,Kentucky,3506224,1962690,1851652,111038
01/06/2020,Louisiana,3580287,1955017,1772157,182860
01/06/2020,Maine,1117286,661977,626891,35086
01/06/2020,Maryland,4772600,3235141,2957538,277603
01/06/2020,Massachusetts,5647618,3683679,3138699,544980
01/06/2020,Michigan,7993462,4917012,4221930,695082
01/06/2020,Minnesota,4446981,3178494,2894566,283928
01/06/2020,Mississippi,2285922,1235797,1117094,118703
01/06/2020,Missouri,4833125,2994804,2752806,241998
01/06/2020,Montana,861056,549295,507756,41539
01/06/2020,Nebraska,1486137,1048401,979531,68870
01/06/2020,Nevada,2478346,1504348,1272287,232061
01/06/2020,Ohio,9255121,5680927,5093233,587694
01/06/2020,Oklahoma,3051282,1838543,1687262,151281
01/06/2020,Oregon,3438732,2133140,1913733,219407
01/06/2020,Pennsylvania,10275510,6421698,5567918,853780
01/06/2020,Tennessee,5434065,3156214,2862152,294062
01/06/2020,Texas,22271053,14068625,12638796,1429829
01/06/2020,Utah,2397123,1650824,1547616,103208
01/06/2020,Vermont,518679,327912,302806,25106
01/06/2020,Virginia,6722117,4320856,3939193,381663
01/06/2020,Washington,6095478,3877618,3457295,420323
01/06/2020,Wisconsin,4653004,3049234,2786485,262749
01/06/2020,Wyoming,454118,297883,275846,22037
01/07/2020,Alabama,3880648,2221858,2056348,165510
01/07/2020,Alaska,545364,345354,307513,37841
01/07/2020,Arizona,5863335,3610878,3233654,377224
01/07/2020,Arkansas,2357952,1344406,1249195,95211
01/07/2020,California,31069557,18731539,16268045,2463494
01/07/2020,Colorado,4611317,3070601,2844310,226291
01/07/2020,Connecticut,2882679,1895751,1681865,213886
01/07/2020,Delaware,790928,489517,449079,40438
01/07/2020,Florida,17650810,10108143,8940935,1167208
01/07/2020,Georgia,8298770,4966280,4587883,378397
01/07/2020,Hawaii,1085710,641845,551240,90605
01/07/2020,Idaho,1407405,887190,835264,51926
01/07/2020,Illinois,9954618,6146834,5409563,737271
01/07/2020,Indiana,5272639,3304366,3019818,284548
01/07/2020,Iowa,2478961,1637807,1538161,99646
01/07/2020,Kansas,2233951,1497429,1398770,98659
01/07/2020,Kentucky,3506659,1968434,1858922,109512
01/07/2020,Louisiana,3579383,1952856,1775157,177699
01/07/2020,Maine,1117659,690375,629790,60585
01/07/2020,Maryland,4772159,3151830,2877939,273891
01/07/2020,Massachusetts,5647519,3563106,3213230,349876
01/07/2020,Michigan,7992512,4835421,4399525,435896
01/07/2020,Minnesota,4448291,3136773,2898989,237784
01/07/2020,Mississippi,2285425,1245129,1138838,106291
01/07/2020,Missouri,4834175,3101654,2891126,210528
01/07/2020,Montana,861803,545747,509831,35916
01/07/2020,Nebraska,1486531,1028806,983881,44925
01/07/2020,Nevada,2481749,1512588,1261549,251039
01/07/2020,Ohio,9254910,5735320,5199086,536234
01/07/2020,Oklahoma,3052681,1846738,1714448,132290
01/07/2020,Oregon,3440819,2037847,1842992,194855
01/07/2020,Pennsylvania,10273917,6431720,5592719,839001
01/07/2020,Tennessee,5438126,3167388,2884231,283157
01/07/2020,Texas,22296608,14005509,12704427,1301082
01/07/2020,Utah,2401050,1645536,1556112,89424
01/07/2020,Vermont,518664,324705,304020,20685
01/07/2020,Virginia,6724104,4313312,3972148,341164
01/07/2020,Washington,6100875,3920431,3497219,423212
01/07/2020,Wisconsin,4654069,3049237,2829923,219314
01/07/2020,Wyoming,454334,297259,277055,20204
01/08/2020,Alabama,3882472,2218586,2061877,156709
01/08/2020,Alaska,545315,332996,308923,24073
01/08/2020,Arizona,5875190,3518731,3272951,245780
01/08/2020,Arkansas,2359375,1341356,1254825,86531
01/08/2020,California,31074765,18666663,16365343,2301320
01/08/2020,Colorado,4616798,3105843,2884052,221791
01/08/2020,Connecticut,2882475,1841890,1687722,154168
01/08/2020,Delaware,791842,490233,451598,38635
01/08/2020,Florida,17669527,9991016,9206578,784438
01/08/2020,Georgia,8306713,4951494,4606347,345147
01/08/2020,Hawaii,1085305,643435,552752,90683
01/08/2020,Idaho,1410666,889123,845684,43439
01/08/2020,Illinois,9951889,6251739,5556088,695651
01/08/2020,Indiana,5275194,3320857,3077335,243522
01/08/2020,Iowa,2479628,1634482,1548511,85971
01/08/2020,Kansas,2234666,1509706,1415790,93916
01/08/2020,Kentucky,3507887,1974553,1865892,108661
01/08/2020,Louisiana,3579331,2096160,1924464,171696
01/08/2020,Maine,1118255,666897,632379,34518
01/08/2020,Maryland,4772659,3161767,2890448,271319
01/08/2020,Massachusetts,5647588,3614444,3277606,336838
01/08/2020,Michigan,7993400,4841531,4428898,412633
01/08/2020,Minnesota,4450313,3107608,2903291,204317
01/08/2020,Mississippi,2285698,1253922,1156630,97292
01/08/2020,Missouri,4836296,3089395,2904372,185023
01/08/2020,Montana,862714,542642,511307,31335
01/08/2020,Nebraska,1487267,1028809,987515,41294
01/08/2020,Nevada,2485827,1523576,1302740,220836
01/08/2020,Ohio,9256696,5803203,5280326,522877
01/08/2020,Oklahoma,3054823,1853864,1736890,116974
01/08/2020,Oregon,3443733,2086120,1911571,174549
01/08/2020,Pennsylvania,10274843,6252470,5614075,638395
01/08/2020,Tennessee,5443591,3377475,3104367,273108
01/08/2020,Texas,22327142,14095792,13118386,977406
01/08/2020,Utah,2405329,1642626,1564538,78088
01/08/2020,Vermont,518754,322293,305041,17252
01/08/2020,Virginia,6727072,4376496,4068442,308054
01/08/2020,Washington,6107080,3886077,3532848,353229
01/08/2020,Wisconsin,4656094,3050916,2864676,186240
01/08/2020,Wyoming,454672,296712,278278,18434
01/09/2020,Alabama,3884533,2212712,2065378,147334
01/09/2020,Alaska,545254,333247,309975,23272
01/09/2020,Arizona,5887367,3541969,3299327,242642
01/09/2020,Arkansas,2360906,1337649,1258219,79430
01/09/2020,California,31081669,18385558,16435503,1950055
01/09/2020,Colorado,4622504,3133342,2914426,218916
01/09/2020,Connecticut,2882419,1844073,1691446,152627
01/09/2020,Delaware,792821,490907,453405,37502
01/09/2020,Florida,17689159,10052895,9333690,719205
01/09/2020,Georgia,8315078,4940860,4620784,320076
01/09/2020,Hawaii,1084946,610118,519692,90426
01/09/2020,Idaho,1414009,908599,853750,54849
01/09/2020,Illinois,9949614,6363924,5703261,660663
01/09/2020,Indiana,5277977,3331816,3121310,210506
01/09/2020,Iowa,2480410,1632810,1556751,76059
01/09/2020,Kansas,2235531,1472356,1382202,90154
01/09/2020,Kentucky,3509267,1979845,1870874,108971
01/09/2020,Louisiana,3579467,2095001,1927988,167013
01/09/2020,Maine,1118905,666384,634000,32384
01/09/2020,Maryland,4773360,3009144,2800001,209143
01/09/2020,Massachusetts,5647956,3655222,3330763,324459
01/09/2020,Michigan,7994613,4848757,4450747,398010
01/09/2020,Minnesota,4452562,3086445,2905954,180491
01/09/2020,Mississippi,2286039,1261776,1170336,91440
01/09/2020,Missouri,4838656,3079960,2914028,165932
01/09/2020,Montana,863704,539685,511783,27902
01/09/2020,Nebraska,1488070,1028194,989626,38568
01/09/2020,Nevada,2489990,1535174,1335440,199734
01/09/2020,Ohio,9258910,5668842,5250401,418441
01/09/2020,Oklahoma,3057131,1858861,1753633,105228
01/09/2020,Oregon,3446867,2107097,1948079,159018
01/09/2020,Pennsylvania,10276251,6317241,5867228,450013
01/09/2020,Tennessee,5449301,3388990,3122079,266911
01/09/2020,Texas,22358893,13978180,12872257,1105923
01/09/2020,Utah,2409740,1640259,1571099,69160
01/09/2020,Vermont,518848,320189,305589,14600
01/09/2020,Virginia,6730369,4302424,4020210,282214
01/09/2020,Washington,6113541,3870014,3560713,309301
01/09/2020,Wisconsin,4658297,3128082,2965386,162696
01/09/2020,Wyoming,454998,296176,279179,16997
01/10/2020,Alabama,3886383,2266300,2158999,107301
01/10/2020,Alaska,545223,354075,331171,22904
01/10/2020,Arizona,5899190,3556433,3315121,241312
01/10/2020,Arkansas,2362323,1333366,1259359,74007
01/10/2020,California,31086721,18904638,17050260,1854378
01/10/2020,Colorado,4627942,3153491,2935611,217880
01/10/2020,Connecticut,2882202,1844473,1692736,151737
01/10/2020,Delaware,793770,481815,454271,27544
01/10/2020,Florida,17707888,10010524,9427112,583412
01/10/2020,Georgia,8323051,5133190,4831831,301359
01/10/2020,Hawaii,1084522,643115,553195,89920
01/10/2020,Idaho,1417281,903294,859499,43795
01/10/2020,Illinois,9946882,6326464,5813987,512477
01/10/2020,Indiana,5280606,3338006,3152745,185261
01/10/2020,Iowa,2481099,1630576,1561396,69180
01/10/2020,Kansas,2236251,1508097,1437158,70939
01/10/2020,Kentucky,3510534,1983293,1873315,109978
01/10/2020,Louisiana,3579445,2094453,1929972,164481
01/10/2020,Maine,1119531,666379,634487,31892
01/10/2020,Maryland,4773863,3113628,2903239,210389
01/10/2020,Massachusetts,5648070,3688327,3373320,315007
01/10/2020,Michigan,7995545,4854613,4461770,392843
01/10/2020,Minnesota,4454624,3070211,2906452,163759
01/10/2020,Mississippi,2286309,1268234,1180316,87918
01/10/2020,Missouri,4840816,3071517,2919089,152428
01/10/2020,Montana,864626,536872,511419,25453
01/10/2020,Nebraska,1488824,1026818,990239,36579
01/10/2020,Nevada,2494084,1545744,1360394,185350
01/10/2020,Ohio,9260740,5698877,5380157,318720
01/10/2020,Oklahoma,3059281,1861590,1765143,96447
01/10/2020,Oregon,3449790,2122565,1974681,147884
01/10/2020,Pennsylvania,10277210,6314482,5870140,444342
01/10/2020,Tennessee,5454779,3396932,3131888,265044
01/10/2020,Texas,22389388,14220838,13177348,1043490
01/10/2020,Utah,2414062,1637215,1574896,62319
01/10/2020,Vermont,518954,318369,305655,12714
01/10/2020,Virginia,6733361,4290462,4027562,262900
01/10/2020,Washington,6119759,3981810,3704008,277802
01/10/2020,Wisconsin,4660353,3054307,2908317,145990
01/10/2020,Wyoming,455331,295623,279620,16003
01/11/2020,Alabama,3887946,2263901,2158343,105558
01/11/2020,Alaska,545133,354071,331069,23002
01/11/2020,Arizona,5910601,3563927,3322173,241754
01/11/2020,Arkansas,2363579,1328600,1258385,70215
01/11/2020,California,31090632,18604626,16983903,1620723
01/11/2020,Colorado,4633108,3166511,2947931,218580
01/11/2020,Connecticut,2881741,1843528,1691777,151751
01/11/2020,Delaware,794630,481873,453979,27894
01/11/2020,Florida,17725160,10025050,9485302,539748
01/11/2020,Georgia,8330547,5116371,4831240,285131
01/11/2020,Hawaii,1084113,655912,588368,67544
01/11/2020,Idaho,1420432,901615,862991,38624
01/11/2020,Illinois,9943419,6161356,5662138,499218
01/11/2020,Indiana,5282747,3340983,3173510,167473
01/11/2020,Iowa,2481531,1625043,1560883,64160
01/11/2020,Kansas,2236775,1513503,1442525,70978
01/11/2020,Kentucky,3511462,1983374,1872685,110689
01/11/2020,Louisiana,3579170,2094642,1929950,164692
01/11/2020,Maine,1120025,666706,633957,32749
01/11/2020,Maryland,4774038,3113418,2901959,211459
01/11/2020,Massachusetts,5647713,3721554,3408246,313308
01/11/2020,Michigan,7995779,4855661,4458979,396682
01/11/2020,Minnesota,4456287,3057403,2905452,151951
01/11/2020,Mississippi,2286424,1272826,1187251,85575
01/11/2020,Missouri,4842526,3061073,2918134,142939
01/11/2020,Montana,865491,534549,510758,23791
01/11/2020,Nebraska,1489408,1024861,989563,35298
01/11/2020,Nevada,2498025,1509102,1378050,131052
01/11/2020,Ohio,9261688,5732818,5413227,319591
01/11/2020,Oklahoma,3061177,1861831,1772259,89572
01/11/2020,Oregon,3452417,2132974,1992470,140504
01/11/2020,Pennsylvania,10277120,6310994,5865408,445586
01/11/2020,Tennessee,5459887,3314879,3130511,184368
01/11/2020,Texas,22418959,13992055,12989789,1002266
01/11/2020,Utah,2418202,1631847,1574574,57273
01/11/2020,Vermont,518950,316982,305386,11596
01/11/2020,Virginia,6735886,4271293,4023075,248218
01/11/2020,Washington,6125522,3842951,3586497,256454
01/11/2020,Wisconsin,4661965,3054158,2921245,132913
01/11/2020,Wyoming,455610,295063,279509,15554
01/12/2020,Alabama,3889304,2264054,2157736,106318
01/12/2020,Alaska,545002,354035,330888,23147
01/12/2020,Arizona,5921658,3569317,3326907,242410
01/12/2020,Arkansas,2364696,1379313,1312142,67171
01/12/2020,California,31092761,18705475,16957019,1748456
01/12/2020,Colorado,4638089,3176560,2957291,219269
01/12/2020,Connecticut,2881139,1842967,1690960,152007
01/12/2020,Delaware,795439,481840,453637,28203
01/12/2020,Florida,17741498,10043992,9528878,515114
01/12/2020,Georgia,8337625,5100297,4829189,271108
01/12/2020,Hawaii,1083643,655587,588168,67419
01/12/2020,Idaho,1423536,900245,865649,34596
01/12/2020,Illinois,9939435,6150544,5659671,490873
01/12/2020,Indiana,5284652,3343929,3190041,153888
01/12/2020,Iowa,2481817,1619441,1559562,59879
01/12/2020,Kansas,2237175,1518416,1446860,71556
01/12/2020,Kentucky,3512248,1982759,1871847,110912
01/12/2020,Louisiana,3578682,2095025,1929532,165493
01/12/2020,Maine,1120437,666913,633553,33360
01/12/2020,Maryland,4773973,3112292,2900385,211907
01/12/2020,Massachusetts,5647094,3753070,3438583,314487
01/12/2020,Michigan,7995651,4855353,4454983,400370
01/12/2020,Minnesota,4457728,3048729,2904806,143923
01/12/2020,Mississippi,2286392,1276640,1192792,83848
01/12/2020,Missouri,4844027,3051663,2916551,135112
01/12/2020,Montana,866314,532934,510472,22462
01/12/2020,Nebraska,1489954,1023600,989072,34528
01/12/2020,Nevada,2501811,1516397,1391773,124624
01/12/2020,Ohio,9262241,5763310,5442603,320707
01/12/2020,Oklahoma,3062909,1861928,1777990,83938
01/12/2020,Oregon,3454895,2141252,2006503,134749
01/12/2020,Pennsylvania,10276507,6310050,5862162,447888
01/12/2020,Tennessee,5464698,3313650,3127609,186041
01/12/2020,Texas,22447253,14133518,13162510,971008
01/12/2020,Utah,2422249,1626916,1573578,53338
01/12/2020,Vermont,518976,316150,305226,10924
01/12/2020,Virginia,6738044,4255079,4018875,236204
01/12/2020,Washington,6131010,3830416,3590957,239459
01/12/2020,Wisconsin,4663376,3053836,2932229,121607
01/12/2020,Wyoming,455877,294630,279346,15284
01/01/2021,Alabama,3890500,2257961,2160236,97725
01/01/2021,Alaska,544894,354958,331373,23585
01/01/2021,Arizona,5932506,3571263,3331367,239896
01/01/2021,Arkansas,2365706,1375929,1312405,63524
01/01/2021,California,31093847,18668523,16988683,1679840
01/01/2021,Colorado,4642794,3183395,2972204,211191
01/01/2021,Connecticut,2880415,1839727,1690546,149181
01/01/2021,Delaware,796235,487378,457875,29503
01/01/2021,Florida,17757100,10068685,9587059,481626
01/01/2021,Georgia,8344325,5112237,4853777,258460
01/01/2021,Hawaii,1083148,655766,588116,67650
01/01/2021,Idaho,1426574,900287,869144,31143
01/01/2021,Illinois,9935021,6146410,5673481,472929
01/01/2021,Indiana,5286270,3347810,3206431,141379
01/01/2021,Iowa,2482022,1625153,1567143,58010
01/01/2021,Kansas,2237486,1502248,1450464,51784
01/01/2021,Kentucky,3512884,1989380,1882979,106401
01/01/2021,Louisiana,3578075,2084330,1925840,158490
01/01/2021,Maine,1120850,671317,636270,35047
01/01/2021,Maryland,4773686,3106287,2907520,198767
01/01/2021,Massachusetts,5646187,3756720,3461950,294770
01/01/2021,Michigan,7995094,4736547,4465785,270762
01/01/2021,Minnesota,4458943,3025807,2889849,135958
01/01/2021,Mississippi,2286271,1279970,1197779,82191
01/01/2021,Missouri,4845259,3042955,2912406,130549
01/01/2021,Montana,867082,532910,511691,21219
01/01/2021,Nebraska,1490395,1024822,992112,32710
01/01/2021,Nevada,2505533,1536046,1405483,130563
01/01/2021,Ohio,9262261,5768594,5462512,306082
01/01/2021,Oklahoma,3064511,1864691,1783422,81269
01/01/2021,Oregon,3457167,2150483,2017032,133451
01/01/2021,Pennsylvania,10275393,6294551,5837381,457170
01/01/2021,Tennessee,5469230,3317190,3146950,170240
01/01/2021,Texas,22474687,14063544,13104983,958561
01/01/2021,Utah,2426150,1630721,1580527,50194
01/01/2021,Vermont,518952,314630,304521,10109
01/01/2021,Virginia,6739873,4254052,4026838,227214
01/01/2021,Washington,6136163,3835229,3606638,228591
01/01/2021,Wisconsin,4664495,3056717,2939823,116894
01/01/2021,Wyoming,456106,295132,280002,15130
01/02/2021,Alabama,3891139,2249475,2158410,91065
01/02/2021,Alaska,544693,351042,327734,23308
01/02/2021,Arizona,5942577,3580159,3333218,246941
01/02/2021,Arkansas,2366377,1363154,1301585,61569
01/02/2021,California,31091641,18944536,17334333,1610203
01/02/2021,Colorado,4647075,3187192,2977934,209258
01/02/2021,Connecticut,2879316,1712892,1566755,146137
01/02/2021,Delaware,796901,488849,457878,30971
01/02/2021,Florida,17769891,10124081,9649964,474117
01/02/2021,Georgia,8350072,5145311,4899537,245774
01/02/2021,Hawaii,1082480,655353,595209,60144
01/02/2021,Idaho,1429397,899796,870056,29740
01/02/2021,Illinois,9929473,6138343,5684103,454240
01/02/2021,Indiana,5287355,3342839,3208862,133977
01/02/2021,Iowa,2481881,1628644,1570309,58335
01/02/2021,Kansas,2237550,1499299,1451432,47867
01/02/2021,Kentucky,3513075,1993122,1889699,103423
01/02/2021,Louisiana,3576989,2076336,1919136,157200
01/02/2021,Maine,1121094,672438,639943,32495
01/02/2021,Maryland,4772844,3101248,2909635,191613
01/02/2021,Massachusetts,5644665,3744815,3477684,267131
01/02/2021,Michigan,7993560,4695245,4451945,243300
01/02/2021,Minnesota,4459692,3022136,2892393,129743
01/02/2021,Mississippi,2285852,1281419,1200442,80977
01/02/2021,Missouri,4845885,3050852,2921918,128934
01/02/2021,Montana,867716,531389,510726,20663
01/02/2021,Nebraska,1490687,1021103,989085,32018
01/02/2021,Nevada,2508958,1545250,1416663,128587
01/02/2021,Ohio,9261248,5755857,5467067,288790
01/02/2021,Oklahoma,3065768,1865479,1784164,81315
01/02/2021,Oregon,3459073,2152206,2021269,130937
01/02/2021,Pennsylvania,10273015,6330147,5867367,462780
01/02/2021,Tennessee,5473138,3308238,3145757,162481
01/02/2021,Texas,22500029,14005438,13034964,970474
01/02/2021,Utah,2429915,1630609,1581835,48774
01/02/2021,Vermont,518856,313279,303681,9598
01/02/2021,Virginia,6740927,4238057,4018030,220027
01/02/2021,Washington,6140754,3837392,3621486,215906
01/02/2021,Wisconsin,4665137,3059210,2942805,116405
01/02/2021,Wyoming,456315,295331,279791,15540
