ds,name,civ,labor,emp,unemp
2008-01-01,Alabama,3577198,2171477,2061406,110071
2008-01-01,Alaska,498693,347658,322830,24828
2008-01-01,Arizona,4822624,3048863,2912105,136758
2008-01-01,Arkansas,2177814,1332982,1255266,77716
2008-01-01,California,27453421,17988606,16842411,1146195
2008-01-01,Colorado,3733587,2715804,2590207,125597
2008-01-01,Connecticut,2718370,1858666,1758354,100312
2008-01-01,Delaware,673835,448670,428398,20272
2008-01-01,Florida,14421176,9127336,8728208,399128
2008-01-01,Georgia,7145219,4864210,4587190,277020
2008-01-01,Hawaii,972401,642461,622234,20227
2008-01-01,Idaho,1125010,748021,716262,31759
2008-01-01,Illinois,9782110,6665726,6248036,417690
2008-01-01,Indiana,4858075,3205507,3032465,173042
2008-01-01,Iowa,2313758,1663105,1588198,74907
2008-01-01,Kansas,2104656,1479049,1412114,66935
2008-01-01,Kentucky,3293294,2015015,1895688,119327
2008-01-01,Louisiana,3328228,2021945,1931104,90841
2008-01-01,Maine,1060238,693749,655269,38480
2008-01-01,Maryland,4342905,2986942,2871579,115363
2008-01-01,Massachusetts,5161571,3424276,3245010,179266
2008-01-01,Michigan,7775722,4923092,4541731,381361
2008-01-01,Minnesota,4034155,2878621,2718407,160214
2008-01-01,Mississippi,2180462,1295451,1212181,83270
2008-01-01,Missouri,4557530,3040242,2858403,181839
2008-01-01,Montana,755967,504946,480524,24422
2008-01-01,Nebraska,1347708,976129,943527,32602
2008-01-01,Nevada,1961491,1361703,1282920,78783
2008-01-01,Ohio,8918397,5950827,5574913,375914
2008-01-01,Oklahoma,2731019,1714409,1651143,63266
2008-01-01,Oregon,2951299,1912606,1799626,112980
2008-01-01,Pennsylvania,9863659,6380089,6036966,343123
2008-01-01,Tennessee,4795355,3033431,2857673,175758
2008-01-01,Texas,17582139,11521768,10984265,537503
2008-01-01,Utah,1914712,1386365,1343002,43363
2008-01-01,Vermont,503680,351566,334847,16719
2008-01-01,Virginia,5895643,4060419,3895571,164848
2008-01-01,Washington,5051757,3438496,3257136,181360
2008-01-01,Wisconsin,4375769,3068771,2911655,157116
2008-01-01,Wyoming,407544,292482,282176,10306
2008-02-01,Alabama,3579499,2163864,2055573,108291
2008-02-01,Alaska,499046,348615,323492,25123
2008-02-01,Arizona,4830910,3038659,2910949,127710
2008-02-01,Arkansas,2179102,1340541,1267086,73455
2008-02-01,California,27479147,18001749,16872625,1129124
2008-02-01,Colorado,3739334,2714527,2589465,125062
2008-02-01,Connecticut,2719672,1850212,1751907,98305
2008-02-01,Delaware,674570,446966,427244,19722
2008-02-01,Florida,14430272,9084185,8699548,384637
2008-02-01,Georgia,7154305,4852357,4574865,277492
2008-02-01,Hawaii,972875,637743,618514,19229
2008-02-01,Idaho,1126616,745894,715177,30717
2008-02-01,Illinois,9786404,6653392,6249183,404209
2008-02-01,Indiana,4860492,3199266,3022083,177183
2008-02-01,Iowa,2314422,1661064,1590707,70357
2008-02-01,Kansas,2105468,1477818,1413285,64533
2008-02-01,Kentucky,3295867,2007387,1886041,121346
2008-02-01,Louisiana,3332810,2016983,1942340,74643
2008-02-01,Maine,1060512,689872,651926,37946
2008-02-01,Maryland,4344772,2977853,2863851,114002
2008-02-01,Massachusetts,5164974,3416342,3243722,172620
2008-02-01,Michigan,7773898,4903718,4532956,370762
2008-02-01,Minnesota,4036544,2873431,2717791,155640
2008-02-01,Mississippi,2181475,1287336,1210398,76938
2008-02-01,Missouri,4560490,3032754,2851832,180922
2008-02-01,Montana,756618,505395,481697,23698
2008-02-01,Nebraska,1348302,976687,944888,31799
2008-02-01,Nevada,1964358,1364518,1288436,76082
2008-02-01,Ohio,8919307,5943486,5583742,359744
2008-02-01,Oklahoma,2732742,1710993,1652651,58342
2008-02-01,Oregon,2954500,1910871,1799811,111060
2008-02-01,Pennsylvania,9866910,6344329,5999969,344360
2008-02-01,Tennessee,4799873,3026010,2850581,175429
2008-02-01,Texas,17609205,11498916,10997614,501302
2008-02-01,Utah,1918073,1382877,1338695,44182
2008-02-01,Vermont,503793,350347,334314,16033
2008-02-01,Virginia,5900482,4065217,3903028,162189
2008-02-01,Washington,5057807,3444741,3261711,183030
2008-02-01,Wisconsin,4377602,3073998,2907769,166229
2008-02-01,Wyoming,408100,291892,282444,9448
2008-03-01,Alabama,3582052,2171070,2064940,106130
2008-03-01,Alaska,499412,350997,326202,24795
2008-03-01,Arizona,4839400,3054422,2921692,132730
2008-03-01,Arkansas,2180553,1349088,1281414,67674
2008-03-01,California,27505162,18044280,16866360,1177920
2008-03-01,Colorado,3745254,2716379,2592499,123880
2008-03-01,Connecticut,2721142,1855747,1758615,97132
2008-03-01,Delaware,675366,450546,431364,19182
2008-03-01,Florida,14439993,9117039,8716635,400404
2008-03-01,Georgia,7163749,4887091,4608883,278208
2008-03-01,Hawaii,973332,642928,623642,19286
2008-03-01,Idaho,1128349,747704,717343,30361
2008-03-01,Illinois,9791250,6677031,6284512,392519
2008-03-01,Indiana,4863316,3213536,3035017,178519
2008-03-01,Iowa,2315303,1664719,1595481,69238
2008-03-01,Kansas,2106418,1479530,1414922,64608
2008-03-01,Kentucky,3298681,2021430,1898074,123356
2008-03-01,Louisiana,3337626,2039141,1957138,82003
2008-03-01,Maine,1060902,693010,655388,37622
2008-03-01,Maryland,4346938,2998421,2885739,112682
2008-03-01,Massachusetts,5168747,3434825,3265410,169415
2008-03-01,Michigan,7772766,4918175,4539531,378644
2008-03-01,Minnesota,4039257,2885044,2724953,160091
2008-03-01,Mississippi,2182554,1294383,1217862,76521
2008-03-01,Missouri,4563774,3045730,2865340,180390
2008-03-01,Montana,757375,508556,484459,24097
2008-03-01,Nebraska,1348963,981179,949854,31325
2008-03-01,Nevada,1967341,1365034,1286687,78347
2008-03-01,Ohio,8920917,5953134,5591583,361551
2008-03-01,Oklahoma,2734661,1720792,1666123,54669
2008-03-01,Oregon,2957914,1921315,1808883,112432
2008-03-01,Pennsylvania,9870932,6352367,6021556,330811
2008-03-01,Tennessee,4804746,3032584,2858431,174153
2008-03-01,Texas,17636630,11546621,11047823,498798
2008-03-01,Utah,1921544,1383406,1339677,43729
2008-03-01,Vermont,503985,351155,334675,16480
2008-03-01,Virginia,5905631,4100116,3938241,161875
2008-03-01,Washington,5064189,3453807,3277378,176429
2008-03-01,Wisconsin,4379735,3079088,2919931,159157
2008-03-01,Wyoming,408662,293486,284153,9333
2008-04-01,Alabama,3584693,2173278,2079349,93929
2008-04-01,Alaska,499825,350296,327613,22683
2008-04-01,Arizona,4848008,3051035,2921043,129992
2008-04-01,Arkansas,2182082,1353945,1292843,61102
2008-04-01,California,27532092,18023973,16933417,1090556
2008-04-01,Colorado,3751342,2714786,2599173,115613
2008-04-01,Connecticut,2722664,1855755,1769576,86179
2008-04-01,Delaware,676171,451762,433829,17933
2008-04-01,Florida,14449961,9123684,8723110,400574
2008-04-01,Georgia,7173457,4884134,4617680,266454
2008-04-01,Hawaii,973900,645090,624266,20824
2008-04-01,Idaho,1130104,753307,720398,32909
2008-04-01,Illinois,9796390,6663820,6297699,366121
2008-04-01,Indiana,4866256,3221631,3069162,152469
2008-04-01,Iowa,2316272,1672320,1612140,60180
2008-04-01,Kansas,2107403,1482300,1426406,55894
2008-04-01,Kentucky,3301623,2027319,1918082,109237
2008-04-01,Louisiana,3342530,2048052,1975577,72475
2008-04-01,Maine,1061310,695562,661053,34509
2008-04-01,Maryland,4349192,3002867,2898403,104464
2008-04-01,Massachusetts,5172601,3426910,3277468,149442
2008-04-01,Michigan,7771825,4873653,4536037,337616
2008-04-01,Minnesota,4042105,2891108,2747630,143478
2008-04-01,Mississippi,2183705,1294829,1224533,70296
2008-04-01,Missouri,4567221,3054822,2904860,149962
2008-04-01,Montana,758116,507846,487163,20683
2008-04-01,Nebraska,1349702,988177,960148,28029
2008-04-01,Nevada,1970300,1365736,1287781,77955
2008-04-01,Ohio,8922741,5978606,5651090,327516
2008-04-01,Oklahoma,2736623,1725545,1676979,48566
2008-04-01,Oregon,2961357,1920971,1821728,99243
2008-04-01,Pennsylvania,9875143,6377210,6085929,291281
2008-04-01,Tennessee,4809741,3041390,2880485,160905
2008-04-01,Texas,17664569,11595144,11140125,455019
2008-04-01,Utah,1925126,1379534,1341296,38238
2008-04-01,Vermont,504134,349239,333554,15685
2008-04-01,Virginia,5910973,4115145,3973644,141501
2008-04-01,Washington,5070675,3445283,3289467,155816
2008-04-01,Wisconsin,4381983,3081283,2940069,141214
2008-04-01,Wyoming,409212,293205,285034,8171
2008-05-01,Alabama,3587446,2175799,2066345,109454
2008-05-01,Alaska,500225,356809,333751,23058
2008-05-01,Arizona,4856783,3069969,2917192,152777
2008-05-01,Arkansas,2183726,1364377,1294834,69543
2008-05-01,California,27559044,18081530,16922259,1159271
2008-05-01,Colorado,3757482,2719042,2597122,121920
2008-05-01,Connecticut,2724259,1880045,1779424,100621
2008-05-01,Delaware,677046,449038,430199,18839
2008-05-01,Florida,14460689,9181636,8722619,459017
2008-05-01,Georgia,7183238,4912439,4614187,298252
2008-05-01,Hawaii,974398,643285,620485,22800
2008-05-01,Idaho,1131924,760050,727577,32473
2008-05-01,Illinois,9801672,6672611,6266697,405914
2008-05-01,Indiana,4869426,3249806,3082887,166919
2008-05-01,Iowa,2317378,1675817,1615366,60451
2008-05-01,Kansas,2108535,1487030,1421996,65034
2008-05-01,Kentucky,3304688,2039768,1920020,119748
2008-05-01,Louisiana,3347495,2052130,1969772,82358
2008-05-01,Maine,1061827,698553,663413,35140
2008-05-01,Maryland,4351442,3021241,2899222,122019
2008-05-01,Massachusetts,5176718,3432458,3264680,167778
2008-05-01,Michigan,7771115,4944749,4554579,390170
2008-05-01,Minnesota,4045132,2904120,2761695,142425
2008-05-01,Mississippi,2184868,1304101,1217781,86320
2008-05-01,Missouri,4570847,3071195,2898357,172838
2008-05-01,Montana,758910,512842,492666,20176
2008-05-01,Nebraska,1350512,991423,961448,29975
2008-05-01,Nevada,1973333,1372658,1289311,83347
2008-05-01,Ohio,8924889,6016212,5655456,360756
2008-05-01,Oklahoma,2738669,1738703,1679282,59421
2008-05-01,Oregon,2965016,1922647,1823822,98825
2008-05-01,Pennsylvania,9879825,6438998,6117367,321631
2008-05-01,Tennessee,4814888,3051186,2869915,181271
2008-05-01,Texas,17692809,11619987,11111796,508191
2008-05-01,Utah,1928810,1384784,1344517,40267
2008-05-01,Vermont,504303,351050,335992,15058
2008-05-01,Virginia,5916469,4139074,3973627,165447
2008-05-01,Washington,5077412,3458377,3286429,171948
2008-05-01,Wisconsin,4384483,3080196,2945908,134288
2008-05-01,Wyoming,409806,294286,286434,7852
2008-06-01,Alabama,3590424,2196754,2064944,131810
2008-06-01,Alaska,500654,362606,339165,23441
2008-06-01,Arizona,4865847,3100618,2919890,180728
2008-06-01,Arkansas,2185440,1377817,1304120,73697
2008-06-01,California,27587706,18196219,16917578,1278641
2008-06-01,Colorado,3763867,2753333,2617933,135400
2008-06-01,Connecticut,2726025,1901279,1794805,106474
2008-06-01,Delaware,677885,454325,431976,22349
2008-06-01,Florida,14472206,9202129,8682443,519686
2008-06-01,Georgia,7193494,4939373,4610852,328521
2008-06-01,Hawaii,974980,647993,619130,28863
2008-06-01,Idaho,1133789,770197,734539,35658
2008-06-01,Illinois,9807583,6749152,6286323,462829
2008-06-01,Indiana,4872865,3286126,3099182,186944
2008-06-01,Iowa,2318576,1692597,1623726,68871
2008-06-01,Kansas,2109796,1509095,1440763,68332
2008-06-01,Kentucky,3307933,2067879,1933674,134205
2008-06-01,Louisiana,3352675,2091995,1983803,108192
2008-06-01,Maine,1062361,714463,679462,35001
2008-06-01,Maryland,4354007,3059497,2919367,140130
2008-06-01,Massachusetts,5181107,3507265,3323080,184185
2008-06-01,Michigan,7770857,4988090,4583744,404346
2008-06-01,Minnesota,4048438,2938595,2781757,156838
2008-06-01,Mississippi,2186207,1310975,1213204,97771
2008-06-01,Missouri,4574724,3109330,2924194,185136
2008-06-01,Montana,759760,519660,496424,23236
2008-06-01,Nebraska,1351414,1000043,965835,34208
2008-06-01,Nevada,1976466,1375428,1284833,90595
2008-06-01,Ohio,8927562,6077583,5672538,405045
2008-06-01,Oklahoma,2740965,1758769,1691595,67174
2008-06-01,Oregon,2968804,1947957,1836634,111323
2008-06-01,Pennsylvania,9885062,6498396,6154255,344141
2008-06-01,Tennessee,4820351,3092079,2882504,209575
2008-06-01,Texas,17722244,11707776,11124638,583138
2008-06-01,Utah,1932599,1394101,1346669,47432
2008-06-01,Vermont,504558,358414,342397,16017
2008-06-01,Virginia,5922288,4178383,3999229,179154
2008-06-01,Washington,5084384,3491773,3314534,177239
2008-06-01,Wisconsin,4387249,3142618,2988593,154025
2008-06-01,Wyoming,410427,301174,292433,8741
2008-07-01,Alabama,3593293,2191553,2056365,135188
2008-07-01,Alaska,501082,365309,343949,21360
2008-07-01,Arizona,4874841,3111565,2915771,195794
2008-07-01,Arkansas,2187167,1377927,1301313,76614
2008-07-01,California,27615732,18308123,16913099,1395024
2008-07-01,Colorado,3770226,2764431,2627702,136729
2008-07-01,Connecticut,2727747,1917120,1802824,114296
2008-07-01,Delaware,678769,455445,431820,23625
2008-07-01,Florida,14483564,9252548,8683269,569279
2008-07-01,Georgia,7203540,4979495,4632574,346921
2008-07-01,Hawaii,975546,647616,620836,26780
2008-07-01,Idaho,1135675,773611,736056,37555
2008-07-01,Illinois,9813237,6740968,6281188,459780
2008-07-01,Indiana,4876173,3299115,3100085,199030
2008-07-01,Iowa,2319771,1703341,1633219,70122
2008-07-01,Kansas,2110980,1516466,1439869,76597
2008-07-01,Kentucky,3311128,2056648,1920321,136327
2008-07-01,Louisiana,3357744,2095783,1990043,105740
2008-07-01,Maine,1062884,722486,686394,36092
2008-07-01,Maryland,4356418,3089427,2943965,145462
2008-07-01,Massachusetts,5185422,3533663,3340122,193541
2008-07-01,Michigan,7770438,4984048,4544607,439441
2008-07-01,Minnesota,4051642,2955274,2796187,159087
2008-07-01,Mississippi,2187453,1310025,1210404,99621
2008-07-01,Missouri,4578539,3113390,2911223,202167
2008-07-01,Montana,760598,522332,499980,22352
2008-07-01,Nebraska,1352261,1002891,968168,34723
2008-07-01,Nevada,1979594,1383013,1286665,96348
2008-07-01,Ohio,8930028,6099438,5673786,425652
2008-07-01,Oklahoma,2743144,1751718,1688447,63271
2008-07-01,Oregon,2972578,1973007,1850494,122513
2008-07-01,Pennsylvania,9890101,6546880,6182035,364845
2008-07-01,Tennessee,4825694,3098462,2882307,216155
2008-07-01,Texas,17751353,11768476,11157692,610784
2008-07-01,Utah,1936350,1396731,1350213,46518
2008-07-01,Vermont,504770,358983,343076,15907
2008-07-01,Virginia,5927975,4213526,4026853,186673
2008-07-01,Washington,5091309,3512238,3329725,182513
2008-07-01,Wisconsin,4389936,3142809,2993385,149424
2008-07-01,Wyoming,411048,301683,293540,8143
2008-08-01,Alabama,3596204,2180865,2041469,139396
2008-08-01,Alaska,502170,363125,342770,20355
2008-08-01,Arizona,4882204,3121536,2909915,211621
2008-08-01,Arkansas,2188840,1365996,1292280,73716
2008-08-01,California,27647757,18274056,16851497,1422559
2008-08-01,Colorado,3776709,2748977,2613997,134980
2008-08-01,Connecticut,2729782,1891427,1776367,115060
2008-08-01,Delaware,679481,453150,427765,25385
2008-08-01,Florida,14494359,9216232,8615504,600728
2008-08-01,Georgia,7212743,4942885,4589457,353428
2008-08-01,Hawaii,976125,642084,614541,27543
2008-08-01,Idaho,1137065,765604,727240,38364
2008-08-01,Illinois,9820037,6656400,6201968,454432
2008-08-01,Indiana,4879459,3273986,3078174,195812
2008-08-01,Iowa,2321258,1686407,1615714,70693
2008-08-01,Kansas,2112793,1491192,1417670,73522
2008-08-01,Kentucky,3312948,2045809,1911979,133830
2008-08-01,Louisiana,3360884,2083664,1976488,107176
2008-08-01,Maine,1063209,718616,684354,34262
2008-08-01,Maryland,4360469,3052224,2905119,147105
2008-08-01,Massachusetts,5190727,3522773,3333702,189071
2008-08-01,Michigan,7771436,4946353,4533797,412556
2008-08-01,Minnesota,4054892,2938349,2781111,157238
2008-08-01,Mississippi,2188782,1288770,1197924,90846
2008-08-01,Missouri,4581836,3074578,2869375,205203
2008-08-01,Montana,761268,520314,497165,23149
2008-08-01,Nebraska,1353373,989692,957926,31766
2008-08-01,Nevada,1981608,1377173,1276651,100522
2008-08-01,Ohio,8933289,6064016,5648452,415564
2008-08-01,Oklahoma,2746239,1746409,1683974,62435
2008-08-01,Oregon,2976099,1977591,1851833,125758
2008-08-01,Pennsylvania,9895782,6514491,6151174,363317
2008-08-01,Tennessee,4829913,3074063,2864788,209275
2008-08-01,Texas,17783166,11738660,11121466,617194
2008-08-01,Utah,1939685,1388983,1339998,48985
2008-08-01,Vermont,505023,356766,340961,15805
2008-08-01,Virginia,5934957,4160058,3971059,188999
2008-08-01,Washington,5099238,3501805,3316461,185344
2008-08-01,Wisconsin,4392873,3118411,2970183,148228
2008-08-01,Wyoming,411744,299696,291824,7872
2008-09-01,Alabama,3598993,2167438,2031777,135661
2008-09-01,Alaska,503222,356235,335864,20371
2008-09-01,Arizona,4889372,3137745,2925741,212004
2008-09-01,Arkansas,2190470,1365117,1293166,71951
2008-09-01,California,27679019,18277943,16877449,1400494
2008-09-01,Colorado,3783064,2747474,2616750,130724
2008-09-01,Connecticut,2731705,1880157,1770941,109216
2008-09-01,Delaware,680178,445499,421215,24284
2008-09-01,Florida,14504739,9208002,8600083,607919
2008-09-01,Georgia,7221664,4785759,4433563,352196
2008-09-01,Hawaii,976705,637589,607864,29725
2008-09-01,Idaho,1138405,761916,723725,38191
2008-09-01,Illinois,9826546,6600658,6175159,425499
2008-09-01,Indiana,4882575,3244607,3059798,184809
2008-09-01,Iowa,2322671,1692571,1625215,67356
2008-09-01,Kansas,2114526,1493514,1424486,69028
2008-09-01,Kentucky,3314652,2035150,1900964,134186
2008-09-01,Louisiana,3363894,2087436,1974085,113351
2008-09-01,Maine,1063497,699698,665175,34523
2008-09-01,Maryland,4364380,3025545,2883441,142104
2008-09-01,Massachusetts,5195775,3459577,3267793,191784
2008-09-01,Michigan,7772172,4891598,4490912,400686
2008-09-01,Minnesota,4058030,2922601,2770777,151824
2008-09-01,Mississippi,2190044,1287341,1198665,88676
2008-09-01,Missouri,4584996,3057685,2866017,191668
2008-09-01,Montana,761925,513454,491136,22318
2008-09-01,Nebraska,1354435,981524,950168,31356
2008-09-01,Nevada,1983560,1377645,1275374,102271
2008-09-01,Ohio,8936246,6001656,5595541,406115
2008-09-01,Oklahoma,2749269,1753088,1692845,60243
2008-09-01,Oregon,2979483,1968649,1849522,119127
2008-09-01,Pennsylvania,9901160,6454717,6134802,319915
2008-09-01,Tennessee,4834013,3068209,2858845,209364
2008-09-01,Texas,17814485,11743686,11135375,608311
2008-09-01,Utah,1942966,1382446,1338992,43454
2008-09-01,Vermont,505257,353040,336885,16155
2008-09-01,Virginia,5941756,4123240,3944843,178397
2008-09-01,Washington,5106981,3488802,3314174,174628
2008-09-01,Wisconsin,4395671,3091792,2957766,134026
2008-09-01,Wyoming,412444,298726,291305,7421
2008-10-01,Alabama,3601896,2185944,2041420,144524
2008-10-01,Alaska,504284,354082,332616,21466
2008-10-01,Arizona,4896695,3140969,2926334,214635
2008-10-01,Arkansas,2192094,1363323,1291255,72068
2008-10-01,California,27710666,18347099,16877620,1469479
2008-10-01,Colorado,3789510,2752078,2611948,140130
2008-10-01,Connecticut,2733733,1891158,1779628,111530
2008-10-01,Delaware,680882,450301,424547,25754
2008-10-01,Florida,14515421,9198079,8581355,616724
2008-10-01,Georgia,7230835,4768491,4397513,370978
2008-10-01,Hawaii,977292,636362,606930,29432
2008-10-01,Idaho,1139803,764572,723451,41121
2008-10-01,Illinois,9833265,6596688,6157300,439388
2008-10-01,Indiana,4885822,3260136,3061774,198362
2008-10-01,Iowa,2324167,1700463,1634310,66153
2008-10-01,Kansas,2116326,1501888,1431730,70158
2008-10-01,Kentucky,3316457,2041229,1904366,136863
2008-10-01,Louisiana,3366976,2092028,1985009,107019
2008-10-01,Maine,1063777,704383,667631,36752
2008-10-01,Maryland,4368415,3047661,2893127,154534
2008-10-01,Massachusetts,5200987,3482436,3293513,188923
2008-10-01,Michigan,7773056,4893324,4484157,409167
2008-10-01,Minnesota,4061267,2933165,2783602,149563
2008-10-01,Mississippi,2191391,1285943,1199471,86472
2008-10-01,Missouri,4588232,3067709,2875596,192113
2008-10-01,Montana,762562,513370,488693,24677
2008-10-01,Nebraska,1355531,990564,958647,31917
2008-10-01,Nevada,1985545,1381406,1273913,107493
2008-10-01,Ohio,8939361,6021912,5616506,405406
2008-10-01,Oklahoma,2752323,1762121,1695034,67087
2008-10-01,Oregon,2982987,1977283,1846154,131129
2008-10-01,Pennsylvania,9906713,6471603,6135871,335732
2008-10-01,Tennessee,4838191,3082565,2871180,211385
2008-10-01,Texas,17846170,11784017,11175729,608288
2008-10-01,Utah,1946306,1382891,1338714,44177
2008-10-01,Vermont,505508,355873,341507,14366
2008-10-01,Virginia,5948680,4143426,3962680,180746
2008-10-01,Washington,5114846,3493987,3311993,181994
2008-10-01,Wisconsin,4398555,3104349,2962944,141405
2008-10-01,Wyoming,413128,299297,291311,7986
2008-11-01,Alabama,3604408,2176875,2026957,149918
2008-11-01,Alaska,505353,353514,330417,23097
2008-11-01,Arizona,4903496,3138518,2919148,219370
2008-11-01,Arkansas,2193563,1354782,1277695,77087
2008-11-01,California,27740241,18312452,16767603,1544849
2008-11-01,Colorado,3795646,2733332,2589363,143969
2008-11-01,Connecticut,2735434,1885383,1772973,112410
2008-11-01,Delaware,681538,448991,423501,25490
2008-11-01,Florida,14524347,9102749,8471790,630959
2008-11-01,Georgia,7239404,4764853,4387919,376934
2008-11-01,Hawaii,977913,638351,606621,31730
2008-11-01,Idaho,1141084,763475,713357,50118
2008-11-01,Illinois,9839056,6589890,6140432,449458
2008-11-01,Indiana,4888584,3249481,3026072,223409
2008-11-01,Iowa,2325378,1689016,1618030,70986
2008-11-01,Kansas,2117869,1503629,1432715,70914
2008-11-01,Kentucky,3317952,2046820,1901931,144889
2008-11-01,Louisiana,3369760,2081415,1978784,102631
2008-11-01,Maine,1063982,697013,654984,42029
2008-11-01,Maryland,4372021,3039866,2877092,162774
2008-11-01,Massachusetts,5205636,3479526,3281180,198346
2008-11-01,Michigan,7773150,4873535,4445525,428010
2008-11-01,Minnesota,4064091,2928129,2765275,162854
2008-11-01,Mississippi,2192508,1281055,1195329,85726
2008-11-01,Missouri,4591041,3057729,2851958,205771
2008-11-01,Montana,763186,511184,483532,27652
2008-11-01,Nebraska,1356466,988961,957112,31849
2008-11-01,Nevada,1987408,1377445,1264023,113422
2008-11-01,Ohio,8941524,5978235,5560657,417578
2008-11-01,Oklahoma,2755121,1759268,1689805,69463
2008-11-01,Oregon,2986162,1968375,1822767,145608
2008-11-01,Pennsylvania,9911055,6454880,6095480,359400
2008-11-01,Tennessee,4841978,3067374,2846607,220767
2008-11-01,Texas,17876599,11820882,11191568,629314
2008-11-01,Utah,1949504,1378553,1333345,45208
2008-11-01,Vermont,505734,355875,339300,16575
2008-11-01,Virginia,5955076,4125423,3934153,191270
2008-11-01,Washington,5122196,3483545,3287154,196391
2008-11-01,Wisconsin,4401027,3104376,2942741,161635
2008-11-01,Wyoming,413791,297655,288800,8855
2008-12-01,Alabama,3606592,2167330,2004401,162929
2008-12-01,Alaska,506307,354332,329696,24636
2008-12-01,Arizona,4909739,3138010,2900593,237417
2008-12-01,Arkansas,2194791,1346696,1258826,87870
2008-12-01,California,27766504,18302848,16631061,1671787
2008-12-01,Colorado,3801345,2732610,2574383,158227
2008-12-01,Connecticut,2736850,1870498,1753306,117192
2008-12-01,Delaware,682121,448482,420467,28015
2008-12-01,Florida,14531697,9063868,8409975,653893
2008-12-01,Georgia,7247260,4777617,4362800,414817
2008-12-01,Hawaii,978390,636810,604138,32672
2008-12-01,Idaho,1142231,761765,706811,54954
2008-12-01,Illinois,9843756,6568975,6077656,491319
2008-12-01,Indiana,4890861,3234280,2976411,257869
2008-12-01,Iowa,2326326,1685087,1597398,87689
2008-12-01,Kansas,2119222,1498863,1424303,74560
2008-12-01,Kentucky,3319100,2054245,1884155,170090
2008-12-01,Louisiana,3372245,2065730,1959973,105757
2008-12-01,Maine,1064068,695748,648241,47507
2008-12-01,Maryland,4375176,3033664,2857194,176470
2008-12-01,Massachusetts,5209753,3470824,3251910,218914
2008-12-01,Michigan,7772501,4849030,4371409,477621
2008-12-01,Minnesota,4066483,2921155,2729691,191464
2008-12-01,Mississippi,2193422,1280289,1184544,95745
2008-12-01,Missouri,4593380,3057845,2830043,227802
2008-12-01,Montana,763677,507439,475666,31773
2008-12-01,Nebraska,1357295,983176,947916,35260
2008-12-01,Nevada,1989039,1375519,1248870,126649
2008-12-01,Ohio,8942768,5944503,5484943,459560
2008-12-01,Oklahoma,2757591,1748813,1673031,75782
2008-12-01,Oregon,2988988,1957200,1791803,165397
2008-12-01,Pennsylvania,9914426,6443474,6046417,397057
2008-12-01,Tennessee,4845237,3061992,2821804,240188
2008-12-01,Texas,17904835,11786983,11137898,649085
2008-12-01,Utah,1952476,1387080,1317614,69466
2008-12-01,Vermont,505873,355523,337592,17931
2008-12-01,Virginia,5960915,4119036,3909742,209294
2008-12-01,Washington,5129048,3475662,3253806,221856
2008-12-01,Wisconsin,4402985,3099479,2909539,189940
2008-12-01,Wyoming,414409,295849,285451,10398
2009-01-01,Alabama,3608960,2153660,1960038,193622
2009-01-01,Alaska,507364,352585,323679,28906
2009-01-01,Arizona,4916200,3126349,2866590,259759
2009-01-01,Arkansas,2196134,1336113,1230187,105926
2009-01-01,California,27794667,18259781,16348170,1911611
2009-01-01,Colorado,3807212,2724768,2531025,193743
2009-01-01,Connecticut,2738401,1869865,1724366,145499
2009-01-01,Delaware,682762,445695,410669,35026
2009-01-01,Florida,14539769,8992390,8266272,726118
2009-01-01,Georgia,7255557,4767806,4312975,454831
2009-01-01,Hawaii,978992,635102,596940,38162
2009-01-01,Idaho,1143426,761008,691461,69547
2009-01-01,Illinois,9849030,6535038,5950282,584756
2009-01-01,Indiana,4893292,3239786,2911395,328391
2009-01-01,Iowa,2327391,1678482,1564950,113532
2009-01-01,Kansas,2120640,1498833,1404685,94148
2009-01-01,Kentucky,3320357,2048611,1836431,212180
2009-01-01,Louisiana,3374902,2047208,1918060,129148
2009-01-01,Maine,1064171,692102,632492,59610
2009-01-01,Maryland,4378599,3028310,2813420,214890
2009-01-01,Massachusetts,5214072,3454264,3183753,270511
2009-01-01,Michigan,7772160,4828873,4262788,566085
2009-01-01,Minnesota,4068989,2911074,2674318,236756
2009-01-01,Mississippi,2194462,1268317,1159299,109018
2009-01-01,Missouri,4595874,3043481,2779842,263639
2009-01-01,Montana,764203,503080,463369,39711
2009-01-01,Nebraska,1358167,977667,932093,45574
2009-01-01,Nevada,1990788,1371623,1230528,141095
2009-01-01,Ohio,8944394,5882414,5322286,560128
2009-01-01,Oklahoma,2760215,1745793,1650484,95309
2009-01-01,Oregon,2991928,1956031,1749343,206688
2009-01-01,Pennsylvania,9918169,6436433,5941896,494537
2009-01-01,Tennessee,4848693,3033730,2750960,282770
2009-01-01,Texas,17934287,11738304,10980730,757574
2009-01-01,Utah,1955576,1384553,1295976,88577
2009-01-01,Vermont,506066,356225,333875,22350
2009-01-01,Virginia,5967043,4106211,3849099,257112
2009-01-01,Washington,5136093,3467678,3203743,263935
2009-01-01,Wisconsin,4405116,3096041,2845413,250628
2009-01-01,Wyoming,415020,295414,280556,14858
2009-02-01,Alabama,3611025,2161777,1956754,205023
2009-02-01,Alaska,508336,355044,324562,30482
2009-02-01,Arizona,4922302,3123154,2856660,266494
2009-02-01,Arkansas,2197249,1352504,1242434,110070
2009-02-01,California,27820364,18341910,16346151,1995759
2009-02-01,Colorado,3812882,2733979,2524262,209717
2009-02-01,Connecticut,2739720,1869976,1720050,149926
2009-02-01,Delaware,683309,444199,407478,36721
2009-02-01,Florida,14546500,8942821,8209158,733663
2009-02-01,Georgia,7263209,4780854,4304255,476599
2009-02-01,Hawaii,979422,632560,592935,39625
2009-02-01,Idaho,1144528,762682,691382,71300
2009-02-01,Illinois,9853542,6554779,5924262,630517
2009-02-01,Indiana,4895465,3236384,2888392,347992
2009-02-01,Iowa,2328279,1682305,1567507,114798
2009-02-01,Kansas,2121939,1503980,1406264,97716
2009-02-01,Kentucky,3321451,2056179,1828968,227211
2009-02-01,Louisiana,3377231,2048567,1924461,124106
2009-02-01,Maine,1064193,691206,627693,63513
2009-02-01,Maryland,4381626,3028943,2800624,228319
2009-02-01,Massachusetts,5218090,3455114,3175445,279669
2009-02-01,Michigan,7771192,4850088,4254074,596014
2009-02-01,Minnesota,4071329,2918910,2667365,251545
2009-02-01,Mississippi,2195299,1270722,1160622,110100
2009-02-01,Missouri,4598092,3052369,2773403,278966
2009-02-01,Montana,764676,502363,462452,39911
2009-02-01,Nebraska,1358954,980873,936288,44585
2009-02-01,Nevada,1992370,1378995,1233107,145888
2009-02-01,Ohio,8945406,5901074,5313208,587866
2009-02-01,Oklahoma,2762668,1751943,1647428,104515
2009-02-01,Oregon,2994706,1969570,1741767,227803
2009-02-01,Pennsylvania,9921186,6430827,5897041,533786
2009-02-01,Tennessee,4851827,3038351,2740819,297532
2009-02-01,Texas,17962241,11758403,10992199,766204
2009-02-01,Utah,1958558,1386716,1289641,97075
2009-02-01,Vermont,506207,356875,334112,22763
2009-02-01,Virginia,5972693,4119048,3847442,271606
2009-02-01,Washington,5142825,3481150,3197533,283617
2009-02-01,Wisconsin,4407013,3119719,2828589,291130
2009-02-01,Wyoming,415658,295325,280093,15232
2009-03-01,Alabama,3613034,2159479,1956802,202677
2009-03-01,Alaska,509304,354978,324373,30605
2009-03-01,Arizona,4928269,3120958,2845451,275507
2009-03-01,Arkansas,2198385,1353941,1248354,105587
2009-03-01,California,27845224,18325895,16267586,2058309
2009-03-01,Colorado,3818492,2723853,2512933,210920
2009-03-01,Connecticut,2741025,1871348,1722302,149046
2009-03-01,Delaware,683851,443203,406574,36629
2009-03-01,Florida,14553015,8925733,8180881,744852
2009-03-01,Georgia,7270704,4794370,4317114,477256
2009-03-01,Hawaii,979839,632665,591786,40879
2009-03-01,Idaho,1145653,762165,690121,72044
2009-03-01,Illinois,9857938,6557701,5918560,639141
2009-03-01,Indiana,4897589,3237238,2878296,358942
2009-03-01,Iowa,2329173,1679299,1562297,117002
2009-03-01,Kansas,2123219,1501871,1403457,98414
2009-03-01,Kentucky,3322520,2070423,1837232,233191
2009-03-01,Louisiana,3379507,2055756,1926266,129490
2009-03-01,Maine,1064236,691744,627161,64583
2009-03-01,Maryland,4384547,3042450,2814449,228001
2009-03-01,Massachusetts,5222100,3461324,3182172,279152
2009-03-01,Michigan,7770196,4863138,4232324,630814
2009-03-01,Minnesota,4073662,2925116,2666294,258822
2009-03-01,Mississippi,2196101,1268926,1159317,109609
2009-03-01,Missouri,4600232,3057774,2778935,278839
2009-03-01,Montana,765161,501781,460492,41289
2009-03-01,Nebraska,1359717,983965,937238,46727
2009-03-01,Nevada,1993918,1370845,1222080,148765
2009-03-01,Ohio,8946406,5884977,5299959,585018
2009-03-01,Oklahoma,2765042,1764547,1652453,112094
2009-03-01,Oregon,2997399,1970618,1729119,241499
2009-03-01,Pennsylvania,9924198,6398265,5872082,526183
2009-03-01,Tennessee,4854945,3025654,2719947,305707
2009-03-01,Texas,17989636,11755589,10990873,764716
2009-03-01,Utah,1961510,1378772,1281914,96858
2009-03-01,Vermont,506354,358373,334818,23555
2009-03-01,Virginia,5978215,4131936,3856531,275405
2009-03-01,Washington,5149512,3469177,3186202,282975
2009-03-01,Wisconsin,4408918,3117691,2810399,307292
2009-03-01,Wyoming,416274,297647,279742,17905
2009-04-01,Alabama,3615107,2159617,1968097,191520
2009-04-01,Alaska,510314,355880,327347,28533
2009-04-01,Arizona,4934381,3126297,2853098,273199
2009-04-01,Arkansas,2199548,1361753,1262167,99586
2009-04-01,California,27871138,18292896,16321600,1971296
2009-04-01,Colorado,3824191,2739934,2526814,213120
2009-04-01,Connecticut,2742384,1866043,1726225,139818
2009-04-01,Delaware,684422,444162,409251,34911
2009-04-01,Florida,14559741,8939315,8201244,738071
2009-04-01,Georgia,7278430,4782046,4322644,459402
2009-04-01,Hawaii,980298,633948,593492,40456
2009-04-01,Idaho,1146825,754847,695156,59691
2009-04-01,Illinois,9862551,6578508,5949297,629211
2009-04-01,Indiana,4899811,3234663,2903669,330994
2009-04-01,Iowa,2330117,1677437,1575443,101994
2009-04-01,Kansas,2124509,1513224,1415486,97738
2009-04-01,Kentucky,3323639,2070825,1853669,217156
2009-04-01,Louisiana,3381899,2065695,1937578,128117
2009-04-01,Maine,1064283,694370,634218,60152
2009-04-01,Maryland,4387555,3041189,2826797,214392
2009-04-01,Massachusetts,5226156,3458563,3197563,261000
2009-04-01,Michigan,7769346,4852757,4243137,609620
2009-04-01,Minnesota,4076031,2936581,2700879,235702
2009-04-01,Mississippi,2196932,1271283,1163803,107480
2009-04-01,Missouri,4602491,3066263,2817655,248608
2009-04-01,Montana,765637,502410,466945,35465
2009-04-01,Nebraska,1360520,992352,947624,44728
2009-04-01,Nevada,1995501,1367751,1221734,146017
2009-04-01,Ohio,8947541,5888498,5322907,565591
2009-04-01,Oklahoma,2767495,1769395,1660898,108497
2009-04-01,Oregon,3000182,1971771,1746592,225179
2009-04-01,Pennsylvania,9927312,6396603,5918967,477636
2009-04-01,Tennessee,4858086,3015782,2726112,289670
2009-04-01,Texas,18017597,11801531,11085855,715676
2009-04-01,Utah,1964512,1375547,1282635,92912
2009-04-01,Vermont,506480,356360,333738,22622
2009-04-01,Virginia,5983942,4141280,3882226,259054
2009-04-01,Washington,5156239,3451510,3187976,263534
2009-04-01,Wisconsin,4410843,3119764,2828821,290943
2009-04-01,Wyoming,416861,300629,280618,20011
2009-05-01,Alabama,3617361,2158615,1954436,204179
2009-05-01,Alaska,511330,360482,331797,28685
2009-05-01,Arizona,4940746,3124374,2837284,287090
2009-05-01,Arkansas,2200846,1363152,1256271,106881
2009-05-01,California,27897359,18286367,16269519,2016848
2009-05-01,Colorado,3830099,2733606,2518188,215418
2009-05-01,Connecticut,2743885,1889221,1737945,151276
2009-05-01,Delaware,684993,440274,404820,35454
2009-05-01,Florida,14567324,9009618,8186397,823221
2009-05-01,Georgia,7286426,4796972,4312366,484606
2009-05-01,Hawaii,980763,631678,589619,42059
2009-05-01,Idaho,1148040,765111,700347,64764
2009-05-01,Illinois,9867563,6607251,5957567,649684
2009-05-01,Indiana,4902376,3257218,2908320,348898
2009-05-01,Iowa,2331259,1673991,1570172,103819
2009-05-01,Kansas,2125995,1516320,1409918,106402
2009-05-01,Kentucky,3325013,2081613,1849399,232214
2009-05-01,Louisiana,3384370,2067902,1930192,137710
2009-05-01,Maine,1064444,696400,636881,59519
2009-05-01,Maryland,4390739,3050899,2820974,229925
2009-05-01,Massachusetts,5230561,3458514,3182397,276117
2009-05-01,Michigan,7768973,4914389,4245199,669190
2009-05-01,Minnesota,4078760,2938592,2710494,228098
2009-05-01,Mississippi,2197842,1278304,1159016,119288
2009-05-01,Missouri,4605119,3078690,2808524,270166
2009-05-01,Montana,766208,503995,470153,33842
2009-05-01,Nebraska,1361436,993378,947518,45860
2009-05-01,Nevada,1997181,1371546,1218833,152713
2009-05-01,Ohio,8949202,5907154,5326301,580853
2009-05-01,Oklahoma,2770103,1782140,1657401,124739
2009-05-01,Oregon,3003209,1964701,1748217,216484
2009-05-01,Pennsylvania,9931122,6450395,5928806,521589
2009-05-01,Tennessee,4861579,3017903,2717951,299952
2009-05-01,Texas,18046180,11908611,11048917,859694
2009-05-01,Utah,1967728,1376759,1281691,95068
2009-05-01,Vermont,506662,358904,337430,21474
2009-05-01,Virginia,5989932,4157668,3876948,280720
2009-05-01,Washington,5163366,3452280,3178340,273940
2009-05-01,Wisconsin,4413190,3117681,2833606,284075
2009-05-01,Wyoming,417505,300247,281405,18842
2009-06-01,Alabama,3619629,2183673,1951985,231688
2009-06-01,Alaska,512325,367276,337281,29995
2009-06-01,Arizona,4947208,3142284,2827584,314700
2009-06-01,Arkansas,2202154,1375912,1263727,112185
2009-06-01,California,27924313,18388487,16225494,2162993
2009-06-01,Colorado,3836067,2763719,2532126,231593
2009-06-01,Connecticut,2745421,1913029,1752559,160470
2009-06-01,Delaware,685612,443652,404887,38765
2009-06-01,Florida,14575145,9031682,8132640,899042
2009-06-01,Georgia,7294421,4830293,4295739,534554
2009-06-01,Hawaii,981229,635542,588567,46975
2009-06-01,Idaho,1149304,774785,707222,67563
2009-06-01,Illinois,9872670,6716485,6009135,707350
2009-06-01,Indiana,4904977,3288931,2925269,363662
2009-06-01,Iowa,2332447,1692176,1579323,112853
2009-06-01,Kansas,2127510,1535044,1424483,110561
2009-06-01,Kentucky,3326417,2108787,1864290,244497
2009-06-01,Louisiana,3386911,2104277,1936764,167513
2009-06-01,Maine,1064612,709144,649518,59626
2009-06-01,Maryland,4393922,3088859,2842826,246033
2009-06-01,Massachusetts,5235023,3520966,3224562,296404
2009-06-01,Michigan,7768604,4972869,4248276,724593
2009-06-01,Minnesota,4081532,2967403,2718549,248854
2009-06-01,Mississippi,2198782,1285630,1157060,128570
2009-06-01,Missouri,4607694,3122645,2830770,291875
2009-06-01,Montana,766762,511135,475421,35714
2009-06-01,Nebraska,1362376,1000233,951599,48634
2009-06-01,Nevada,1998890,1374022,1209714,164308
2009-06-01,Ohio,8950933,5975857,5346139,629718
2009-06-01,Oklahoma,2772778,1801117,1672931,128186
2009-06-01,Oregon,3006279,1984699,1760955,223744
2009-06-01,Pennsylvania,9935005,6486735,5947290,539445
2009-06-01,Tennessee,4865073,3066127,2729664,336463
2009-06-01,Texas,18075211,12062534,11048285,1014249
2009-06-01,Utah,1970908,1383559,1278990,104569
2009-06-01,Vermont,506890,365327,342525,22802
2009-06-01,Virginia,5995931,4188146,3893261,294885
2009-06-01,Washington,5170538,3480158,3194500,285658
2009-06-01,Wisconsin,4415500,3180505,2875197,305308
2009-06-01,Wyoming,418196,305424,285364,20060
2009-07-01,Alabama,3622181,2173031,1941159,231872
2009-07-01,Alaska,513402,369621,342609,27012
2009-07-01,Arizona,4953939,3148784,2821305,327479
2009-07-01,Arkansas,2203656,1377127,1264855,112272
2009-07-01,California,27952375,18447916,16211350,2236566
2009-07-01,Colorado,3842322,2758656,2534394,224262
2009-07-01,Connecticut,2747122,1936263,1769378,166885
2009-07-01,Delaware,686254,441700,403826,37874
2009-07-01,Florida,14583822,9067704,8139573,928131
2009-07-01,Georgia,7302994,4846427,4311279,535148
2009-07-01,Hawaii,981756,636766,593561,43205
2009-07-01,Idaho,1150638,775026,709281,65745
2009-07-01,Illinois,9878410,6729321,6017382,711939
2009-07-01,Indiana,4907917,3247829,2901147,346682
2009-07-01,Iowa,2333773,1693006,1583174,109832
2009-07-01,Kansas,2129150,1549567,1425327,124240
2009-07-01,Kentucky,3328074,2091576,1853326,238250
2009-07-01,Louisiana,3389686,2109394,1946176,163218
2009-07-01,Maine,1064870,714629,656966,57663
2009-07-01,Maryland,4397413,3110900,2866578,244322
2009-07-01,Massachusetts,5239849,3538354,3238413,299941
2009-07-01,Michigan,7768829,4954139,4229531,724608
2009-07-01,Minnesota,4084586,2978410,2742715,235695
2009-07-01,Mississippi,2199851,1282737,1153807,128930
2009-07-01,Missouri,4610651,3113540,2821327,292213
2009-07-01,Montana,767393,511577,477812,33765
2009-07-01,Nebraska,1363415,1005197,955938,49259
2009-07-01,Nevada,2000720,1376470,1209792,166678
2009-07-01,Ohio,8953337,5984536,5358227,626309
2009-07-01,Oklahoma,2775621,1788002,1665944,122058
2009-07-01,Oregon,3009552,1994278,1777456,216822
2009-07-01,Pennsylvania,9939596,6516324,5960681,555643
2009-07-01,Tennessee,4868936,3064585,2736446,328139
2009-07-01,Texas,18105139,12110849,11076994,1033855
2009-07-01,Utah,1974253,1384015,1280572,103443
2009-07-01,Vermont,507115,366186,343936,22250
2009-07-01,Virginia,6002403,4204615,3912937,291678
2009-07-01,Washington,5178070,3489039,3202180,286859
2009-07-01,Wisconsin,4418188,3172986,2879428,293558
2009-07-01,Wyoming,418865,304300,285511,18789
2009-08-01,Alabama,3624837,2161001,1927752,233249
2009-08-01,Alaska,513656,366434,340850,25584
2009-08-01,Arizona,4961060,3147171,2816399,330772
2009-08-01,Arkansas,2205479,1356455,1253878,102577
2009-08-01,California,27986270,18361060,16157394,2203666
2009-08-01,Colorado,3847562,2745058,2528953,216105
2009-08-01,Connecticut,2749085,1908947,1742636,166311
2009-08-01,Delaware,686972,438138,400535,37603
2009-08-01,Florida,14599431,9032197,8094288,937909
2009-08-01,Georgia,7312496,4795968,4274605,521363
2009-08-01,Hawaii,982384,631605,588886,42719
2009-08-01,Idaho,1151866,766369,702163,64206
2009-08-01,Illinois,9884709,6631698,5938509,693189
2009-08-01,Indiana,4911180,3207323,2878679,328644
2009-08-01,Iowa,2335284,1677874,1570798,107076
2009-08-01,Kansas,2130871,1512736,1402390,110346
2009-08-01,Kentucky,3330802,2064594,1842725,221869
2009-08-01,Louisiana,3392730,2079646,1925106,154540
2009-08-01,Maine,1065143,712275,658438,53837
2009-08-01,Maryland,4401975,3068376,2831995,236381
2009-08-01,Massachusetts,5244207,3516972,3229564,287408
2009-08-01,Michigan,7770891,4896760,4231473,665287
2009-08-01,Minnesota,4087541,2948897,2720936,227961
2009-08-01,Mississippi,2201059,1262038,1140468,121570
2009-08-01,Missouri,4613947,3070934,2782246,288688
2009-08-01,Montana,767959,507830,474727,33103
2009-08-01,Nebraska,1364635,991809,945113,46696
2009-08-01,Nevada,2002267,1368439,1200743,167696
2009-08-01,Ohio,8956374,5936354,5335779,600575
2009-08-01,Oklahoma,2778180,1778645,1656200,122445
2009-08-01,Oregon,3012625,1981053,1770794,210259
2009-08-01,Pennsylvania,9945029,6436501,5901406,535095
2009-08-01,Tennessee,4873515,3027656,2714185,313471
2009-08-01,Texas,18134768,12049532,11041017,1008515
2009-08-01,Utah,1977352,1377447,1271190,106257
2009-08-01,Vermont,507430,363235,341574,21661
2009-08-01,Virginia,6009725,4150113,3859239,290874
2009-08-01,Washington,5185004,3470152,3178421,291731
2009-08-01,Wisconsin,4420667,3137830,2855117,282713
2009-08-01,Wyoming,419192,301994,283943,18051
2009-09-01,Alabama,3627477,2142066,1912064,230002
2009-09-01,Alaska,513872,360616,333778,26838
2009-09-01,Arizona,4968072,3135557,2804809,330748
2009-09-01,Arkansas,2207281,1347690,1247596,100094
2009-09-01,California,28019194,18286642,16109768,2176874
2009-09-01,Colorado,3852743,2725956,2515507,210449
2009-09-01,Connecticut,2751032,1882463,1719767,162696
2009-09-01,Delaware,687690,428969,392193,36776
2009-09-01,Florida,14615000,9012922,8061653,951269
2009-09-01,Georgia,7321947,4779933,4264724,515209
2009-09-01,Hawaii,982979,628739,583832,44907
2009-09-01,Idaho,1153087,760292,696816,63476
2009-09-01,Illinois,9890904,6577717,5880927,696790
2009-09-01,Indiana,4914475,3176445,2860620,315825
2009-09-01,Iowa,2336799,1672014,1572637,99377
2009-09-01,Kansas,2132592,1512732,1405174,107558
2009-09-01,Kentucky,3333496,2048870,1833031,215839
2009-09-01,Louisiana,3395772,2058946,1914622,144324
2009-09-01,Maine,1065440,693452,639639,53813
2009-09-01,Maryland,4406548,3033816,2805163,228653
2009-09-01,Massachusetts,5248524,3439543,3150530,289013
2009-09-01,Michigan,7772966,4823812,4184032,639780
2009-09-01,Minnesota,4090504,2912743,2695060,217683
2009-09-01,Mississippi,2202315,1258418,1138361,120057
2009-09-01,Missouri,4617243,3048175,2770493,277682
2009-09-01,Montana,768524,498627,467016,31611
2009-09-01,Nebraska,1365808,982885,936348,46537
2009-09-01,Nevada,2003771,1363372,1192238,171134
2009-09-01,Ohio,8959495,5872174,5272442,599732
2009-09-01,Oklahoma,2780669,1771346,1650243,121103
2009-09-01,Oregon,3015664,1961363,1767082,194281
2009-09-01,Pennsylvania,9950472,6349457,5852853,496604
2009-09-01,Tennessee,4878100,3015097,2704067,311030
2009-09-01,Texas,18163851,12030653,11027843,1002810
2009-09-01,Utah,1980374,1364675,1262291,102384
2009-09-01,Vermont,507724,356933,335110,21823
2009-09-01,Virginia,6017014,4105023,3814433,290590
2009-09-01,Washington,5191902,3459337,3167339,291998
2009-09-01,Wisconsin,4423136,3080183,2822323,257860
2009-09-01,Wyoming,419500,299400,281900,17500
2009-10-01,Alabama,3630337,2150175,1916261,233914
2009-10-01,Alaska,514133,357612,329187,28425
2009-10-01,Arizona,4975352,3122709,2794315,328394
2009-10-01,Arkansas,2209199,1343966,1244831,99135
2009-10-01,California,28053709,18268092,16059829,2208263
2009-10-01,Colorado,3858144,2716866,2503937,212929
2009-10-01,Connecticut,2753149,1892990,1727421,165569
2009-10-01,Delaware,688459,430176,392992,37184
2009-10-01,Florida,14631311,9005141,8049589,955552
2009-10-01,Georgia,7331829,4778178,4259538,518640
2009-10-01,Hawaii,983622,626626,583551,43075
2009-10-01,Idaho,1154366,761410,697822,63588
2009-10-01,Illinois,9897655,6589070,5878619,710451
2009-10-01,Indiana,4918039,3171007,2850614,320393
2009-10-01,Iowa,2338466,1676832,1574929,101903
2009-10-01,Kansas,2134462,1507139,1403194,103945
2009-10-01,Kentucky,3336401,2043779,1831112,212667
2009-10-01,Louisiana,3398961,2066790,1926037,140753
2009-10-01,Maine,1065788,695536,641518,54018
2009-10-01,Maryland,4411347,3042360,2808460,233900
2009-10-01,Massachusetts,5253091,3450864,3172734,278130
2009-10-01,Michigan,7775455,4809023,4190151,618872
2009-10-01,Minnesota,4093670,2919419,2708522,210897
2009-10-01,Mississippi,2203668,1255194,1133568,121626
2009-10-01,Missouri,4620808,3039491,2768100,271391
2009-10-01,Montana,769146,497258,464488,32770
2009-10-01,Nebraska,1367090,983735,939314,44421
2009-10-01,Nevada,2005462,1361396,1187988,173408
2009-10-01,Ohio,8963041,5896005,5283438,612567
2009-10-01,Oklahoma,2783333,1766230,1643556,122674
2009-10-01,Oregon,3018895,1961051,1766175,194876
2009-10-01,Pennsylvania,9956445,6320240,5838803,481437
2009-10-01,Tennessee,4882981,3027437,2718593,308844
2009-10-01,Texas,18194118,12014874,11044675,970199
2009-10-01,Utah,1983529,1362107,1258619,103488
2009-10-01,Vermont,508094,357711,337381,20330
2009-10-01,Virginia,6024651,4118315,3827243,291072
2009-10-01,Washington,5199075,3458362,3167008,291354
2009-10-01,Wisconsin,4425882,3076294,2819543,256751
2009-10-01,Wyoming,419851,299318,279816,19502
2009-11-01,Alabama,3632553,2143439,1916867,226572
2009-11-01,Alaska,514325,357744,328467,29277
2009-11-01,Arizona,4981854,3127851,2810158,317693
2009-11-01,Arkansas,2210757,1341679,1243973,97706
2009-11-01,California,28084234,18257860,16065177,2192683
2009-11-01,Colorado,3862938,2706660,2493078,213582
2009-11-01,Connecticut,2754731,1892572,1730674,161898
2009-11-01,Delaware,689092,430320,394473,35847
2009-11-01,Florida,14645036,8960646,8017527,943119
2009-11-01,Georgia,7340523,4785570,4281605,503965
2009-11-01,Hawaii,984262,630065,587605,42460
2009-11-01,Idaho,1155469,760575,692881,67694
2009-11-01,Illinois,9902704,6591558,5891805,699753
2009-11-01,Indiana,4920671,3164633,2845255,319378
2009-11-01,Iowa,2339640,1666198,1567984,98214
2009-11-01,Kansas,2135884,1505300,1405289,100011
2009-11-01,Kentucky,3338735,2050146,1843671,206475
2009-11-01,Louisiana,3401585,2065538,1933031,132507
2009-11-01,Maine,1065945,692086,635236,56850
2009-11-01,Maryland,4415406,3041309,2810686,230623
2009-11-01,Massachusetts,5256717,3456439,3183507,272932
2009-11-01,Michigan,7776472,4800617,4193326,607291
2009-11-01,Minnesota,4096104,2922125,2711658,210467
2009-11-01,Mississippi,2204638,1258687,1138880,119807
2009-11-01,Missouri,4623522,3032711,2754955,277756
2009-11-01,Montana,769618,497887,463259,34628
2009-11-01,Nebraska,1368134,984159,941841,42318
2009-11-01,Nevada,2006744,1357869,1186781,171088
2009-11-01,Ohio,8964826,5886781,5269787,616994
2009-11-01,Oklahoma,2785467,1766633,1650217,116416
2009-11-01,Oregon,3021588,1957517,1763181,194336
2009-11-01,Pennsylvania,9960433,6312994,5839762,473232
2009-11-01,Tennessee,4886991,3035287,2731517,303770
2009-11-01,Texas,18221759,12076771,11116937,959834
2009-11-01,Utah,1986362,1364472,1261983,102489
2009-11-01,Vermont,508329,359158,336781,22377
2009-11-01,Virginia,6031267,4113624,3823678,289946
2009-11-01,Washington,5205382,3449352,3144714,304638
2009-11-01,Wisconsin,4427819,3071767,2815976,255791
2009-11-01,Wyoming,420108,299666,279230,20436
2009-12-01,Alabama,3634419,2132585,1903195,229390
2009-12-01,Alaska,514467,354275,324690,29585
2009-12-01,Arizona,4987853,3101207,2783462,317745
2009-12-01,Arkansas,2212101,1329778,1226015,103763
2009-12-01,California,28111925,18154531,15935426,2219105
2009-12-01,Colorado,3867378,2694196,2464582,229614
2009-12-01,Connecticut,2756043,1867777,1703010,164767
2009-12-01,Delaware,689720,430105,392912,37193
2009-12-01,Florida,14657213,8933301,7987787,945514
2009-12-01,Georgia,7348529,4767388,4257118,510270
2009-12-01,Hawaii,984741,628342,586797,41545
2009-12-01,Idaho,1156479,759323,687331,71992
2009-12-01,Illinois,9906794,6550303,5826118,724185
2009-12-01,Indiana,4922905,3136971,2810425,326546
2009-12-01,Iowa,2340638,1655083,1545512,109571
2009-12-01,Kansas,2137157,1494120,1392035,102085
2009-12-01,Kentucky,3340801,2042764,1831168,211596
2009-12-01,Louisiana,3403890,2044761,1908112,136649
2009-12-01,Maine,1066053,689429,629947,59482
2009-12-01,Maryland,4419022,3021020,2790795,230225
2009-12-01,Massachusetts,5259886,3434256,3153437,280819
2009-12-01,Michigan,7776809,4753963,4143230,610733
2009-12-01,Minnesota,4098214,2905399,2682892,222507
2009-12-01,Mississippi,2205398,1261804,1133768,128036
2009-12-01,Missouri,4625852,3014382,2732432,281950
2009-12-01,Montana,770036,493174,455207,37967
2009-12-01,Nebraska,1369023,978007,931926,46081
2009-12-01,Nevada,2007872,1346074,1171090,174984
2009-12-01,Ohio,8965878,5842341,5207159,635182
2009-12-01,Oklahoma,2787381,1747571,1632529,115042
2009-12-01,Oregon,3023994,1947722,1741191,206531
2009-12-01,Pennsylvania,9963526,6268077,5781290,486787
2009-12-01,Tennessee,4890561,3024289,2711349,312940
2009-12-01,Texas,18247563,12022010,11063681,958329
2009-12-01,Utah,1989021,1347466,1245016,102450
2009-12-01,Vermont,508622,356093,332933,23160
2009-12-01,Virginia,6037319,4098250,3797169,301081
2009-12-01,Washington,5211219,3436362,3112788,323574
2009-12-01,Wisconsin,4429332,3059471,2785095,274376
2009-12-01,Wyoming,420366,299354,275303,24051
2010-01-01,Alabama,3636380,2128186,1878281,249905
2010-01-01,Alaska,514628,356467,323178,33289
2010-01-01,Arizona,4994110,3110508,2772644,337864
2010-01-01,Arkansas,2213503,1321348,1205297,116051
2010-01-01,California,28141513,18231618,15835465,2396153
2010-01-01,Colorado,3871967,2695219,2439576,255643
2010-01-01,Connecticut,2757497,1878043,1685560,192483
2010-01-01,Delaware,690331,429385,387802,41583
2010-01-01,Florida,14670087,8959824,7958515,1001309
2010-01-01,Georgia,7356794,4774348,4241657,532691
2010-01-01,Hawaii,985330,635894,590638,45256
2010-01-01,Idaho,1157503,758392,678252,80140
2010-01-01,Illinois,9911282,6575045,5771900,803145
2010-01-01,Indiana,4925217,3154555,2789625,364930
2010-01-01,Iowa,2341680,1656586,1533771,122815
2010-01-01,Kansas,2138455,1496355,1381658,114697
2010-01-01,Kentucky,3342861,2043308,1803413,239895
2010-01-01,Louisiana,3406282,2043441,1884797,158644
2010-01-01,Maine,1066138,687569,619336,68233
2010-01-01,Maryland,4422798,3026365,2769334,257031
2010-01-01,Massachusetts,5263246,3452596,3131597,320999
2010-01-01,Michigan,7777357,4738897,4085834,653063
2010-01-01,Minnesota,4100422,2907124,2655575,251549
2010-01-01,Mississippi,2206254,1256763,1116969,139794
2010-01-01,Missouri,4628246,3018275,2707216,311059
2010-01-01,Montana,770491,494907,451423,43484
2010-01-01,Nebraska,1370014,978470,924953,53517
2010-01-01,Nevada,2009168,1355110,1164171,190939
2010-01-01,Ohio,8967104,5836703,5134393,702310
2010-01-01,Oklahoma,2789349,1754265,1622911,131354
2010-01-01,Oregon,3026512,1957286,1727141,230145
2010-01-01,Pennsylvania,9966890,6326572,5746110,580462
2010-01-01,Tennessee,4894242,3034060,2697042,337018
2010-01-01,Texas,18274485,12067223,11028365,1038858
2010-01-01,Utah,1991747,1347813,1235440,112373
2010-01-01,Vermont,508821,357413,331030,26383
2010-01-01,Virginia,6043575,4109977,3775974,334003
2010-01-01,Washington,5217186,3446345,3095015,351330
2010-01-01,Wisconsin,4430954,3066564,2756537,310027
2010-01-01,Wyoming,420608,299391,273348,26043
2010-02-01,Alabama,3637985,2132653,1890021,242632
2010-02-01,Alaska,514760,357495,323109,34386
2010-02-01,Arizona,4999841,3105437,2777711,327726
2010-02-01,Arkansas,2214703,1333692,1217405,116287
2010-02-01,California,28168472,18307939,15928687,2379252
2010-02-01,Colorado,3876247,2701427,2444960,256467
2010-02-01,Connecticut,2758668,1879039,1687595,191444
2010-02-01,Delaware,690834,428187,386800,41387
2010-02-01,Florida,14681071,8961248,7990672,970576
2010-02-01,Georgia,7364379,4717188,4197138,520050
2010-02-01,Hawaii,985714,635574,591922,43652
2010-02-01,Idaho,1158417,760005,681134,78871
2010-02-01,Illinois,9914870,6587019,5800794,786225
2010-02-01,Indiana,4927158,3146711,2780993,365718
2010-02-01,Iowa,2342488,1661860,1542554,119306
2010-02-01,Kansas,2139596,1496287,1384204,112083
2010-02-01,Kentucky,3344688,2049877,1804949,244928
2010-02-01,Louisiana,3408339,2040030,1900030,140000
2010-02-01,Maine,1066067,688124,619217,68907
2010-02-01,Maryland,4426148,3025116,2764804,260312
2010-02-01,Massachusetts,5266159,3452906,3140363,312543
2010-02-01,Michigan,7777182,4743972,4099013,644959
2010-02-01,Minnesota,4102269,2910728,2660574,250154
2010-02-01,Mississippi,2206814,1259922,1125602,134320
2010-02-01,Missouri,4630244,3025652,2710006,315646
2010-02-01,Montana,770816,495951,453377,42574
2010-02-01,Nebraska,1370817,982672,929811,52861
2010-02-01,Nevada,2010225,1361228,1172226,189002
2010-02-01,Ohio,8967563,5841592,5149390,692202
2010-02-01,Oklahoma,2791092,1757494,1625965,131529
2010-02-01,Oregon,3028729,1967223,1735595,231628
2010-02-01,Pennsylvania,9969289,6316328,5720703,595625
2010-02-01,Tennessee,4897491,3037528,2709249,328279
2010-02-01,Texas,18299762,12107774,11092558,1015216
2010-02-01,Utah,1994390,1349090,1234858,114232
2010-02-01,Vermont,509023,357828,332086,25742
2010-02-01,Virginia,6049306,4117455,3783607,333848
2010-02-01,Washington,5222744,3453296,3103110,350186
2010-02-01,Wisconsin,4432255,3080787,2761896,318891
2010-02-01,Wyoming,420826,298909,274063,24846
2010-03-01,Alabama,3639724,2142119,1906137,235982
2010-03-01,Alaska,514896,358639,324727,33912
2010-03-01,Arizona,5005603,3109325,2788343,320982
2010-03-01,Arkansas,2215934,1341772,1232833,108939
2010-03-01,California,28195088,18335934,15955721,2380213
2010-03-01,Colorado,3880636,2709758,2448860,260898
2010-03-01,Connecticut,2759910,1885266,1697360,187906
2010-03-01,Delaware,691403,431385,391638,39747
2010-03-01,Florida,14692208,8997618,8033224,964394
2010-03-01,Georgia,7372287,4707246,4204743,502503
2010-03-01,Hawaii,986160,640298,596656,43642
2010-03-01,Idaho,1159426,761126,685672,75454
2010-03-01,Illinois,9918785,6613284,5851353,761931
2010-03-01,Indiana,4929346,3157615,2801170,356445
2010-03-01,Iowa,2343400,1669082,1553321,115761
2010-03-01,Kansas,2140798,1492806,1383137,109669
2010-03-01,Kentucky,3346711,2063134,1830716,232418
2010-03-01,Louisiana,3410594,2061051,1918540,142511
2010-03-01,Maine,1066137,691302,624367,66935
2010-03-01,Maryland,4429620,3058601,2800994,257607
2010-03-01,Massachusetts,5269256,3465648,3163932,301716
2010-03-01,Michigan,7777301,4757816,4109356,648460
2010-03-01,Minnesota,4104281,2927523,2674183,253340
2010-03-01,Mississippi,2207537,1265422,1135654,129768
2010-03-01,Missouri,4632421,3028556,2722448,306108
2010-03-01,Montana,771187,498568,456674,41894
2010-03-01,Nebraska,1371688,986434,934432,52002
2010-03-01,Nevada,2011335,1358270,1169905,188365
2010-03-01,Ohio,8968417,5859725,5192327,667398
2010-03-01,Oklahoma,2792911,1755714,1636505,119209
2010-03-01,Oregon,3031074,1978767,1742511,236256
2010-03-01,Pennsylvania,9972037,6306264,5742587,563677
2010-03-01,Tennessee,4900953,3057438,2734717,322721
2010-03-01,Texas,18325113,12151184,11142577,1008607
2010-03-01,Utah,1997075,1347122,1236090,111032
2010-03-01,Vermont,509216,359685,333801,25884
2010-03-01,Virginia,6055213,4152734,3825692,327042
2010-03-01,Washington,5228475,3462998,3122132,340866
2010-03-01,Wisconsin,4433668,3081864,2769331,312533
2010-03-01,Wyoming,421067,300692,276201,24491
2010-04-01,Alabama,3696845,2201796,1979924,221872
2010-04-01,Alaska,515851,359904,329225,30679
2010-04-01,Arizona,4838466,3113307,2800049,313258
2010-04-01,Arkansas,2231366,1356946,1255963,100983
2010-04-01,California,28538466,18390575,16136634,2253941
2010-04-01,Colorado,3848295,2717141,2471198,245943
2010-04-01,Connecticut,2802329,1896974,1719901,177073
2010-04-01,Delaware,701527,436053,398520,37533
2010-04-01,Florida,14959822,9109164,8156798,952366
2010-04-01,Georgia,7276848,4700670,4221738,478932
2010-04-01,Hawaii,1039195,648113,605456,42657
2010-04-01,Idaho,1163327,764782,695240,69542
2010-04-01,Illinois,9881090,6637652,5925499,712153
2010-04-01,Indiana,4962744,3189092,2866134,322958
2010-04-01,Iowa,2358250,1684458,1584932,99526
2010-04-01,Kansas,2147765,1500438,1398414,102024
2010-04-01,Kentucky,3340225,2069432,1858587,210845
2010-04-01,Louisiana,3434434,2087889,1946864,141025
2010-04-01,Maine,1074471,695268,633550,61718
2010-04-01,Maryland,4490945,3069839,2839281,230558
2010-04-01,Massachusetts,5224455,3468612,3191791,276821
2010-04-01,Michigan,7718784,4759201,4162541,596660
2010-04-01,Minnesota,4108452,2949602,2730673,218929
2010-04-01,Mississippi,2228901,1270593,1148212,122381
2010-04-01,Missouri,4618728,3049815,2771113,278702
2010-04-01,Montana,777438,501138,464302,36836
2010-04-01,Nebraska,1388012,995639,948916,46723
2010-04-01,Nevada,2073299,1361771,1176874,184897
2010-04-01,Ohio,8958283,5908851,5289309,619542
2010-04-01,Oklahoma,2836218,1767608,1657610,109998
2010-04-01,Oregon,3024399,1989913,1772667,217246
2010-04-01,Pennsylvania,10056682,6342316,5839858,502458
2010-04-01,Tennessee,4916740,3093251,2794710,298541
2010-04-01,Texas,18541655,12289277,11313897,975380
2010-04-01,Utah,1952084,1350122,1243911,106211
2010-04-01,Vermont,506421,358181,333941,24240
2010-04-01,Virginia,6149198,4173234,3874258,298976
2010-04-01,Washington,5233189,3465490,3156563,308927
2010-04-01,Wisconsin,4428585,3085641,2812995,272646
2010-04-01,Wyoming,433003,301533,279199,22334
2010-05-01,Alabama,3700013,2204596,1987257,217339
2010-05-01,Alaska,516810,360897,331992,28905
2010-05-01,Arizona,4843931,3098759,2787719,311040
2010-05-01,Arkansas,2233214,1363057,1259428,103629
2010-05-01,California,28564851,18340692,16153890,2186802
2010-05-01,Colorado,3852091,2705995,2465869,240126
2010-05-01,Connecticut,2804758,1915485,1734088,181397
2010-05-01,Delaware,702130,433958,398190,35768
2010-05-01,Florida,14974268,9158235,8201682,956553
2010-05-01,Georgia,7285144,4691224,4209914,481310
2010-05-01,Hawaii,1040697,646683,604539,42144
2010-05-01,Idaho,1164326,763293,701362,61931
2010-05-01,Illinois,9885775,6616298,5940978,675320
2010-05-01,Indiana,4965541,3196189,2879835,316354
2010-05-01,Iowa,2359389,1677638,1582742,94896
2010-05-01,Kansas,2148511,1496311,1395931,100380
2010-05-01,Kentucky,3343644,2068434,1858325,210109
2010-05-01,Louisiana,3437625,2089364,1937947,151417
2010-05-01,Maine,1074480,694481,636739,57742
2010-05-01,Maryland,4495161,3072774,2841770,231004
2010-05-01,Massachusetts,5230789,3465598,3190613,274985
2010-05-01,Michigan,7719607,4790257,4205039,585218
2010-05-01,Minnesota,4111034,2947460,2741932,205528
2010-05-01,Mississippi,2230751,1277612,1147861,129751
2010-05-01,Missouri,4621534,3048413,2772583,275830
2010-05-01,Montana,777863,502822,469550,33272
2010-05-01,Nebraska,1388844,995855,951558,44297
2010-05-01,Nevada,2074378,1360190,1178017,182173
2010-05-01,Ohio,8961281,5901906,5309177,592729
2010-05-01,Oklahoma,2838991,1769734,1653423,116311
2010-05-01,Oregon,3027045,1983393,1778700,204693
2010-05-01,Pennsylvania,10060817,6384258,5858175,526083
2010-05-01,Tennessee,4921391,3102149,2811545,290604
2010-05-01,Texas,18567698,12253619,11285844,967775
2010-05-01,Utah,1954737,1351208,1246446,104762
2010-05-01,Vermont,506599,357993,336014,21979
2010-05-01,Virginia,6155076,4180531,3875766,304765
2010-05-01,Washington,5237362,3459259,3152022,307237
2010-05-01,Wisconsin,4430315,3077547,2821326,256221
2010-05-01,Wyoming,433341,301797,280586,21211
2010-06-01,Alabama,3703287,2224668,1992429,232239
2010-06-01,Alaska,517816,366653,337757,28896
2010-06-01,Arizona,4849422,3103031,2778141,324890
2010-06-01,Arkansas,2235014,1376813,1270662,106151
2010-06-01,California,28591878,18367830,16108371,2259459
2010-06-01,Colorado,3855998,2724911,2476852,248059
2010-06-01,Connecticut,2807133,1931137,1747167,183970
2010-06-01,Delaware,702750,439612,401318,38294
2010-06-01,Florida,14988894,9170145,8176197,993948
2010-06-01,Georgia,7293730,4692671,4187537,505134
2010-06-01,Hawaii,1042459,651540,604169,47371
2010-06-01,Idaho,1165402,768854,705814,63040
2010-06-01,Illinois,9890376,6675048,5965864,709184
2010-06-01,Indiana,4968191,3216933,2891779,325154
2010-06-01,Iowa,2360458,1686764,1586793,99971
2010-06-01,Kansas,2149335,1513497,1409745,103752
2010-06-01,Kentucky,3347186,2086923,1872392,214531
2010-06-01,Louisiana,3440859,2120423,1945392,175031
2010-06-01,Maine,1074478,705004,648534,56470
2010-06-01,Maryland,4499403,3101660,2858127,243533
2010-06-01,Massachusetts,5237003,3516434,3233172,283262
2010-06-01,Michigan,7720262,4820499,4220260,600239
2010-06-01,Minnesota,4113576,2960917,2746252,214665
2010-06-01,Mississippi,2232572,1322734,1182163,140571
2010-06-01,Missouri,4624402,3080420,2792558,287862
2010-06-01,Montana,778260,508278,473019,35259
2010-06-01,Nebraska,1389679,1002787,953340,49447
2010-06-01,Nevada,2075511,1356432,1171510,184922
2010-06-01,Ohio,8964153,5931689,5321855,609834
2010-06-01,Oklahoma,2841937,1781258,1662393,118865
2010-06-01,Oregon,3029692,2003769,1789862,213907
2010-06-01,Pennsylvania,10064783,6401542,5883024,518518
2010-06-01,Tennessee,4926066,3129158,2820220,308938
2010-06-01,Texas,18594205,12274200,11242679,1031521
2010-06-01,Utah,1957360,1356619,1245795,110824
2010-06-01,Vermont,506795,363952,341189,22763
2010-06-01,Virginia,6161486,4199373,3891164,308209
2010-06-01,Washington,5241659,3468192,3162400,305792
2010-06-01,Wisconsin,4432000,3120472,2854117,266355
2010-06-01,Wyoming,433698,305282,285102,20180
2010-07-01,Alabama,3706618,2225018,1996280,228738
2010-07-01,Alaska,518874,371072,344475,26597
2010-07-01,Arizona,4855271,3101831,2768327,333504
2010-07-01,Arkansas,2237003,1376840,1265727,111113
2010-07-01,California,28619823,18465090,16111097,2353993
2010-07-01,Colorado,3860150,2730380,2484464,245916
2010-07-01,Connecticut,2809705,1949761,1759254,190507
2010-07-01,Delaware,703370,441878,403086,38792
2010-07-01,Florida,15004298,9229666,8198987,1030679
2010-07-01,Georgia,7301868,4711921,4200352,511569
2010-07-01,Hawaii,1044210,653984,608548,45436
2010-07-01,Idaho,1166472,769180,706770,62410
2010-07-01,Illinois,9895347,6680099,5975047,705052
2010-07-01,Indiana,4971237,3221513,2899019,322494
2010-07-01,Iowa,2361712,1686060,1586629,99431
2010-07-01,Kansas,2150262,1521132,1408806,112326
2010-07-01,Kentucky,3350635,2077913,1864241,213672
2010-07-01,Louisiana,3444273,2122784,1950127,172657
2010-07-01,Maine,1074529,711346,654679,56667
2010-07-01,Maryland,4504017,3134099,2881092,253007
2010-07-01,Massachusetts,5243644,3531924,3244353,287571
2010-07-01,Michigan,7721434,4842828,4204211,638617
2010-07-01,Minnesota,4116358,2977806,2763217,214589
2010-07-01,Mississippi,2234489,1346140,1201097,145043
2010-07-01,Missouri,4627241,3081383,2782679,298704
2010-07-01,Montana,778719,509873,476157,33716
2010-07-01,Nebraska,1390608,1005029,957210,47819
2010-07-01,Nevada,2076775,1363584,1173752,189832
2010-07-01,Ohio,8967602,5932884,5332253,600631
2010-07-01,Oklahoma,2844698,1774253,1659951,114302
2010-07-01,Oregon,3032496,2011390,1797457,213933
2010-07-01,Pennsylvania,10069471,6446828,5904169,542659
2010-07-01,Tennessee,4931020,3131158,2828107,303051
2010-07-01,Texas,18621263,12308914,11272847,1036067
2010-07-01,Utah,1960150,1357128,1248629,108499
2010-07-01,Vermont,506980,364670,342499,22171
2010-07-01,Virginia,6168295,4223107,3914346,308761
2010-07-01,Washington,5246398,3473339,3168221,305118
2010-07-01,Wisconsin,4433927,3119562,2861776,257786
2010-07-01,Wyoming,434045,303981,285445,18536
2010-08-01,Alabama,3708665,2230259,2002203,228056
2010-08-01,Alaska,519938,366810,341280,25530
2010-08-01,Arizona,4862034,3098733,2767154,331579
2010-08-01,Arkansas,2238891,1365853,1259755,106098
2010-08-01,California,28651165,18463983,16152702,2311281
2010-08-01,Colorado,3866394,2733553,2487389,246164
2010-08-01,Connecticut,2811743,1936104,1748260,187844
2010-08-01,Delaware,704160,441834,403169,38665
2010-08-01,Florida,15024207,9249471,8214721,1034750
2010-08-01,Georgia,7309203,4696166,4185594,510572
2010-08-01,Hawaii,1045500,653477,608672,44805
2010-08-01,Idaho,1167725,764453,702782,61671
2010-08-01,Illinois,9901550,6639116,5967158,671958
2010-08-01,Indiana,4974530,3196400,2884601,311799
2010-08-01,Iowa,2363261,1670247,1571397,98850
2010-08-01,Kansas,2151610,1498926,1393396,105530
2010-08-01,Kentucky,3352851,2069001,1866229,202772
2010-08-01,Louisiana,3447819,2104857,1933125,171732
2010-08-01,Maine,1075061,713489,660675,52814
2010-08-01,Maryland,4508940,3109514,2862235,247279
2010-08-01,Massachusetts,5248732,3524805,3252128,272677
2010-08-01,Michigan,7725162,4798237,4219912,578325
2010-08-01,Minnesota,4119761,2961588,2750844,210744
2010-08-01,Mississippi,2235801,1334602,1206910,127692
2010-08-01,Missouri,4629639,3054146,2761206,292940
2010-08-01,Montana,779335,507778,475240,32538
2010-08-01,Nebraska,1391584,996154,951860,44294
2010-08-01,Nevada,2078269,1358629,1171726,186903
2010-08-01,Ohio,8971266,5908052,5334021,574031
2010-08-01,Oklahoma,2847076,1767387,1655569,111818
2010-08-01,Oregon,3035865,2014907,1802762,212145
2010-08-01,Pennsylvania,10075228,6414809,5888370,526439
2010-08-01,Tennessee,4935322,3116919,2818490,298429
2010-08-01,Texas,18653451,12309500,11291662,1017838
2010-08-01,Utah,1963071,1355227,1245433,109794
2010-08-01,Vermont,507341,362993,341539,21454
2010-08-01,Virginia,6175954,4186241,3881107,305134
2010-08-01,Washington,5252718,3461874,3154173,307701
2010-08-01,Wisconsin,4436495,3105304,2857056,248248
2010-08-01,Wyoming,434340,303768,285371,18397
2010-09-01,Alabama,3710620,2218011,1997576,220435
2010-09-01,Alaska,520706,362801,336898,25903
2010-09-01,Arizona,4868640,3099578,2780841,318737
2010-09-01,Arkansas,2240717,1358826,1256457,102369
2010-09-01,California,28682473,18446183,16212876,2233307
2010-09-01,Colorado,3872252,2725505,2486564,238941
2010-09-01,Connecticut,2813819,1922456,1743536,178920
2010-09-01,Delaware,704947,436148,399708,36440
2010-09-01,Florida,15043725,9260974,8245534,1015440
2010-09-01,Georgia,7316156,4703169,4208579,494590
2010-09-01,Hawaii,1046297,651055,605951,45104
2010-09-01,Idaho,1168906,759762,700892,58870
2010-09-01,Illinois,9907377,6592088,5955910,636178
2010-09-01,Indiana,4977966,3160975,2867487,293488
2010-09-01,Iowa,2364850,1673241,1578999,94242
2010-09-01,Kansas,2152775,1499385,1400502,98883
2010-09-01,Kentucky,3354938,2063161,1866101,197060
2010-09-01,Louisiana,3451131,2094052,1931216,162836
2010-09-01,Maine,1075651,697198,645873,51325
2010-09-01,Maryland,4513628,3090113,2856966,233147
2010-09-01,Massachusetts,5253897,3460043,3191423,268620
2010-09-01,Michigan,7729079,4744899,4205310,539589
2010-09-01,Minnesota,4123243,2937750,2739014,198736
2010-09-01,Mississippi,2236920,1343998,1214087,129911
2010-09-01,Missouri,4632006,3042650,2766446,276204
2010-09-01,Montana,779928,500985,470309,30676
2010-09-01,Nebraska,1392543,988388,944977,43411
2010-09-01,Nevada,2079628,1362212,1174240,187972
2010-09-01,Ohio,8975063,5845358,5285082,560276
2010-09-01,Oklahoma,2849245,1766213,1658673,107540
2010-09-01,Oregon,3039325,1995960,1797978,197982
2010-09-01,Pennsylvania,10081106,6359191,5884087,475104
2010-09-01,Tennessee,4939470,3103612,2815132,288480
2010-09-01,Texas,18684832,12317178,11325377,991801
2010-09-01,Utah,1965965,1350674,1247351,103323
2010-09-01,Vermont,507719,358472,337542,20930
2010-09-01,Virginia,6182352,4151887,3861326,290561
2010-09-01,Washington,5258655,3454683,3156613,298070
2010-09-01,Wisconsin,4439156,3067595,2843146,224449
2010-09-01,Wyoming,434583,302470,285416,17054
2010-10-01,Alabama,3712775,2222965,2002846,220119
2010-10-01,Alaska,521665,359873,333239,26634
2010-10-01,Arizona,4875453,3076889,2770338,306551
2010-10-01,Arkansas,2242644,1352457,1253793,98664
2010-10-01,California,28715259,18369991,16153039,2216952
2010-10-01,Colorado,3878447,2715526,2473517,242009
2010-10-01,Connecticut,2815960,1919902,1742893,177009
2010-10-01,Delaware,705737,437845,402113,35732
2010-10-01,Florida,15063974,9234135,8240820,993315
2010-10-01,Georgia,7323865,4693702,4200841,492861
2010-10-01,Hawaii,1047433,649797,605790,44007
2010-10-01,Idaho,1170177,759211,700003,59208
2010-10-01,Illinois,9913651,6575551,5954038,621513
2010-10-01,Indiana,4981455,3164238,2874478,289760
2010-10-01,Iowa,2366432,1678949,1589024,89925
2010-10-01,Kansas,2154068,1497321,1399695,97626
2010-10-01,Kentucky,3357264,2058321,1865875,192446
2010-10-01,Louisiana,3454715,2093487,1934494,158993
2010-10-01,Maine,1076239,699490,647772,51718
2010-10-01,Maryland,4518646,3090369,2862603,227766
2010-10-01,Massachusetts,5259094,3466980,3214008,252972
2010-10-01,Michigan,7733095,4712979,4204562,508417
2010-10-01,Minnesota,4126763,2939857,2747359,192498
2010-10-01,Mississippi,2238228,1338722,1213396,125326
2010-10-01,Missouri,4634573,3033121,2765426,267695
2010-10-01,Montana,780526,498253,466722,31531
2010-10-01,Nebraska,1393532,990739,948566,42173
2010-10-01,Nevada,2081102,1356113,1172429,183684
2010-10-01,Ohio,8978933,5850351,5306546,543805
2010-10-01,Oklahoma,2851655,1765517,1657341,108176
2010-10-01,Oregon,3042809,2002259,1804968,197291
2010-10-01,Pennsylvania,10087177,6348158,5875587,472571
2010-10-01,Tennessee,4943817,3109188,2822330,286858
2010-10-01,Texas,18717463,12305589,11329924,975665
2010-10-01,Utah,1968852,1346822,1244565,102257
2010-10-01,Vermont,508111,358307,339590,18717
2010-10-01,Virginia,6190036,4160955,3876477,284478
2010-10-01,Washington,5264988,3461317,3166535,294782
2010-10-01,Wisconsin,4441858,3064792,2844044,220748
2010-10-01,Wyoming,434866,301792,284024,17768
2010-11-01,Alabama,3714308,2221711,1998520,223191
2010-11-01,Alaska,522685,360157,330770,29387
2010-11-01,Arizona,4881581,3080826,2774711,306115
2010-11-01,Arkansas,2244183,1351076,1248335,102741
2010-11-01,California,28745035,18402762,16110612,2292150
2010-11-01,Colorado,3884216,2717180,2463362,253818
2010-11-01,Connecticut,2817651,1918767,1741002,177765
2010-11-01,Delaware,706439,438592,403346,35246
2010-11-01,Florida,15081696,9219063,8204898,1014165
2010-11-01,Georgia,7330672,4713667,4210121,503546
2010-11-01,Hawaii,1048818,658320,612549,45771
2010-11-01,Idaho,1171219,758774,693697,65077
2010-11-01,Illinois,9918371,6594749,5964436,630313
2010-11-01,Indiana,4984018,3163433,2864700,298733
2010-11-01,Iowa,2367571,1674892,1581411,93481
2010-11-01,Kansas,2155106,1500367,1400657,99710
2010-11-01,Kentucky,3359139,2066246,1868199,198047
2010-11-01,Louisiana,3457717,2087119,1930173,156946
2010-11-01,Maine,1076699,695474,638571,56903
2010-11-01,Maryland,4522968,3086783,2853491,233292
2010-11-01,Massachusetts,5263454,3473941,3214397,259544
2010-11-01,Michigan,7735723,4692663,4197465,495198
2010-11-01,Minnesota,4129555,2938876,2740040,198836
2010-11-01,Mississippi,2239207,1344673,1214172,130501
2010-11-01,Missouri,4636373,3030650,2748475,282175
2010-11-01,Montana,781026,497163,462645,34518
2010-11-01,Nebraska,1394320,991216,949347,41869
2010-11-01,Nevada,2082333,1359913,1171639,188274
2010-11-01,Ohio,8981177,5840683,5291025,549658
2010-11-01,Oklahoma,2853727,1770677,1661269,109408
2010-11-01,Oregon,3045757,2006693,1800611,206082
2010-11-01,Pennsylvania,10091215,6349538,5865131,484407
2010-11-01,Tennessee,4947403,3105208,2811043,294165
2010-11-01,Texas,18748043,12381301,11366697,1014604
2010-11-01,Utah,1971498,1349703,1247008,102695
2010-11-01,Vermont,508419,358913,337276,21637
2010-11-01,Virginia,6197094,4154538,3868418,286120
2010-11-01,Washington,5270758,3456907,3142403,314504
2010-11-01,Wisconsin,4443782,3068407,2839375,229032
2010-11-01,Wyoming,435098,302764,282438,20326
2010-12-01,Alabama,3715741,2212360,1994418,217942
2010-12-01,Alaska,523689,359718,329574,30144
2010-12-01,Arizona,4887492,3057571,2762869,294702
2010-12-01,Arkansas,2245614,1344941,1239054,105887
2010-12-01,California,28773773,18323833,16082357,2241476
2010-12-01,Colorado,3889801,2712088,2461343,250745
2010-12-01,Connecticut,2819242,1902534,1730837,171697
2010-12-01,Delaware,707142,439474,404963,34511
2010-12-01,Florida,15098874,9215745,8242768,972977
2010-12-01,Georgia,7337313,4715400,4218977,496423
2010-12-01,Hawaii,1050130,657855,615627,42228
2010-12-01,Idaho,1172254,757932,691557,66375
2010-12-01,Illinois,9922695,6563244,5945444,617800
2010-12-01,Indiana,4986382,3142963,2858292,284671
2010-12-01,Iowa,2368633,1673149,1571944,101205
2010-12-01,Kansas,2156053,1492724,1397913,94811
2010-12-01,Kentucky,3360884,2064527,1868593,195934
2010-12-01,Louisiana,3460659,2069047,1919940,149107
2010-12-01,Maine,1077041,695243,638497,56746
2010-12-01,Maryland,4527177,3075181,2852646,222535
2010-12-01,Massachusetts,5267534,3472157,3215626,256531
2010-12-01,Michigan,7738064,4655337,4173843,481494
2010-12-01,Minnesota,4132148,2929123,2721812,207311
2010-12-01,Mississippi,2240112,1348353,1217129,131224
2010-12-01,Missouri,4637996,3025910,2746764,279146
2010-12-01,Montana,781473,495026,458279,36747
2010-12-01,Nebraska,1395040,990732,947373,43359
2010-12-01,Nevada,2083488,1352872,1166058,186814
2010-12-01,Ohio,8983084,5799879,5262265,537614
2010-12-01,Oklahoma,2855615,1758370,1654409,103961
2010-12-01,Oregon,3048548,1989426,1786156,203270
2010-12-01,Pennsylvania,10094881,6331458,5854175,477283
2010-12-01,Tennessee,4950759,3097748,2806084,291664
2010-12-01,Texas,18777822,12355432,11372898,982534
2010-12-01,Utah,1974065,1340545,1239358,101187
2010-12-01,Vermont,508692,357894,336535,21359
2010-12-01,Virginia,6203808,4149484,3873459,276025
2010-12-01,Washington,5276239,3437710,3126125,311585
2010-12-01,Wisconsin,4445481,3056685,2825843,230842
2010-12-01,Wyoming,435291,300332,280241,20091
2011-01-01,Alabama,3717148,2199552,1964136,235416
2011-01-01,Alaska,524423,359097,326825,32272
2011-01-01,Arizona,4893368,3057934,2748390,309544
2011-01-01,Arkansas,2247108,1336043,1216799,119244
2011-01-01,California,28802283,18297073,15968196,2328877
2011-01-01,Colorado,3895089,2695117,2438683,256434
2011-01-01,Connecticut,2820871,1903432,1711400,192032
2011-01-01,Delaware,707838,439811,401825,37986
2011-01-01,Florida,15115903,9192293,8203084,989209
2011-01-01,Georgia,7343837,4705453,4199862,505591
2011-01-01,Hawaii,1050960,659793,614278,45515
2011-01-01,Idaho,1173278,756976,682260,74716
2011-01-01,Illinois,9927281,6504165,5840006,664159
2011-01-01,Indiana,4988952,3151950,2840274,311676
2011-01-01,Iowa,2369761,1664914,1551171,113743
2011-01-01,Kansas,2156803,1492113,1384967,107146
2011-01-01,Kentucky,3362512,2051058,1834944,216114
2011-01-01,Louisiana,3463488,2064179,1893071,171108
2011-01-01,Maine,1077430,690447,627194,63253
2011-01-01,Maryland,4531264,3073409,2829108,244301
2011-01-01,Massachusetts,5271792,3462301,3173946,288355
2011-01-01,Michigan,7740726,4621636,4111767,509869
2011-01-01,Minnesota,4134872,2922203,2697639,224564
2011-01-01,Mississippi,2240917,1332387,1198177,134210
2011-01-01,Missouri,4639686,3016637,2715803,300834
2011-01-01,Montana,781908,494083,452953,41130
2011-01-01,Nebraska,1395701,988119,937864,50255
2011-01-01,Nevada,2084614,1351230,1160198,191032
2011-01-01,Ohio,8985195,5745418,5160402,585016
2011-01-01,Oklahoma,2857438,1748386,1638448,109938
2011-01-01,Oregon,3051463,1982621,1765893,216728
2011-01-01,Pennsylvania,10098875,6343116,5809769,533347
2011-01-01,Tennessee,4954125,3092767,2777273,315494
2011-01-01,Texas,18807299,12328134,11285568,1042566
2011-01-01,Utah,1976608,1337336,1229163,108173
2011-01-01,Vermont,509005,358793,334690,24103
2011-01-01,Virginia,6209446,4149779,3852412,297367
2011-01-01,Washington,5281394,3433847,3096421,337426
2011-01-01,Wisconsin,4447290,3048075,2788336,259739
2011-01-01,Wyoming,435435,300653,277421,23232
2011-02-01,Alabama,3718178,2197575,1970875,226700
2011-02-01,Alaska,525057,360565,328492,32073
2011-02-01,Arizona,4898622,3046699,2754422,292277
2011-02-01,Arkansas,2248324,1345800,1228723,117077
2011-02-01,California,28826883,18327993,16054387,2273606
2011-02-01,Colorado,3900018,2704793,2450957,253836
2011-02-01,Connecticut,2822128,1896692,1710320,186372
2011-02-01,Delaware,708429,439817,403000,36817
2011-02-01,Florida,15130726,9173242,8225753,947489
2011-02-01,Georgia,7349349,4696460,4206261,490199
2011-02-01,Hawaii,1051535,660296,616140,44156
2011-02-01,Idaho,1174126,757760,685690,72070
2011-02-01,Illinois,9930629,6495328,5846948,648380
2011-02-01,Indiana,4991071,3143835,2841590,302245
2011-02-01,Iowa,2370604,1666980,1559475,107505
2011-02-01,Kansas,2157303,1497072,1391223,105849
2011-02-01,Kentucky,3363785,2050811,1837934,212877
2011-02-01,Louisiana,3465991,2060368,1907992,152376
2011-02-01,Maine,1077709,689678,627118,62560
2011-02-01,Maryland,4534863,3069166,2830313,238853
2011-02-01,Massachusetts,5275498,3457872,3180189,277683
2011-02-01,Michigan,7742608,4623756,4123916,499840
2011-02-01,Minnesota,4137246,2926902,2708530,218372
2011-02-01,Mississippi,2241481,1337737,1204485,133252
2011-02-01,Missouri,4640819,3020404,2724530,295874
2011-02-01,Montana,782278,494756,455910,38846
2011-02-01,Nebraska,1396240,993858,944592,49266
2011-02-01,Nevada,2085509,1356426,1171688,184738
2011-02-01,Ohio,8986497,5747256,5184803,562453
2011-02-01,Oklahoma,2858912,1746109,1639450,106659
2011-02-01,Oregon,3054102,1986978,1777738,209240
2011-02-01,Pennsylvania,10101882,6325735,5801619,524116
2011-02-01,Tennessee,4956991,3105374,2800766,304608
2011-02-01,Texas,18834479,12373377,11357121,1016256
2011-02-01,Utah,1979059,1339651,1230838,108813
2011-02-01,Vermont,509200,357512,334889,22623
2011-02-01,Virginia,6214418,4166564,3878173,288391
2011-02-01,Washington,5286052,3441969,3111886,330083
2011-02-01,Wisconsin,4448743,3058982,2792244,266738
2011-02-01,Wyoming,435625,299921,278357,21564
2011-03-01,Alabama,3719329,2202922,1986875,216047
2011-03-01,Alaska,525998,360971,329986,30985
2011-03-01,Arizona,4903936,3056259,2771253,285006
2011-03-01,Arkansas,2249580,1352642,1243937,108705
2011-03-01,California,28851906,18336778,16089452,2247326
2011-03-01,Colorado,3905335,2708256,2463156,245100
2011-03-01,Connecticut,2823420,1902848,1723434,179414
2011-03-01,Delaware,709022,443848,408882,34966
2011-03-01,Florida,15145898,9201076,8274267,926809
2011-03-01,Georgia,7355534,4717283,4241448,475835
2011-03-01,Hawaii,1052652,664852,621667,43185
2011-03-01,Idaho,1175062,760468,690059,70409
2011-03-01,Illinois,9934177,6527152,5895454,631698
2011-03-01,Indiana,4993128,3159206,2871448,287758
2011-03-01,Iowa,2371487,1669520,1565927,103593
2011-03-01,Kansas,2158094,1494005,1393560,100445
2011-03-01,Kentucky,3365375,2066506,1861226,205280
2011-03-01,Louisiana,3468626,2071511,1920519,150992
2011-03-01,Maine,1077980,691458,631246,60212
2011-03-01,Maryland,4538624,3088754,2860320,228434
2011-03-01,Massachusetts,5279236,3469355,3204415,264940
2011-03-01,Michigan,7744339,4629497,4147365,482132
2011-03-01,Minnesota,4139617,2938766,2722325,216441
2011-03-01,Mississippi,2242215,1340651,1212417,128234
2011-03-01,Missouri,4642214,3024801,2744400,280401
2011-03-01,Montana,782660,497787,459688,38099
2011-03-01,Nebraska,1396850,999643,951906,47737
2011-03-01,Nevada,2086463,1356096,1173842,182254
2011-03-01,Ohio,8987798,5758595,5228759,529836
2011-03-01,Oklahoma,2860602,1754626,1657994,96632
2011-03-01,Oregon,3056622,1993040,1787886,205154
2011-03-01,Pennsylvania,10104727,6320543,5822899,497644
2011-03-01,Tennessee,4960063,3118627,2822826,295801
2011-03-01,Texas,18862126,12416106,11415804,1000302
2011-03-01,Utah,1981579,1341258,1235642,105616
2011-03-01,Vermont,509462,358750,336319,22431
2011-03-01,Virginia,6220972,4195222,3916388,278834
2011-03-01,Washington,5291169,3444270,3128840,315430
2011-03-01,Wisconsin,4450178,3062269,2806245,256024
2011-03-01,Wyoming,435792,301477,280760,20717
2011-04-01,Alabama,3720594,2202588,1999336,203252
2011-04-01,Alaska,526677,358175,329674,28501
2011-04-01,Arizona,4909573,3043669,2767138,276531
2011-04-01,Arkansas,2250956,1352587,1251328,101259
2011-04-01,California,28878193,18294256,16162096,2132160
2011-04-01,Colorado,3910501,2706651,2475834,230817
2011-04-01,Connecticut,2824880,1895462,1728436,167026
2011-04-01,Delaware,709653,444180,411165,33015
2011-04-01,Florida,15161610,9221855,8315418,906437
2011-04-01,Georgia,7361501,4697636,4238745,458891
2011-04-01,Hawaii,1053281,663435,621178,42257
2011-04-01,Idaho,1176067,759548,695233,64315
2011-04-01,Illinois,9938364,6520572,5914129,606443
2011-04-01,Indiana,4995709,3169607,2906729,262878
2011-04-01,Iowa,2372558,1673030,1583280,89750
2011-04-01,Kansas,2158718,1491593,1400206,91387
2011-04-01,Kentucky,3366900,2062706,1875131,187575
2011-04-01,Louisiana,3471308,2072990,1930330,142660
2011-04-01,Maine,1078360,692914,636567,56347
2011-04-01,Maryland,4542385,3074610,2861696,212914
2011-04-01,Massachusetts,5283400,3463489,3220934,242555
2011-04-01,Michigan,7746818,4604848,4159037,445811
2011-04-01,Minnesota,4142356,2950876,2757366,193510
2011-04-01,Mississippi,2242874,1342887,1219440,123447
2011-04-01,Missouri,4643748,3032371,2776420,255951
2011-04-01,Montana,783082,497232,464099,33133
2011-04-01,Nebraska,1397510,1003241,959816,43425
2011-04-01,Nevada,2087465,1354293,1174331,179962
2011-04-01,Ohio,8989863,5765952,5269949,496003
2011-04-01,Oklahoma,2862265,1755496,1668074,87422
2011-04-01,Oregon,3059486,1988482,1800569,187913
2011-04-01,Pennsylvania,10108542,6323160,5869808,453352
2011-04-01,Tennessee,4963320,3125148,2846339,278809
2011-04-01,Texas,18890272,12459734,11497979,961755
2011-04-01,Utah,1984210,1337075,1235867,101208
2011-04-01,Vermont,509732,354808,333241,21567
2011-04-01,Virginia,6226145,4198158,3940032,258126
2011-04-01,Washington,5296088,3426618,3139782,286836
2011-04-01,Wisconsin,4452042,3053134,2819011,234123
2011-04-01,Wyoming,435951,300225,280730,19495
2011-05-01,Alabama,3721955,2204468,1998613,205855
2011-05-01,Alaska,527433,364510,336821,27689
2011-05-01,Arizona,4915290,3038494,2766653,271841
2011-05-01,Arkansas,2252425,1360934,1254490,106444
2011-05-01,California,28904789,18324296,16220310,2103986
2011-05-01,Colorado,3915913,2719880,2478018,241862
2011-05-01,Connecticut,2826494,1915763,1742676,173087
2011-05-01,Delaware,710295,441386,409504,31882
2011-05-01,Florida,15177934,9288710,8369081,919629
2011-05-01,Georgia,7367896,4735401,4261947,473454
2011-05-01,Hawaii,1054070,660804,616712,44092
2011-05-01,Idaho,1177152,762395,703557,58838
2011-05-01,Illinois,9942921,6546883,5930321,616562
2011-05-01,Indiana,4998403,3198764,2926177,272587
2011-05-01,Iowa,2373762,1665898,1577699,88199
2011-05-01,Kansas,2159579,1494203,1400796,93407
2011-05-01,Kentucky,3368682,2069211,1875262,193949
2011-05-01,Louisiana,3474088,2075270,1925170,150100
2011-05-01,Maine,1078807,693088,638846,54242
2011-05-01,Maryland,4546292,3088755,2867842,220913
2011-05-01,Massachusetts,5287766,3458727,3212637,246090
2011-05-01,Michigan,7749462,4670932,4208927,462005
2011-05-01,Minnesota,4145265,2960396,2774676,185720
2011-05-01,Mississippi,2243657,1354784,1222485,132299
2011-05-01,Missouri,4645581,3044259,2783013,261246
2011-05-01,Montana,783539,500795,470128,30667
2011-05-01,Nebraska,1398234,1006293,963220,43073
2011-05-01,Nevada,2088489,1358765,1181172,177593
2011-05-01,Ohio,8992219,5785683,5282381,503302
2011-05-01,Oklahoma,2864136,1762564,1666118,96446
2011-05-01,Oregon,3062462,1983660,1801621,182039
2011-05-01,Pennsylvania,10112630,6369372,5891206,478166
2011-05-01,Tennessee,4966716,3124742,2845930,278812
2011-05-01,Texas,18918815,12472700,11480410,992290
2011-05-01,Utah,1986941,1345001,1243974,101027
2011-05-01,Vermont,510055,356894,336972,19922
2011-05-01,Virginia,6231923,4210100,3940312,269788
2011-05-01,Washington,5301308,3431886,3141471,290415
2011-05-01,Wisconsin,4454088,3057148,2831306,225842
2011-05-01,Wyoming,436185,300739,282799,17940
2011-06-01,Alabama,3723324,2225342,1995644,229698
2011-06-01,Alaska,528424,370318,341539,28779
2011-06-01,Arizona,4921061,3065288,2747484,317804
2011-06-01,Arkansas,2253923,1368360,1255264,113096
2011-06-01,California,28932601,18398501,16155683,2242818
2011-06-01,Colorado,3921602,2730844,2493375,237469
2011-06-01,Connecticut,2828103,1932823,1752682,180141
2011-06-01,Delaware,710947,445957,410351,35606
2011-06-01,Florida,15194605,9282203,8313710,968493
2011-06-01,Georgia,7374731,4750209,4241738,508471
2011-06-01,Hawaii,1055250,664135,613969,50166
2011-06-01,Idaho,1178222,768122,707894,60228
2011-06-01,Illinois,9947621,6646313,5965638,680675
2011-06-01,Indiana,5000969,3228231,2936032,292199
2011-06-01,Iowa,2374926,1678147,1580777,97370
2011-06-01,Kansas,2160579,1509984,1410818,99166
2011-06-01,Kentucky,3370550,2090511,1886018,204493
2011-06-01,Louisiana,3476941,2100732,1925912,174820
2011-06-01,Maine,1079234,706016,652624,53392
2011-06-01,Maryland,4550304,3121737,2880769,240968
2011-06-01,Massachusetts,5292032,3512759,3248995,263764
2011-06-01,Michigan,7751914,4718329,4221127,497202
2011-06-01,Minnesota,4148114,2973438,2771536,201902
2011-06-01,Mississippi,2244505,1366719,1217678,149041
2011-06-01,Missouri,4647502,3076961,2802010,274951
2011-06-01,Montana,784030,505937,472323,33614
2011-06-01,Nebraska,1399025,1012571,964226,48345
2011-06-01,Nevada,2089613,1359183,1173987,185196
2011-06-01,Ohio,8994387,5831423,5285192,546231
2011-06-01,Oklahoma,2866167,1774877,1669701,105176
2011-06-01,Oregon,3065386,2005677,1807972,197705
2011-06-01,Pennsylvania,10116545,6433508,5915042,518466
2011-06-01,Tennessee,4970183,3148813,2841568,307245
2011-06-01,Texas,18948373,12537024,11443609,1093415
2011-06-01,Utah,1989686,1350854,1242433,108421
2011-06-01,Vermont,510359,361506,341032,20474
2011-06-01,Virginia,6238757,4232795,3946623,286172
2011-06-01,Washington,5306985,3446128,3151353,294775
2011-06-01,Wisconsin,4456029,3114276,2863286,250990
2011-06-01,Wyoming,436390,304951,287131,17820
2011-07-01,Alabama,3725094,2211671,1989059,222612
2011-07-01,Alaska,529293,372657,346476,26181
2011-07-01,Arizona,4927327,3055452,2744466,310986
2011-07-01,Arkansas,2255622,1372837,1258519,114318
2011-07-01,California,28961854,18455080,16172416,2282664
2011-07-01,Colorado,3927503,2739505,2505867,233638
2011-07-01,Connecticut,2829939,1943402,1762475,180927
2011-07-01,Delaware,711649,447372,412046,35326
2011-07-01,Florida,15212690,9302324,8331702,970622
2011-07-01,Georgia,7381294,4759689,4255242,504447
2011-07-01,Hawaii,1056275,664113,617335,46778
2011-07-01,Idaho,1179418,771346,711469,59877
2011-07-01,Illinois,9952918,6630624,5950342,680282
2011-07-01,Indiana,5004175,3226471,2931874,294597
2011-07-01,Iowa,2376369,1681713,1590114,91599
2011-07-01,Kansas,2161702,1516423,1413344,103079
2011-07-01,Kentucky,3372658,2072576,1868163,204413
2011-07-01,Louisiana,3480139,2103467,1934280,169187
2011-07-01,Maine,1079736,713367,661008,52359
2011-07-01,Maryland,4554788,3138052,2898879,239173
2011-07-01,Massachusetts,5296946,3522713,3259802,262911
2011-07-01,Michigan,7755325,4731759,4203254,528505
2011-07-01,Minnesota,4151463,2984378,2770713,213665
2011-07-01,Mississippi,2245527,1359121,1214787,144334
2011-07-01,Missouri,4649586,3066553,2797352,269201
2011-07-01,Montana,784578,507005,475445,31560
2011-07-01,Nebraska,1399924,1015170,969153,46017
2011-07-01,Nevada,2090907,1365882,1179896,185986
2011-07-01,Ohio,8997660,5843514,5306610,536904
2011-07-01,Oklahoma,2868176,1767000,1666683,100317
2011-07-01,Oregon,3068628,2010918,1814452,196466
2011-07-01,Pennsylvania,10121700,6453692,5923436,530256
2011-07-01,Tennessee,4974165,3142618,2846989,295629
2011-07-01,Texas,18978851,12559752,11466092,1093660
2011-07-01,Utah,1992633,1349889,1249396,100493
2011-07-01,Vermont,510702,360757,340825,19932
2011-07-01,Virginia,6245595,4250242,3965005,285237
2011-07-01,Washington,5312903,3450047,3161498,288549
2011-07-01,Wisconsin,4458463,3105529,2868498,237031
2011-07-01,Wyoming,436630,305379,288461,16918
2011-08-01,Alabama,3727077,2206085,1990397,215688
2011-08-01,Alaska,529932,370155,345254,24901
2011-08-01,Arizona,4934665,3048825,2749438,299387
2011-08-01,Arkansas,2256748,1362150,1254852,107298
2011-08-01,California,28992652,18475388,16247087,2228301
2011-08-01,Colorado,3933549,2747025,2513108,233917
2011-08-01,Connecticut,2831528,1925660,1749462,176198
2011-08-01,Delaware,712334,446338,411557,34781
2011-08-01,Florida,15233573,9300290,8343530,956760
2011-08-01,Georgia,7389941,4740038,4244788,495250
2011-08-01,Hawaii,1057360,660260,613911,46349
2011-08-01,Idaho,1180641,766128,707712,58416
2011-08-01,Illinois,9956696,6604845,5933243,671602
2011-08-01,Indiana,5006739,3205353,2915142,290211
2011-08-01,Iowa,2377594,1668694,1575041,93653
2011-08-01,Kansas,2163057,1494019,1395523,98496
2011-08-01,Kentucky,3374290,2058740,1871602,187138
2011-08-01,Louisiana,3482300,2082634,1921782,160852
2011-08-01,Maine,1080008,716057,666872,49185
2011-08-01,Maryland,4559232,3110837,2877048,233789
2011-08-01,Massachusetts,5301948,3531279,3282803,248476
2011-08-01,Michigan,7758849,4717003,4234906,482097
2011-08-01,Minnesota,4154458,2968768,2782967,185801
2011-08-01,Mississippi,2246385,1342924,1209806,133118
2011-08-01,Missouri,4651535,3041584,2770593,270991
2011-08-01,Montana,785191,507878,476765,31113
2011-08-01,Nebraska,1400978,1006672,962848,43824
2011-08-01,Nevada,2093893,1365853,1180226,185627
2011-08-01,Ohio,9000165,5830887,5323874,507013
2011-08-01,Oklahoma,2870614,1766722,1668658,98064
2011-08-01,Oregon,3071373,2013851,1820631,193220
2011-08-01,Pennsylvania,10125377,6433848,5909239,524609
2011-08-01,Tennessee,4978538,3125470,2837575,287895
2011-08-01,Texas,19010408,12553282,11504991,1048291
2011-08-01,Utah,1995505,1345831,1248961,96870
2011-08-01,Vermont,510779,359577,340836,18741
2011-08-01,Virginia,6252917,4216672,3928473,288199
2011-08-01,Washington,5319387,3439665,3156654,283011
2011-08-01,Wisconsin,4460535,3093800,2865860,227940
2011-08-01,Wyoming,437302,304471,288009,16462
2011-09-01,Alabama,3729221,2196402,1988354,208048
2011-09-01,Alaska,530484,367212,341676,25536
2011-09-01,Arizona,4942294,3060225,2769224,291001
2011-09-01,Arkansas,2258033,1362711,1257515,105196
2011-09-01,California,29024770,18543128,16378132,2164996
2011-09-01,Colorado,3939619,2757746,2529122,228624
2011-09-01,Connecticut,2833192,1917182,1749223,167959
2011-09-01,Delaware,713095,441397,408282,33115
2011-09-01,Florida,15255186,9333056,8400198,932858
2011-09-01,Georgia,7398785,4762188,4279205,482983
2011-09-01,Hawaii,1058144,657683,610303,47380
2011-09-01,Idaho,1181963,765138,708877,56261
2011-09-01,Illinois,9961151,6588817,5940775,648042
2011-09-01,Indiana,5009696,3196552,2918102,278450
2011-09-01,Iowa,2379045,1672042,1583467,88575
2011-09-01,Kansas,2164394,1496543,1404259,92284
2011-09-01,Kentucky,3375991,2056340,1869522,186818
2011-09-01,Louisiana,3484631,2083937,1928498,155439
2011-09-01,Maine,1080363,698914,650434,48480
2011-09-01,Maryland,4563796,3098438,2875132,223306
2011-09-01,Massachusetts,5307262,3476816,3229341,247475
2011-09-01,Michigan,7762898,4689060,4233327,455733
2011-09-01,Minnesota,4157759,2962863,2790314,172549
2011-09-01,Mississippi,2247302,1348368,1216959,131409
2011-09-01,Missouri,4653762,3025830,2776470,249360
2011-09-01,Montana,785840,503493,474199,29294
2011-09-01,Nebraska,1402092,998822,957388,41434
2011-09-01,Nevada,2096935,1369038,1185754,183284
2011-09-01,Ohio,9003266,5766563,5272619,493944
2011-09-01,Oklahoma,2873141,1777395,1678914,98481
2011-09-01,Oregon,3074353,2002589,1822490,180099
2011-09-01,Pennsylvania,10129765,6402625,5919293,483332
2011-09-01,Tennessee,4983075,3113035,2834585,278450
2011-09-01,Texas,19042812,12588682,11564022,1024660
2011-09-01,Utah,1998526,1340441,1254464,85977
2011-09-01,Vermont,510881,355990,337350,18640
2011-09-01,Virginia,6259719,4214900,3935290,279610
2011-09-01,Washington,5325852,3437638,3164000,273638
2011-09-01,Wisconsin,4462951,3069996,2858109,211887
2011-09-01,Wyoming,438037,304581,288225,16356
2011-10-01,Alabama,3731395,2204732,2005498,199234
2011-10-01,Alaska,531239,363928,337996,25932
2011-10-01,Arizona,4949772,3056803,2775088,281715
2011-10-01,Arkansas,2259197,1365548,1266686,98862
2011-10-01,California,29057308,18516725,16397352,2119373
2011-10-01,Colorado,3945966,2758902,2531754,227148
2011-10-01,Connecticut,2834869,1919996,1757042,162954
2011-10-01,Delaware,713826,444211,412261,31950
2011-10-01,Florida,15276781,9318419,8421335,897084
2011-10-01,Georgia,7408384,4766418,4293654,472764
2011-10-01,Hawaii,1059477,657342,611688,45654
2011-10-01,Idaho,1183280,767214,711889,55325
2011-10-01,Illinois,9965604,6595927,5959404,636523
2011-10-01,Indiana,5012382,3208315,2929755,278560
2011-10-01,Iowa,2380345,1672771,1588889,83882
2011-10-01,Kansas,2165921,1499780,1410422,89358
2011-10-01,Kentucky,3377830,2053170,1874702,178468
2011-10-01,Louisiana,3486935,2092064,1941767,150297
2011-10-01,Maine,1080688,702075,654125,47950
2011-10-01,Maryland,4568504,3109560,2891032,218528
2011-10-01,Massachusetts,5312353,3485078,3255277,229801
2011-10-01,Michigan,7766568,4682516,4258438,424078
2011-10-01,Minnesota,4160868,2953960,2791477,162483
2011-10-01,Mississippi,2248307,1345731,1218538,127193
2011-10-01,Missouri,4656052,3027995,2793773,234222
2011-10-01,Montana,786491,502575,472764,29811
2011-10-01,Nebraska,1403237,1007137,966819,40318
2011-10-01,Nevada,2099973,1367704,1190835,176869
2011-10-01,Ohio,9005983,5760478,5288797,471681
2011-10-01,Oklahoma,2875894,1782370,1683342,99028
2011-10-01,Oregon,3077143,2001018,1821682,179336
2011-10-01,Pennsylvania,10133621,6402777,5932361,470416
2011-10-01,Tennessee,4987636,3113869,2849076,264793
2011-10-01,Texas,19075801,12560115,11605279,954836
2011-10-01,Utah,2001502,1338902,1259754,79148
2011-10-01,Vermont,510996,356668,340355,16313
2011-10-01,Virginia,6268025,4220923,3953205,267718
2011-10-01,Washington,5332729,3444888,3174246,270642
2011-10-01,Wisconsin,4465132,3072167,2867118,205049
2011-10-01,Wyoming,438779,304766,287694,17072
2011-11-01,Alabama,3733018,2191671,2006403,185268
2011-11-01,Alaska,531683,364506,336846,27660
2011-11-01,Arizona,4956614,3050159,2789519,260640
2011-11-01,Arkansas,2260105,1360787,1264695,96092
2011-11-01,California,29086234,18472822,16419452,2053370
2011-11-01,Colorado,3951498,2751435,2525935,225500
2011-11-01,Connecticut,2836156,1916634,1764092,152542
2011-11-01,Delaware,714415,446028,416422,29606
2011-11-01,Florida,15295953,9250707,8392720,857987
2011-11-01,Georgia,7416536,4767387,4321984,445403
2011-11-01,Hawaii,1060261,659158,614654,44504
2011-11-01,Idaho,1184380,767493,708185,59308
2011-11-01,Illinois,9968779,6584112,5976455,607657
2011-11-01,Indiana,5014631,3196861,2921344,275517
2011-11-01,Iowa,2381354,1665537,1583443,82094
2011-11-01,Kansas,2166958,1498739,1413568,85171
2011-11-01,Kentucky,3379079,2053743,1883858,169885
2011-11-01,Louisiana,3488699,2087677,1947815,139862
2011-11-01,Maine,1080869,696996,647719,49277
2011-11-01,Maryland,4572406,3099200,2891381,207819
2011-11-01,Massachusetts,5316976,3483330,3261803,221527
2011-11-01,Michigan,7769497,4674380,4274168,400212
2011-11-01,Minnesota,4163536,2945835,2787696,158139
2011-11-01,Mississippi,2248891,1339972,1220497,119475
2011-11-01,Missouri,4657686,3010412,2784987,225425
2011-11-01,Montana,787015,501787,471650,30137
2011-11-01,Nebraska,1404152,1006487,969105,37382
2011-11-01,Nevada,2102736,1363958,1194121,169837
2011-11-01,Ohio,9007712,5737314,5297118,440196
2011-11-01,Oklahoma,2877986,1789056,1695093,93963
2011-11-01,Oregon,3079645,1997081,1824047,173034
2011-11-01,Pennsylvania,10136404,6391308,5930451,460857
2011-11-01,Tennessee,4991472,3104835,2852799,252036
2011-11-01,Texas,19105904,12584248,11679523,904725
2011-11-01,Utah,2004296,1339936,1267991,71945
2011-11-01,Vermont,511024,356456,339435,17021
2011-11-01,Virginia,6274099,4206303,3950194,256109
2011-11-01,Washington,5338490,3431692,3160429,271263
2011-11-01,Wisconsin,4466891,3069385,2867223,202162
2011-11-01,Wyoming,439418,304671,286855,17816
2011-12-01,Alabama,3734683,2185040,2001357,183683
2011-12-01,Alaska,532076,363094,334163,28931
2011-12-01,Arizona,4963381,3043439,2782056,261383
2011-12-01,Arkansas,2261056,1353437,1252369,101068
2011-12-01,California,29114664,18439037,16382666,2056371
2011-12-01,Colorado,3956931,2742984,2515855,227129
2011-12-01,Connecticut,2837493,1903492,1752406,151086
2011-12-01,Delaware,715053,447303,417450,29853
2011-12-01,Florida,15315092,9260007,8418633,841374
2011-12-01,Georgia,7424650,4773213,4321122,452091
2011-12-01,Hawaii,1060869,655739,613806,41933
2011-12-01,Idaho,1185520,767865,707093,60772
2011-12-01,Illinois,9972047,6565636,5956726,608910
2011-12-01,Indiana,5016897,3182990,2914299,268691
2011-12-01,Iowa,2382411,1661430,1569921,91509
2011-12-01,Kansas,2167913,1491525,1407691,83834
2011-12-01,Kentucky,3380258,2052627,1879648,172979
2011-12-01,Louisiana,3490514,2071464,1935315,136149
2011-12-01,Maine,1081085,696742,645851,50891
2011-12-01,Maryland,4576360,3095076,2886759,208317
2011-12-01,Massachusetts,5321573,3485904,3259357,226547
2011-12-01,Michigan,7772459,4664031,4245188,418843
2011-12-01,Minnesota,4166245,2941941,2769560,172381
2011-12-01,Mississippi,2249476,1340595,1220386,120209
2011-12-01,Missouri,4659337,3007713,2778594,229119
2011-12-01,Montana,787517,499452,467510,31942
2011-12-01,Nebraska,1405024,1005610,964967,40643
2011-12-01,Nevada,2105492,1361060,1189781,171279
2011-12-01,Ohio,9009541,5708677,5264232,444445
2011-12-01,Oklahoma,2880077,1780076,1686350,93726
2011-12-01,Oregon,3082145,1985255,1806104,179151
2011-12-01,Pennsylvania,10139206,6381298,5915851,465447
2011-12-01,Tennessee,4995309,3094612,2843611,251001
2011-12-01,Texas,19135673,12561980,11686024,875956
2011-12-01,Utah,2007032,1330951,1263082,67869
2011-12-01,Vermont,511064,354398,337399,16999
2011-12-01,Virginia,6280095,4200555,3941994,258561
2011-12-01,Washington,5344052,3425804,3146924,278880
2011-12-01,Wisconsin,4468666,3061120,2852604,208516
2011-12-01,Wyoming,440037,303349,284829,18520
2012-01-01,Alabama,3736437,2157589,1964015,193574
2012-01-01,Alaska,532472,358542,328726,29816
2012-01-01,Arizona,4970220,3035157,2766718,268439
2012-01-01,Arkansas,2262001,1337050,1227609,109441
2012-01-01,California,29143906,18344462,16228253,2116209
2012-01-01,Colorado,3962382,2719932,2481074,238858
2012-01-01,Connecticut,2838829,1894466,1725297,169169
2012-01-01,Delaware,715709,443285,410303,32982
2012-01-01,Florida,15334438,9220132,8365121,855011
2012-01-01,Georgia,7433130,4746786,4288101,458685
2012-01-01,Hawaii,1061464,651909,608546,43363
2012-01-01,Idaho,1186669,764244,695947,68297
2012-01-01,Illinois,9975600,6517459,5876900,640559
2012-01-01,Indiana,5019202,3170094,2881366,288728
2012-01-01,Iowa,2383466,1650819,1550415,100404
2012-01-01,Kansas,2168823,1483717,1392122,91595
2012-01-01,Kentucky,3381405,2031314,1846300,185014
2012-01-01,Louisiana,3492387,2058968,1903586,155382
2012-01-01,Maine,1081268,690026,632791,57235
2012-01-01,Maryland,4580372,3080136,2854642,225494
2012-01-01,Massachusetts,5326196,3470945,3214950,255995
2012-01-01,Michigan,7775523,4628681,4177594,451087
2012-01-01,Minnesota,4168954,2919406,2726370,193036
2012-01-01,Mississippi,2250158,1326389,1200677,125712
2012-01-01,Missouri,4661081,2977764,2740121,237643
2012-01-01,Montana,788035,497671,461986,35685
2012-01-01,Nebraska,1405885,997186,953490,43696
2012-01-01,Nevada,2108162,1352031,1182062,169969
2012-01-01,Ohio,9011434,5657599,5168049,489550
2012-01-01,Oklahoma,2882186,1769336,1670783,98553
2012-01-01,Oregon,3084630,1967693,1774944,192749
2012-01-01,Pennsylvania,10142177,6365988,5849235,516753
2012-01-01,Tennessee,4999080,3068707,2803277,265430
2012-01-01,Texas,19165965,12496868,11585976,910892
2012-01-01,Utah,2009736,1325789,1252665,73124
2012-01-01,Vermont,511126,353886,334099,19787
2012-01-01,Virginia,6285701,4178258,3903635,274623
2012-01-01,Washington,5349660,3443847,3142884,300963
2012-01-01,Wisconsin,4470446,3037868,2804290,233578
2012-01-01,Wyoming,440634,301855,281432,20423
2012-02-01,Alabama,3737775,2163154,1971645,191509
2012-02-01,Alaska,533089,361325,331215,30110
2012-02-01,Arizona,4976397,3041997,2783768,258229
2012-02-01,Arkansas,2262688,1351410,1242429,108981
2012-02-01,California,29169798,18444250,16339222,2105028
2012-02-01,Colorado,3967744,2741149,2498726,242423
2012-02-01,Connecticut,2839834,1893539,1726010,167529
2012-02-01,Delaware,716266,443221,410211,33010
2012-02-01,Florida,15351863,9236646,8406490,830156
2012-02-01,Georgia,7441106,4755576,4301680,453896
2012-02-01,Hawaii,1062469,651621,609579,42042
2012-02-01,Idaho,1187686,767651,701119,66532
2012-02-01,Illinois,9977857,6549934,5924011,625923
2012-02-01,Indiana,5020887,3171317,2887051,284266
2012-02-01,Iowa,2384208,1656688,1558805,97883
2012-02-01,Kansas,2169771,1490223,1396831,93392
2012-02-01,Kentucky,3382463,2035401,1850189,185212
2012-02-01,Louisiana,3494007,2062276,1921189,141087
2012-02-01,Maine,1081314,690755,633034,57721
2012-02-01,Maryland,4584142,3088520,2863300,225220
2012-02-01,Massachusetts,5330155,3479610,3227331,252279
2012-02-01,Michigan,7777560,4646628,4200707,445921
2012-02-01,Minnesota,4171190,2927286,2733581,193705
2012-02-01,Mississippi,2250749,1326939,1205567,121372
2012-02-01,Missouri,4662219,2991738,2747103,244635
2012-02-01,Montana,788463,499912,465523,34389
2012-02-01,Nebraska,1406707,1004415,959945,44470
2012-02-01,Nevada,2110764,1365251,1197510,167741
2012-02-01,Ohio,9012201,5681441,5203149,478292
2012-02-01,Oklahoma,2884156,1778064,1681502,96562
2012-02-01,Oregon,3086730,1975031,1782778,192253
2012-02-01,Pennsylvania,10143682,6376226,5861481,514745
2012-02-01,Tennessee,5002582,3077380,2817450,259930
2012-02-01,Texas,19194543,12562561,11670609,891952
2012-02-01,Utah,2012392,1328603,1260022,68581
2012-02-01,Vermont,511107,353682,334656,19026
2012-02-01,Virginia,6292490,4204401,3930982,273419
2012-02-01,Washington,5355254,3469239,3167383,301856
2012-02-01,Wisconsin,4471727,3056926,2812096,244830
2012-02-01,Wyoming,441268,301892,282830,19062
2012-03-01,Alabama,3739321,2163700,1981392,182308
2012-03-01,Alaska,533381,362177,332985,29192
2012-03-01,Arizona,4982803,3047710,2797636,250074
2012-03-01,Arkansas,2263565,1356312,1256839,99473
2012-03-01,California,29195443,18438391,16374605,2063786
2012-03-01,Colorado,3972960,2736711,2501241,235470
2012-03-01,Connecticut,2841002,1888575,1727598,160977
2012-03-01,Delaware,716829,446764,414849,31915
2012-03-01,Florida,15369634,9257128,8448260,808868
2012-03-01,Georgia,7449017,4770099,4331177,438922
2012-03-01,Hawaii,1062816,654294,612873,41421
2012-03-01,Idaho,1188795,768982,704948,64034
2012-03-01,Illinois,9980816,6549171,5948837,600334
2012-03-01,Indiana,5023170,3167223,2896328,270895
2012-03-01,Iowa,2385211,1659197,1566922,92275
2012-03-01,Kansas,2170593,1484032,1395061,88971
2012-03-01,Kentucky,3383526,2045326,1867122,178204
2012-03-01,Louisiana,3495696,2077226,1937634,139592
2012-03-01,Maine,1081497,691927,636273,55654
2012-03-01,Maryland,4587822,3103167,2889170,213997
2012-03-01,Massachusetts,5334673,3493378,3252257,241121
2012-03-01,Michigan,7780449,4653414,4215046,438368
2012-03-01,Minnesota,4173907,2938602,2748702,189900
2012-03-01,Mississippi,2251220,1322918,1209769,113149
2012-03-01,Missouri,4663809,2993432,2759379,234053
2012-03-01,Montana,788963,502061,468386,33675
2012-03-01,Nebraska,1407566,1005829,964120,41709
2012-03-01,Nevada,2113359,1362237,1198222,164015
2012-03-01,Ohio,9013965,5705702,5257394,448308
2012-03-01,Oklahoma,2886108,1784696,1697289,87407
2012-03-01,Oregon,3089178,1975313,1785688,189625
2012-03-01,Pennsylvania,10146344,6382671,5893099,489572
2012-03-01,Tennessee,5006319,3087230,2837219,250011
2012-03-01,Texas,19222731,12557540,11723236,834304
2012-03-01,Utah,2015192,1331847,1265109,66738
2012-03-01,Vermont,511158,353433,335211,18222
2012-03-01,Virginia,6297993,4221317,3960675,260642
2012-03-01,Washington,5360596,3473542,3184954,288588
2012-03-01,Wisconsin,4473499,3054979,2822286,232693
2012-03-01,Wyoming,441895,302568,284228,18340
2012-04-01,Alabama,3740838,2162665,1997869,164796
2012-04-01,Alaska,533893,359757,333148,26609
2012-04-01,Arizona,4989316,3032606,2793443,239163
2012-04-01,Arkansas,2264414,1354248,1263529,90719
2012-04-01,California,29222479,18342093,16434680,1907413
2012-04-01,Colorado,3978413,2721250,2499769,221481
2012-04-01,Connecticut,2842175,1880781,1732477,148304
2012-04-01,Delaware,717434,446022,415973,30049
2012-04-01,Florida,15387537,9259761,8487483,772278
2012-04-01,Georgia,7457330,4737215,4322758,414457
2012-04-01,Hawaii,1063591,651844,613004,38840
2012-04-01,Idaho,1189917,766625,708315,58310
2012-04-01,Illinois,9983758,6531129,5967345,563784
2012-04-01,Indiana,5025264,3157128,2915168,241960
2012-04-01,Iowa,2386148,1655837,1576685,79152
2012-04-01,Kansas,2171582,1482292,1401047,81245
2012-04-01,Kentucky,3384772,2041308,1883914,157394
2012-04-01,Louisiana,3497367,2084324,1954142,130182
2012-04-01,Maine,1081643,693135,642479,50656
2012-04-01,Maryland,4591610,3087007,2889925,197082
2012-04-01,Massachusetts,5339050,3477007,3258094,218913
2012-04-01,Michigan,7783072,4620161,4227883,392278
2012-04-01,Minnesota,4176493,2936155,2777727,158428
2012-04-01,Mississippi,2251754,1323256,1215614,107642
2012-04-01,Missouri,4665382,2994680,2791455,203225
2012-04-01,Montana,789449,501698,472699,28999
2012-04-01,Nebraska,1408411,1009561,971918,37643
2012-04-01,Nevada,2116001,1357994,1199412,158582
2012-04-01,Ohio,9015464,5694756,5288702,406054
2012-04-01,Oklahoma,2888262,1781715,1701624,80091
2012-04-01,Oregon,3091529,1963844,1791304,172540
2012-04-01,Pennsylvania,10148660,6383376,5936362,447014
2012-04-01,Tennessee,5010012,3078629,2848966,229663
2012-04-01,Texas,19251790,12573478,11786272,787206
2012-04-01,Utah,2017934,1329504,1267787,61717
2012-04-01,Vermont,511169,349910,332582,17328
2012-04-01,Virginia,6304108,4205983,3969668,236315
2012-04-01,Washington,5366242,3452072,3191138,260934
2012-04-01,Wisconsin,4475073,3047134,2839178,207956
2012-04-01,Wyoming,442538,301444,284457,16987
2012-05-01,Alabama,3742396,2176401,2003669,172732
2012-05-01,Alaska,534483,364909,338599,26310
2012-05-01,Arizona,4995794,3055393,2804873,250520
2012-05-01,Arkansas,2265279,1363026,1265274,97752
2012-05-01,California,29249074,18444682,16540083,1904599
2012-05-01,Colorado,3984038,2739228,2518254,220974
2012-05-01,Connecticut,2843391,1906414,1748710,157704
2012-05-01,Delaware,717996,446264,416515,29749
2012-05-01,Florida,15405602,9371457,8566570,804887
2012-05-01,Georgia,7465750,4775012,4346737,428275
2012-05-01,Hawaii,1064477,650735,611513,39222
2012-05-01,Idaho,1191067,773886,719497,54389
2012-05-01,Illinois,9986723,6567237,5998831,568406
2012-05-01,Indiana,5027375,3181148,2930231,250917
2012-05-01,Iowa,2387179,1657320,1578310,79010
2012-05-01,Kansas,2172714,1487828,1404995,82833
2012-05-01,Kentucky,3386098,2063080,1896978,166102
2012-05-01,Louisiana,3499054,2096382,1955411,140971
2012-05-01,Maine,1081842,696812,646645,50167
2012-05-01,Maryland,4595395,3109742,2900364,209378
2012-05-01,Massachusetts,5343485,3491983,3263463,228520
2012-05-01,Michigan,7785658,4691148,4274604,416544
2012-05-01,Minnesota,4179146,2948421,2791723,156698
2012-05-01,Mississippi,2252365,1337679,1220038,117641
2012-05-01,Missouri,4667067,3014276,2805131,209145
2012-05-01,Montana,789993,508142,480785,27357
2012-05-01,Nebraska,1409361,1017535,979366,38169
2012-05-01,Nevada,2118612,1369670,1210331,159339
2012-05-01,Ohio,9016980,5725103,5324059,401044
2012-05-01,Oklahoma,2890509,1796655,1706174,90481
2012-05-01,Oregon,3093887,1962742,1798628,164114
2012-05-01,Pennsylvania,10151079,6456508,5970878,485630
2012-05-01,Tennessee,5013814,3098537,2859435,239102
2012-05-01,Texas,19280899,12628183,11794886,833297
2012-05-01,Utah,2020773,1343517,1281439,62078
2012-05-01,Vermont,511223,353140,336658,16482
2012-05-01,Virginia,6310753,4226824,3976184,250640
2012-05-01,Washington,5372135,3470098,3200211,269887
2012-05-01,Wisconsin,4476792,3062381,2855408,206973
2012-05-01,Wyoming,443188,303241,286992,16249
2012-06-01,Alabama,3744108,2201465,2005855,195610
2012-06-01,Alaska,535035,371360,343958,27402
2012-06-01,Arizona,5002599,3066095,2795939,270156
2012-06-01,Arkansas,2266248,1372392,1269209,103183
2012-06-01,California,29277450,18524399,16510940,2013459
2012-06-01,Colorado,3989781,2773732,2539744,233988
2012-06-01,Connecticut,2844747,1911983,1747127,164856
2012-06-01,Delaware,718652,450220,416978,33242
2012-06-01,Florida,15424547,9392812,8543290,849522
2012-06-01,Georgia,7474404,4794379,4335997,458382
2012-06-01,Hawaii,1065305,653360,608833,44527
2012-06-01,Idaho,1192291,780287,725178,55109
2012-06-01,Illinois,9990366,6673137,6043702,629435
2012-06-01,Indiana,5029844,3211329,2942581,268748
2012-06-01,Iowa,2388331,1672982,1587224,85758
2012-06-01,Kansas,2173881,1507559,1418096,89463
2012-06-01,Kentucky,3387548,2093647,1914077,179570
2012-06-01,Louisiana,3500949,2129886,1960942,168944
2012-06-01,Maine,1082090,711549,661666,49883
2012-06-01,Maryland,4599386,3151940,2921876,230064
2012-06-01,Massachusetts,5348291,3559342,3312548,246794
2012-06-01,Michigan,7788775,4738322,4291948,446374
2012-06-01,Minnesota,4182116,2971816,2796641,175175
2012-06-01,Mississippi,2253035,1348262,1215945,132317
2012-06-01,Missouri,4668979,3046766,2826506,220260
2012-06-01,Montana,790548,514322,484030,30292
2012-06-01,Nebraska,1410340,1023553,981883,41670
2012-06-01,Nevada,2121395,1370416,1206213,164203
2012-06-01,Ohio,9019108,5782437,5345532,436905
2012-06-01,Oklahoma,2892866,1815069,1716987,98082
2012-06-01,Oregon,3096538,1978364,1801005,177359
2012-06-01,Pennsylvania,10154135,6525184,5998839,526345
2012-06-01,Tennessee,5017869,3135266,2866974,268292
2012-06-01,Texas,19311048,12704860,11780372,924488
2012-06-01,Utah,2023694,1354400,1284152,70248
2012-06-01,Vermont,511282,358987,340948,18039
2012-06-01,Virginia,6317350,4259126,3994144,264982
2012-06-01,Washington,5378257,3496047,3221745,274302
2012-06-01,Wisconsin,4478791,3122601,2890041,232560
2012-06-01,Wyoming,443886,307860,290988,16872
2012-07-01,Alabama,3745940,2196227,2003141,193086
2012-07-01,Alaska,535584,372831,347646,25185
2012-07-01,Arizona,5009540,3061575,2782511,279064
2012-07-01,Arkansas,2267294,1366313,1259133,107180
2012-07-01,California,29305807,18582357,16518634,2063723
2012-07-01,Colorado,3995677,2760502,2535760,224742
2012-07-01,Connecticut,2846179,1915829,1745164,170665
2012-07-01,Delaware,719282,450395,416238,34157
2012-07-01,Florida,15443876,9412300,8542944,869356
2012-07-01,Georgia,7482739,4808765,4347472,461293
2012-07-01,Hawaii,1066084,651768,611801,39967
2012-07-01,Idaho,1193509,779988,725112,54876
2012-07-01,Illinois,9993695,6671172,6040984,630188
2012-07-01,Indiana,5032436,3192614,2922445,270169
2012-07-01,Iowa,2389557,1673411,1587718,85693
2012-07-01,Kansas,2175109,1509871,1412748,97123
2012-07-01,Kentucky,3389137,2077812,1898269,179543
2012-07-01,Louisiana,3502948,2122754,1961368,161386
2012-07-01,Maine,1082354,717084,666396,50688
2012-07-01,Maryland,4603555,3175659,2943804,231855
2012-07-01,Massachusetts,5353276,3555355,3301816,253539
2012-07-01,Michigan,7792111,4759142,4271764,487378
2012-07-01,Minnesota,4185165,2977332,2803118,174214
2012-07-01,Mississippi,2253714,1346948,1214424,132524
2012-07-01,Missouri,4670914,3046997,2812632,234365
2012-07-01,Montana,791138,514883,486565,28318
2012-07-01,Nebraska,1411388,1025738,981772,43966
2012-07-01,Nevada,2124233,1375685,1209108,166577
2012-07-01,Ohio,9021458,5776851,5338622,438229
2012-07-01,Oklahoma,2895161,1802386,1706096,96290
2012-07-01,Oregon,3099215,1983326,1800968,182358
2012-07-01,Pennsylvania,10157546,6554386,6008616,545770
2012-07-01,Tennessee,5022071,3122398,2855297,267101
2012-07-01,Texas,19341277,12710860,11787000,923860
2012-07-01,Utah,2026680,1356081,1288986,67095
2012-07-01,Vermont,511355,358527,340778,17749
2012-07-01,Virginia,6324085,4258352,3992185,266167
2012-07-01,Washington,5384419,3493196,3218998,274198
2012-07-01,Wisconsin,4480877,3110555,2886177,224378
2012-07-01,Wyoming,444553,306934,290835,16099
2012-08-01,Alabama,3748082,2184876,2001448,183428
2012-08-01,Alaska,535878,367998,345026,22972
2012-08-01,Arizona,5016602,3056147,2788486,267661
2012-08-01,Arkansas,2268387,1347610,1249957,97653
2012-08-01,California,29335993,18497407,16535423,1961984
2012-08-01,Colorado,4001980,2756248,2540224,216024
2012-08-01,Connecticut,2847427,1883445,1718936,164509
2012-08-01,Delaware,720044,446590,413275,33315
2012-08-01,Florida,15465332,9363996,8524539,839457
2012-08-01,Georgia,7489471,4752944,4314025,438919
2012-08-01,Hawaii,1066807,647915,611131,36784
2012-08-01,Idaho,1194918,773402,720080,53322
2012-08-01,Illinois,9997508,6587037,5985704,601333
2012-08-01,Indiana,5035833,3165772,2907585,258187
2012-08-01,Iowa,2391195,1655073,1572824,82249
2012-08-01,Kansas,2176025,1480970,1393452,87518
2012-08-01,Kentucky,3391439,2062702,1895609,167093
2012-08-01,Louisiana,3505274,2089366,1942480,146886
2012-08-01,Maine,1082712,715010,668827,46183
2012-08-01,Maryland,4607139,3132718,2911152,221566
2012-08-01,Massachusetts,5358546,3544498,3307286,237212
2012-08-01,Michigan,7796014,4718132,4284313,433819
2012-08-01,Minnesota,4188566,2953579,2789610,163969
2012-08-01,Mississippi,2254835,1326954,1209247,117707
2012-08-01,Missouri,4673088,2998533,2779146,219387
2012-08-01,Montana,791933,513269,485792,27477
2012-08-01,Nebraska,1412373,1012046,973262,38784
2012-08-01,Nevada,2127048,1368834,1208475,160359
2012-08-01,Ohio,9025886,5732482,5326269,406213
2012-08-01,Oklahoma,2897653,1791178,1699329,91849
2012-08-01,Oregon,3101836,1973350,1799527,173823
2012-08-01,Pennsylvania,10160869,6500499,5975355,525144
2012-08-01,Tennessee,5026242,3088579,2840615,247964
2012-08-01,Texas,19372177,12635053,11766887,868166
2012-08-01,Utah,2030026,1355476,1288121,67355
2012-08-01,Vermont,511540,355854,338979,16875
2012-08-01,Virginia,6329538,4209106,3954076,255030
2012-08-01,Washington,5389609,3466310,3205069,261241
2012-08-01,Wisconsin,4483459,3079622,2869322,210300
2012-08-01,Wyoming,444980,305400,290031,15369
2012-09-01,Alabama,3750371,2175441,2008193,167248
2012-09-01,Alaska,536044,364715,341962,22753
2012-09-01,Arizona,5023844,3069430,2818578,250852
2012-09-01,Arkansas,2269551,1345092,1253725,91367
2012-09-01,California,29367307,18550473,16738865,1811608
2012-09-01,Colorado,4008367,2766077,2565424,200653
2012-09-01,Connecticut,2848760,1874291,1723284,151007
2012-09-01,Delaware,720904,441858,411421,30437
2012-09-01,Florida,15487278,9407122,8617213,789909
2012-09-01,Georgia,7496368,4772104,4363747,408357
2012-09-01,Hawaii,1067398,647094,611099,35995
2012-09-01,Idaho,1196379,772346,721823,50523
2012-09-01,Illinois,10001763,6586527,6029892,556635
2012-09-01,Indiana,5039417,3162663,2921719,240944
2012-09-01,Iowa,2393002,1657159,1582717,74442
2012-09-01,Kansas,2176962,1486657,1409848,76809
2012-09-01,Kentucky,3393813,2061129,1902681,158448
2012-09-01,Louisiana,3507678,2083036,1949173,133863
2012-09-01,Maine,1083081,698959,654828,44131
2012-09-01,Maryland,4610857,3124779,2920645,204134
2012-09-01,Massachusetts,5364133,3493754,3265140,228614
2012-09-01,Michigan,7800273,4689006,4294533,394473
2012-09-01,Minnesota,4192145,2953337,2805649,147688
2012-09-01,Mississippi,2255957,1328894,1215089,113805
2012-09-01,Missouri,4675357,2994706,2800241,194465
2012-09-01,Montana,792794,508306,483559,24747
2012-09-01,Nebraska,1413365,1009178,974206,34972
2012-09-01,Nevada,2129876,1369862,1218388,151474
2012-09-01,Ohio,9030686,5694596,5308844,385752
2012-09-01,Oklahoma,2900237,1804572,1716718,87854
2012-09-01,Oregon,3104634,1957756,1802078,155678
2012-09-01,Pennsylvania,10164609,6464492,5996924,467568
2012-09-01,Tennessee,5030564,3084368,2852892,231476
2012-09-01,Texas,19403718,12676366,11869056,807310
2012-09-01,Utah,2033498,1358420,1299506,58914
2012-09-01,Vermont,511749,352506,336456,16050
2012-09-01,Virginia,6334899,4205530,3967582,237948
2012-09-01,Washington,5394909,3469665,3228450,241215
2012-09-01,Wisconsin,4486283,3060234,2874638,185596
2012-09-01,Wyoming,445436,304541,290507,14034
2012-10-01,Alabama,3752500,2197166,2029610,167556
2012-10-01,Alaska,536291,364021,340572,23449
2012-10-01,Arizona,5030865,3069450,2821166,248284
2012-10-01,Arkansas,2270630,1343531,1254496,89035
2012-10-01,California,29397331,18593214,16774190,1819024
2012-10-01,Colorado,4014667,2771570,2570182,201388
2012-10-01,Connecticut,2849989,1877960,1726066,151894
2012-10-01,Delaware,721681,446018,415549,30469
2012-10-01,Florida,15508601,9425253,8650455,774798
2012-10-01,Georgia,7503210,4786040,4373151,412889
2012-10-01,Hawaii,1068094,647148,612494,34654
2012-10-01,Idaho,1197771,774888,723850,51038
2012-10-01,Illinois,10005658,6619262,6049110,570152
2012-10-01,Indiana,5042788,3178772,2933347,245425
2012-10-01,Iowa,2394680,1668656,1594907,73749
2012-10-01,Kansas,2177847,1495395,1416612,78783
2012-10-01,Kentucky,3396151,2069946,1912423,157523
2012-10-01,Louisiana,3510000,2100626,1970659,129967
2012-10-01,Maine,1083447,706877,661341,45536
2012-10-01,Maryland,4614496,3145271,2937984,207287
2012-10-01,Massachusetts,5369430,3513019,3293343,219676
2012-10-01,Michigan,7804152,4708436,4317106,391330
2012-10-01,Minnesota,4195557,2966551,2821425,145126
2012-10-01,Mississippi,2257102,1329504,1219583,109921
2012-10-01,Missouri,4677466,3009857,2817259,192598
2012-10-01,Montana,793568,508466,482536,25930
2012-10-01,Nebraska,1414318,1018354,982743,35611
2012-10-01,Nevada,2132662,1373258,1224109,149149
2012-10-01,Ohio,9035065,5740365,5356150,384215
2012-10-01,Oklahoma,2902708,1810575,1719705,90870
2012-10-01,Oregon,3107259,1962747,1802232,160515
2012-10-01,Pennsylvania,10167893,6483015,6014687,468328
2012-10-01,Tennessee,5034781,3110363,2875040,235323
2012-10-01,Texas,19434632,12708718,11918645,790073
2012-10-01,Utah,2036856,1366657,1306418,60239
2012-10-01,Vermont,511935,353717,339662,14055
2012-10-01,Virginia,6340613,4232441,3999943,232498
2012-10-01,Washington,5400070,3483888,3248783,235105
2012-10-01,Wisconsin,4488898,3076204,2893368,182836
2012-10-01,Wyoming,445861,304889,289953,14936
2012-11-01,Alabama,3754422,2182863,2024890,157973
2012-11-01,Alaska,536679,360741,335681,25060
2012-11-01,Arizona,5037642,3061046,2827810,233236
2012-11-01,Arkansas,2271525,1332497,1245636,86861
2012-11-01,California,29427545,18530870,16766409,1764461
2012-11-01,Colorado,4020894,2749545,2552515,197030
2012-11-01,Connecticut,2851060,1865471,1722614,142857
2012-11-01,Delaware,722434,445200,416711,28489
2012-11-01,Florida,15529025,9330920,8589333,741587
2012-11-01,Georgia,7510285,4770446,4377966,392480
2012-11-01,Hawaii,1069163,648919,615754,33165
2012-11-01,Idaho,1199143,771970,718300,53670
2012-11-01,Illinois,10009289,6576257,6021443,554814
2012-11-01,Indiana,5045719,3158250,2908113,250137
2012-11-01,Iowa,2396074,1659762,1586208,73554
2012-11-01,Kansas,2178728,1491821,1415924,75897
2012-11-01,Kentucky,3398358,2067884,1915125,152759
2012-11-01,Louisiana,3512113,2087330,1970342,116988
2012-11-01,Maine,1083716,697483,650443,47040
2012-11-01,Maryland,4617887,3127085,2925129,201956
2012-11-01,Massachusetts,5374322,3499442,3285047,214395
2012-11-01,Michigan,7807358,4679977,4304029,375948
2012-11-01,Minnesota,4198575,2954155,2812762,141393
2012-11-01,Mississippi,2258163,1320062,1217416,102646
2012-11-01,Missouri,4679343,2989281,2798487,190794
2012-11-01,Montana,794361,505332,478569,26763
2012-11-01,Nebraska,1415169,1015893,981881,34012
2012-11-01,Nevada,2135395,1365167,1222465,142702
2012-11-01,Ohio,9038657,5692765,5308857,383908
2012-11-01,Oklahoma,2905208,1807129,1720271,86858
2012-11-01,Oregon,3109580,1945312,1788626,156686
2012-11-01,Pennsylvania,10170070,6455164,5995478,459686
2012-11-01,Tennessee,5038650,3100538,2874019,226519
2012-11-01,Texas,19465766,12709521,11940573,768948
2012-11-01,Utah,2040092,1368511,1310653,57858
2012-11-01,Vermont,512079,352594,337323,15271
2012-11-01,Virginia,6346515,4204093,3980546,223547
2012-11-01,Washington,5405191,3457111,3225158,231953
2012-11-01,Wisconsin,4491084,3069353,2880225,189128
2012-11-01,Wyoming,446255,303413,287893,15520
2012-12-01,Alabama,3756121,2180549,2018451,162098
2012-12-01,Alaska,537018,361462,334494,26968
2012-12-01,Arizona,5044028,3055503,2814674,240829
2012-12-01,Arkansas,2272297,1329177,1234760,94417
2012-12-01,California,29455494,18525974,16731162,1794812
2012-12-01,Colorado,4026842,2754354,2554503,199851
2012-12-01,Connecticut,2851914,1857786,1712963,144823
2012-12-01,Delaware,723135,445712,415845,29867
2012-12-01,Florida,15548277,9351196,8607056,744140
2012-12-01,Georgia,7516903,4778040,4369611,408429
2012-12-01,Hawaii,1070064,648365,617191,31174
2012-12-01,Idaho,1200386,771070,715458,55612
2012-12-01,Illinois,10012126,6575945,5986688,589257
2012-12-01,Indiana,5048319,3154360,2897164,257196
2012-12-01,Iowa,2397326,1655260,1572096,83164
2012-12-01,Kansas,2179407,1489330,1410923,78407
2012-12-01,Kentucky,3400281,2071457,1910618,160839
2012-12-01,Louisiana,3514047,2083548,1956634,126914
2012-12-01,Maine,1083895,699153,649062,50091
2012-12-01,Maryland,4621036,3125340,2920229,205111
2012-12-01,Massachusetts,5378843,3499145,3273792,225353
2012-12-01,Michigan,7810081,4692500,4284030,408470
2012-12-01,Minnesota,4201294,2950597,2790867,159730
2012-12-01,Mississippi,2259083,1327597,1215573,112024
2012-12-01,Missouri,4680944,2994135,2790836,203299
2012-12-01,Montana,795056,503225,474242,28983
2012-12-01,Nebraska,1415931,1014400,976792,37608
2012-12-01,Nevada,2137941,1364095,1216505,147590
2012-12-01,Ohio,9041658,5665602,5259071,406531
2012-12-01,Oklahoma,2907466,1797445,1707013,90432
2012-12-01,Oregon,3111712,1930461,1767199,163262
2012-12-01,Pennsylvania,10171681,6440767,5963949,476818
2012-12-01,Tennessee,5042229,3103875,2865545,238330
2012-12-01,Texas,19495239,12709575,11916186,793389
2012-12-01,Utah,2043202,1363870,1304925,58945
2012-12-01,Vermont,512177,351121,335431,15690
2012-12-01,Virginia,6351838,4204911,3976188,228723
2012-12-01,Washington,5409915,3449836,3204752,245084
2012-12-01,Wisconsin,4493010,3062536,2858766,203770
2012-12-01,Wyoming,446641,300938,285178,15760
2013-01-01,Alabama,3757648,2166149,1984853,181296
2013-01-01,Alaska,537343,359484,329822,29662
2013-01-01,Arizona,5050211,3058118,2802014,256104
2013-01-01,Arkansas,2272945,1319137,1210884,108253
2013-01-01,California,29482749,18542823,16623917,1918906
2013-01-01,Colorado,4032567,2752562,2534557,218005
2013-01-01,Connecticut,2852640,1857992,1689081,168911
2013-01-01,Delaware,723860,443024,408542,34482
2013-01-01,Florida,15566837,9350219,8560940,789279
2013-01-01,Georgia,7523422,4776720,4344974,431746
2013-01-01,Hawaii,1070910,647739,613864,33875
2013-01-01,Idaho,1201563,767452,703817,63635
2013-01-01,Illinois,10014774,6557876,5890504,667372
2013-01-01,Indiana,5050615,3163746,2870924,292822
2013-01-01,Iowa,2398438,1651741,1551528,100213
2013-01-01,Kansas,2179995,1484759,1394512,90247
2013-01-01,Kentucky,3402047,2056223,1875168,181055
2013-01-01,Louisiana,3515759,2081929,1926256,155673
2013-01-01,Maine,1084015,695897,637739,58158
2013-01-01,Maryland,4623925,3121507,2892541,228966
2013-01-01,Massachusetts,5383100,3496645,3231460,265185
2013-01-01,Michigan,7812340,4681374,4222916,458458
2013-01-01,Minnesota,4203761,2949478,2761306,188172
2013-01-01,Mississippi,2259916,1305792,1182072,123720
2013-01-01,Missouri,4682302,2985325,2755643,229682
2013-01-01,Montana,795706,504640,470026,34614
2013-01-01,Nebraska,1416648,1009313,964797,44516
2013-01-01,Nevada,2140368,1366071,1209796,156275
2013-01-01,Ohio,9044122,5641801,5149345,492456
2013-01-01,Oklahoma,2909622,1791719,1690751,100968
2013-01-01,Oregon,3113662,1917876,1736639,181237
2013-01-01,Pennsylvania,10172653,6437518,5895605,541913
2013-01-01,Tennessee,5045479,3082594,2814884,267710
2013-01-01,Texas,19524317,12706990,11817191,889799
2013-01-01,Utah,2046163,1363678,1296496,67182
2013-01-01,Vermont,512268,351150,332493,18657
2013-01-01,Virginia,6356655,4201870,3939972,261898
2013-01-01,Washington,5414242,3451416,3177504,273912
2013-01-01,Wisconsin,4494635,3050140,2811136,239004
2013-01-01,Wyoming,446965,301118,282176,18942
2013-02-01,Alabama,3758678,2167544,1994342,173202
2013-02-01,Alaska,537489,361132,332657,28475
2013-02-01,Arizona,5055713,3046851,2809702,237149
2013-02-01,Arkansas,2273256,1328578,1225077,103501
2013-02-01,California,29506019,18550240,16732495,1817745
2013-02-01,Colorado,4037908,2760867,2547614,213253
2013-02-01,Connecticut,2852925,1846667,1685688,160979
2013-02-01,Delaware,724430,441818,409061,32757
2013-02-01,Florida,15582898,9321733,8593157,728576
2013-02-01,Georgia,7528788,4752279,4344373,407906
2013-02-01,Hawaii,1071588,646550,614984,31566
2013-02-01,Idaho,1202567,769054,708304,60750
2013-02-01,Illinois,10015870,6544227,5896172,648055
2013-02-01,Indiana,5052297,3157824,2880137,277687
2013-02-01,Iowa,2399210,1658189,1567011,91178
2013-02-01,Kansas,2180283,1486984,1400026,86958
2013-02-01,Kentucky,3403390,2052119,1874834,177285
2013-02-01,Louisiana,3517123,2076145,1942912,133233
2013-02-01,Maine,1083932,694192,637991,56201
2013-02-01,Maryland,4626344,3113409,2894879,218530
2013-02-01,Massachusetts,5386735,3491781,3239531,252250
2013-02-01,Michigan,7813604,4688298,4249376,438922
2013-02-01,Minnesota,4205765,2949299,2773702,175597
2013-02-01,Mississippi,2260438,1297989,1183321,114668
2013-02-01,Missouri,4682883,2987802,2762018,225784
2013-02-01,Montana,796277,506196,474488,31708
2013-02-01,Nebraska,1417132,1012136,970208,41928
2013-02-01,Nevada,2142588,1368694,1223557,145137
2013-02-01,Ohio,9045438,5648702,5182145,466557
2013-02-01,Oklahoma,2911344,1787858,1691888,95970
2013-02-01,Oregon,3115248,1920500,1749691,170809
2013-02-01,Pennsylvania,10172294,6405544,5895629,509915
2013-02-01,Tennessee,5048169,3079754,2826229,253525
2013-02-01,Texas,19550750,12740598,11899391,841207
2013-02-01,Utah,2048975,1367840,1302777,65063
2013-02-01,Vermont,512289,349580,332426,17154
2013-02-01,Virginia,6360904,4212302,3964995,247307
2013-02-01,Washington,5418035,3450483,3196253,254230
2013-02-01,Wisconsin,4495713,3063035,2824261,238774
2013-02-01,Wyoming,447276,299629,282985,16644
2013-03-01,Alabama,3759971,2164602,2005801,158801
2013-03-01,Alaska,537668,359096,332324,26772
2013-03-01,Arizona,5061297,3048183,2814226,233957
2013-03-01,Arkansas,2273760,1328711,1234395,94316
2013-03-01,California,29528672,18493096,16743087,1750009
2013-03-01,Colorado,4043296,2744111,2546883,197228
2013-03-01,Connecticut,2853432,1847852,1695449,152403
2013-03-01,Delaware,725014,442378,411285,31093
2013-03-01,Florida,15599379,9313922,8614147,699775
2013-03-01,Georgia,7534514,4748733,4360955,387778
2013-03-01,Hawaii,1071995,646806,616750,30056
2013-03-01,Idaho,1203694,769655,711381,58274
2013-03-01,Illinois,10017644,6519385,5915544,603841
2013-03-01,Indiana,5054512,3153844,2893419,260425
2013-03-01,Iowa,2400220,1655116,1568187,86929
2013-03-01,Kansas,2180605,1481248,1399528,81720
2013-03-01,Kentucky,3404973,2061248,1888774,172474
2013-03-01,Louisiana,3518645,2082866,1951316,131550
2013-03-01,Maine,1084035,693588,641130,52458
2013-03-01,Maryland,4628785,3120278,2912061,208217
2013-03-01,Massachusetts,5390711,3495080,3255516,239564
2013-03-01,Michigan,7815609,4690423,4265732,424691
2013-03-01,Minnesota,4208174,2949147,2779539,169608
2013-03-01,Mississippi,2261049,1287371,1182567,104804
2013-03-01,Missouri,4683981,2989968,2776279,213689
2013-03-01,Montana,796883,507179,476349,30830
2013-03-01,Nebraska,1417718,1011941,973030,38911
2013-03-01,Nevada,2144822,1363978,1223210,140768
2013-03-01,Ohio,9047646,5649356,5215064,434292
2013-03-01,Oklahoma,2913218,1789732,1700948,88784
2013-03-01,Oregon,3117028,1913654,1750756,162898
2013-03-01,Pennsylvania,10172856,6374380,5899764,474616
2013-03-01,Tennessee,5051173,3079406,2835905,243501
2013-03-01,Texas,19577084,12730449,11921682,808767
2013-03-01,Utah,2051950,1368277,1307258,61019
2013-03-01,Vermont,512344,350007,333271,16736
2013-03-01,Virginia,6364931,4224919,3990934,233985
2013-03-01,Washington,5421904,3444429,3207166,237263
2013-03-01,Wisconsin,4497218,3056214,2831222,224992
2013-03-01,Wyoming,447597,299900,284357,15543
2013-04-01,Alabama,3761425,2168390,2025368,143022
2013-04-01,Alaska,537746,358484,333255,25229
2013-04-01,Arizona,5067183,3043631,2815538,228093
2013-04-01,Arkansas,2274396,1336055,1247758,88297
2013-04-01,California,29553252,18474149,16847108,1627041
2013-04-01,Colorado,4048786,2744964,2560632,184332
2013-04-01,Connecticut,2854082,1842828,1701198,141630
2013-04-01,Delaware,725670,443513,414477,29036
2013-04-01,Florida,15616676,9355458,8678051,677407
2013-04-01,Georgia,7540542,4739591,4368630,370961
2013-04-01,Hawaii,1072314,648776,619782,28994
2013-04-01,Idaho,1204876,770756,716498,54258
2013-04-01,Illinois,10020076,6515201,5947707,567494
2013-04-01,Indiana,5056968,3172523,2940609,231914
2013-04-01,Iowa,2401380,1662122,1585263,76859
2013-04-01,Kansas,2180991,1488145,1413849,74296
2013-04-01,Kentucky,3406648,2061826,1906375,155451
2013-04-01,Louisiana,3520231,2096560,1968038,128522
2013-04-01,Maine,1084137,697821,648411,49410
2013-04-01,Maryland,4631489,3115391,2922976,192415
2013-04-01,Massachusetts,5395058,3497541,3276190,221351
2013-04-01,Michigan,7818028,4675510,4286525,388985
2013-04-01,Minnesota,4210788,2954761,2802859,151902
2013-04-01,Mississippi,2261758,1283153,1182886,100267
2013-04-01,Missouri,4685292,3011828,2823879,187949
2013-04-01,Montana,797508,508347,481468,26879
2013-04-01,Nebraska,1418345,1020814,984620,36194
2013-04-01,Nevada,2147154,1364260,1227713,136547
2013-04-01,Ohio,9050334,5677345,5277797,399548
2013-04-01,Oklahoma,2915228,1790845,1708301,82544
2013-04-01,Oregon,3119039,1911948,1764816,147132
2013-04-01,Pennsylvania,10173942,6391570,5957662,433908
2013-04-01,Tennessee,5054403,3087605,2858039,229566
2013-04-01,Texas,19604472,12793831,12020349,773482
2013-04-01,Utah,2055016,1370125,1313778,56347
2013-04-01,Vermont,512436,347582,331350,16232
2013-04-01,Virginia,6368944,4231856,4013177,218679
2013-04-01,Washington,5425892,3436277,3219642,216635
2013-04-01,Wisconsin,4499003,3064350,2850233,214117
2013-04-01,Wyoming,447925,300384,284903,15481
2013-05-01,Alabama,3763029,2172735,2023461,149274
2013-05-01,Alaska,538284,365088,339791,25297
2013-05-01,Arizona,5073301,3056003,2823037,232966
2013-05-01,Arkansas,2275077,1344642,1249495,95147
2013-05-01,California,29579760,18571033,16958696,1612337
2013-05-01,Colorado,4054895,2761017,2574384,186633
2013-05-01,Connecticut,2854892,1875826,1724564,151262
2013-05-01,Delaware,726339,441801,413354,28447
2013-05-01,Florida,15635293,9456250,8754484,701766
2013-05-01,Georgia,7547515,4773520,4384520,389000
2013-05-01,Hawaii,1073510,649774,620329,29445
2013-05-01,Idaho,1206138,777351,727167,50184
2013-05-01,Illinois,10022943,6565783,5986130,579653
2013-05-01,Indiana,5059482,3195725,2954483,241242
2013-05-01,Iowa,2402634,1671066,1596059,75007
2013-05-01,Kansas,2181864,1489938,1410580,79358
2013-05-01,Kentucky,3408721,2071134,1907096,164038
2013-05-01,Louisiana,3522141,2107056,1969400,137656
2013-05-01,Maine,1084318,701986,654839,47147
2013-05-01,Maryland,4634490,3135589,2931092,204497
2013-05-01,Massachusetts,5399486,3510815,3278654,232161
2013-05-01,Michigan,7820362,4759097,4349573,409524
2013-05-01,Minnesota,4213509,2968911,2828313,140598
2013-05-01,Mississippi,2262701,1285788,1174496,111292
2013-05-01,Missouri,4687010,3030270,2829132,201138
2013-05-01,Montana,798209,513277,488306,24971
2013-05-01,Nebraska,1419166,1023825,986827,36998
2013-05-01,Nevada,2149619,1373968,1237207,136761
2013-05-01,Ohio,9053073,5735103,5319993,415110
2013-05-01,Oklahoma,2917592,1811296,1717237,94059
2013-05-01,Oregon,3121022,1917010,1775098,141912
2013-05-01,Pennsylvania,10175207,6448955,5998081,450874
2013-05-01,Tennessee,5057965,3095492,2859583,235909
2013-05-01,Texas,19633581,12840382,12032047,808335
2013-05-01,Utah,2058133,1382891,1326081,56810
2013-05-01,Vermont,512553,349164,333912,15252
2013-05-01,Virginia,6375248,4258345,4020033,238312
2013-05-01,Washington,5430881,3447150,3223949,223201
2013-05-01,Wisconsin,4500856,3069225,2871022,198203
2013-05-01,Wyoming,448342,301113,287706,13407
2013-06-01,Alabama,3764923,2195506,2023617,171889
2013-06-01,Alaska,538281,371156,344375,26781
2013-06-01,Arizona,5079772,3079941,2822419,257522
2013-06-01,Arkansas,2276045,1353444,1252025,101419
2013-06-01,California,29606950,18649655,16902095,1747560
2013-06-01,Colorado,4060727,2792928,2590122,202806
2013-06-01,Connecticut,2855924,1891897,1733429,158468
2013-06-01,Delaware,727078,446136,414510,31626
2013-06-01,Florida,15654708,9475272,8725303,749969
2013-06-01,Georgia,7554106,4785790,4364481,421309
2013-06-01,Hawaii,1073629,654548,619479,35069
2013-06-01,Idaho,1207515,786384,734763,51621
2013-06-01,Illinois,10026812,6660396,6015357,645039
2013-06-01,Indiana,5062772,3239388,2982785,256603
2013-06-01,Iowa,2404245,1693386,1611044,82342
2013-06-01,Kansas,2182471,1507425,1422424,85001
2013-06-01,Kentucky,3410807,2095146,1915233,179913
2013-06-01,Louisiana,3524095,2141506,1977971,163535
2013-06-01,Maine,1084636,715205,667831,47374
2013-06-01,Maryland,4637576,3169543,2946568,222975
2013-06-01,Massachusetts,5404700,3569503,3317677,251826
2013-06-01,Michigan,7823981,4815191,4367221,447970
2013-06-01,Minnesota,4216855,2989204,2832105,157099
2013-06-01,Mississippi,2263641,1291557,1167033,124524
2013-06-01,Missouri,4689032,3064231,2847099,217132
2013-06-01,Montana,798963,519576,491135,28441
2013-06-01,Nebraska,1420027,1028893,987118,41775
2013-06-01,Nevada,2152150,1378180,1234255,143925
2013-06-01,Ohio,9057146,5801995,5341891,460104
2013-06-01,Oklahoma,2919929,1823127,1721443,101684
2013-06-01,Oregon,3123530,1938108,1782355,155753
2013-06-01,Pennsylvania,10178028,6505615,6021891,483724
2013-06-01,Tennessee,5061823,3122830,2858237,264593
2013-06-01,Texas,19662766,12901373,12013470,887903
2013-06-01,Utah,2061510,1395322,1330260,65062
2013-06-01,Vermont,512724,354893,338134,16759
2013-06-01,Virginia,6379556,4285648,4032744,252904
2013-06-01,Washington,5435401,3476695,3244457,232238
2013-06-01,Wisconsin,4503389,3137576,2914317,223259
2013-06-01,Wyoming,448731,306664,292664,14000
2013-07-01,Alabama,3766869,2193265,2025875,167390
2013-07-01,Alaska,538697,372727,348993,23734
2013-07-01,Arizona,5086380,3076864,2820644,256220
2013-07-01,Arkansas,2276997,1349442,1248224,101218
2013-07-01,California,29635123,18686237,16924071,1762166
2013-07-01,Colorado,4067025,2788421,2598963,189458
2013-07-01,Connecticut,2857034,1911533,1752930,158603
2013-07-01,Delaware,727812,446678,415861,30817
2013-07-01,Florida,15674637,9488774,8743278,745496
2013-07-01,Georgia,7560981,4786041,4374131,411910
2013-07-01,Hawaii,1074519,653312,622311,31001
2013-07-01,Idaho,1208893,789380,737097,52283
2013-07-01,Illinois,10030317,6645224,6020723,624501
2013-07-01,Indiana,5065926,3230052,2983991,246061
2013-07-01,Iowa,2405753,1708042,1628343,79699
2013-07-01,Kansas,2183388,1513490,1422482,91008
2013-07-01,Kentucky,3413114,2077908,1903757,174151
2013-07-01,Louisiana,3526293,2134784,1982562,152222
2013-07-01,Maine,1084942,723427,677788,45639
2013-07-01,Maryland,4640951,3181388,2966250,215138
2013-07-01,Massachusetts,5409770,3576209,3326196,250013
2013-07-01,Michigan,7827369,4821733,4349371,472362
2013-07-01,Minnesota,4220108,2983097,2832703,150394
2013-07-01,Mississippi,2264709,1285173,1168164,117009
2013-07-01,Missouri,4691093,3063484,2839716,223768
2013-07-01,Montana,799737,518993,492946,26047
2013-07-01,Nebraska,1420974,1030920,989193,41727
2013-07-01,Nevada,2154816,1381532,1240470,141062
2013-07-01,Ohio,9061057,5794098,5348982,445116
2013-07-01,Oklahoma,2922377,1809550,1714594,94956
2013-07-01,Oregon,3125928,1945140,1789537,155603
2013-07-01,Pennsylvania,10180604,6523638,6032566,491072
2013-07-01,Tennessee,5065824,3114292,2858643,255649
2013-07-01,Texas,19692871,12909311,12046790,862521
2013-07-01,Utah,2064852,1399056,1338829,60227
2013-07-01,Vermont,512904,354927,339215,15712
2013-07-01,Virginia,6385274,4298779,4050645,248134
2013-07-01,Washington,5440583,3485280,3256059,229221
2013-07-01,Wisconsin,4505801,3130869,2920950,209919
2013-07-01,Wyoming,449152,306272,293063,13209
2013-08-01,Alabama,3768499,2181297,2018268,163029
2013-08-01,Alaska,539112,368508,346314,22194
2013-08-01,Arizona,5094765,3070323,2816336,253987
2013-08-01,Arkansas,2278011,1332130,1238697,93433
2013-08-01,California,29665950,18607422,16928001,1679421
2013-08-01,Colorado,4073981,2781211,2600781,180430
2013-08-01,Connecticut,2858175,1881016,1728611,152405
2013-08-01,Delaware,728676,445161,415436,29725
2013-08-01,Florida,15699539,9463511,8732319,731192
2013-08-01,Georgia,7568874,4729502,4341637,387865
2013-08-01,Hawaii,1075489,649509,619766,29743
2013-08-01,Idaho,1210463,781626,730977,50649
2013-08-01,Illinois,10032173,6571415,5977813,593602
2013-08-01,Indiana,5068571,3214225,2985560,228665
2013-08-01,Iowa,2407129,1694157,1617748,76409
2013-08-01,Kansas,2184718,1483693,1401579,82114
2013-08-01,Kentucky,3414664,2056884,1899948,156936
2013-08-01,Louisiana,3528368,2109562,1967302,142260
2013-08-01,Maine,1085388,720544,678730,41814
2013-08-01,Maryland,4643937,3138457,2934008,204449
2013-08-01,Massachusetts,5414595,3562055,3329450,232605
2013-08-01,Michigan,7830628,4783809,4365274,418535
2013-08-01,Minnesota,4223049,2964588,2824264,140324
2013-08-01,Mississippi,2265558,1255656,1147462,108194
2013-08-01,Missouri,4693101,3017707,2805675,212032
2013-08-01,Montana,800442,516768,491763,25005
2013-08-01,Nebraska,1422003,1013265,977593,35672
2013-08-01,Nevada,2158236,1372404,1237246,135158
2013-08-01,Ohio,9064677,5754589,5336888,417701
2013-08-01,Oklahoma,2924485,1798266,1706853,91413
2013-08-01,Oregon,3129332,1941040,1794006,147034
2013-08-01,Pennsylvania,10183403,6456787,5988835,467952
2013-08-01,Tennessee,5069972,3069872,2832124,237748
2013-08-01,Texas,19728313,12854671,12034343,820328
2013-08-01,Utah,2067849,1395533,1335099,60434
2013-08-01,Vermont,512966,352399,337903,14496
2013-08-01,Virginia,6391397,4247481,4006100,241381
2013-08-01,Washington,5448331,3469581,3245439,224142
2013-08-01,Wisconsin,4507808,3099111,2902473,196638
2013-08-01,Wyoming,449222,303881,291521,12360
2013-09-01,Alabama,3770214,2171998,2015988,156010
2013-09-01,Alaska,539171,365611,342897,22714
2013-09-01,Arizona,5103215,3083259,2840414,242845
2013-09-01,Arkansas,2279106,1331589,1241722,89867
2013-09-01,California,29696653,18658696,17059231,1599465
2013-09-01,Colorado,4080567,2781098,2608936,172162
2013-09-01,Connecticut,2859384,1871259,1728824,142435
2013-09-01,Delaware,729578,440754,413234,27520
2013-09-01,Florida,15724553,9495677,8787818,707859
2013-09-01,Georgia,7576721,4741377,4371498,369879
2013-09-01,Hawaii,1075926,650812,619026,31786
2013-09-01,Idaho,1212088,781403,731816,49587
2013-09-01,Illinois,10034545,6542765,5979243,563522
2013-09-01,Indiana,5071500,3195955,2979591,216364
2013-09-01,Iowa,2408648,1689749,1617677,72072
2013-09-01,Kansas,2185822,1486027,1413630,72397
2013-09-01,Kentucky,3416171,2050577,1895205,155372
2013-09-01,Louisiana,3530459,2104587,1971555,133032
2013-09-01,Maine,1085923,706864,665733,41131
2013-09-01,Maryland,4646932,3124371,2931437,192934
2013-09-01,Massachusetts,5419749,3501817,3273048,228769
2013-09-01,Michigan,7834323,4758587,4363532,395055
2013-09-01,Minnesota,4226279,2963535,2832581,130954
2013-09-01,Mississippi,2266375,1256664,1152474,104190
2013-09-01,Missouri,4695256,3003566,2814873,188693
2013-09-01,Montana,801146,511316,488363,22953
2013-09-01,Nebraska,1423047,1006211,972431,33780
2013-09-01,Nevada,2161607,1375850,1243796,132054
2013-09-01,Ohio,9068774,5705810,5293217,412593
2013-09-01,Oklahoma,2926590,1805800,1714463,91337
2013-09-01,Oregon,3132931,1929109,1796293,132816
2013-09-01,Pennsylvania,10186846,6410576,5984117,426459
2013-09-01,Tennessee,5074160,3061501,2831425,230076
2013-09-01,Texas,19763523,12895648,12088154,807494
2013-09-01,Utah,2070938,1397133,1342778,54355
2013-09-01,Vermont,513076,348955,334185,14770
2013-09-01,Virginia,6396539,4233963,4001887,232076
2013-09-01,Washington,5455719,3467788,3254798,212990
2013-09-01,Wisconsin,4510094,3076025,2894020,182005
2013-09-01,Wyoming,449293,303232,290997,12235
2013-10-01,Alabama,3771896,2165825,2011142,154683
2013-10-01,Alaska,539295,360939,336580,24359
2013-10-01,Arizona,5111574,3064719,2827742,236977
2013-10-01,Arkansas,2280144,1323632,1237661,85971
2013-10-01,California,29726663,18532575,16936285,1596290
2013-10-01,Colorado,4087135,2765371,2593713,171658
2013-10-01,Connecticut,2860520,1863821,1721921,141900
2013-10-01,Delaware,730453,442388,415268,27120
2013-10-01,Florida,15749207,9442562,8749974,692588
2013-10-01,Georgia,7584668,4717977,4344889,373088
2013-10-01,Hawaii,1076293,650206,618425,31781
2013-10-01,Idaho,1213707,781554,731330,50224
2013-10-01,Illinois,10036798,6524935,5958539,566396
2013-10-01,Indiana,5074366,3195912,2977816,218096
2013-10-01,Iowa,2410150,1677313,1608114,69199
2013-10-01,Kansas,2186901,1481935,1410339,71596
2013-10-01,Kentucky,3417645,2030312,1876045,154267
2013-10-01,Louisiana,3532431,2100915,1974908,126007
2013-10-01,Maine,1086416,705392,663919,41473
2013-10-01,Maryland,4649825,3120090,2917867,202223
2013-10-01,Massachusetts,5424816,3493094,3276118,216976
2013-10-01,Michigan,7837931,4733343,4347862,385481
2013-10-01,Minnesota,4229411,2955818,2830406,125412
2013-10-01,Mississippi,2267144,1242257,1140996,101261
2013-10-01,Missouri,4697387,2992970,2811844,181126
2013-10-01,Montana,801824,509758,484928,24830
2013-10-01,Nebraska,1424077,1006418,973345,33073
2013-10-01,Nevada,2164903,1369766,1240559,129207
2013-10-01,Ohio,9072686,5703885,5297459,406426
2013-10-01,Oklahoma,2928709,1796580,1702307,94273
2013-10-01,Oregon,3136440,1922671,1786203,136468
2013-10-01,Pennsylvania,10189979,6369822,5948510,421312
2013-10-01,Tennessee,5078253,3050444,2821599,228845
2013-10-01,Texas,19798357,12823726,12050883,772843
2013-10-01,Utah,2073970,1393086,1339482,53604
2013-10-01,Vermont,513176,347423,334848,12575
2013-10-01,Virginia,6401486,4224986,3991699,233287
2013-10-01,Washington,5462940,3470622,3252540,218082
2013-10-01,Wisconsin,4512294,3062186,2881260,180926
2013-10-01,Wyoming,449366,301494,288404,13090
2013-11-01,Alabama,3773384,2164179,2017319,146860
2013-11-01,Alaska,539263,361427,336269,25158
2013-11-01,Arizona,5119649,3079702,2860050,219652
2013-11-01,Arkansas,2281058,1321855,1239332,82523
2013-11-01,California,29756007,18557195,17020130,1537065
2013-11-01,Colorado,4093376,2767471,2601909,165562
2013-11-01,Connecticut,2861561,1864536,1735101,129435
2013-11-01,Delaware,731214,444199,419349,24850
2013-11-01,Florida,15772705,9407793,8751776,656017
2013-11-01,Georgia,7592498,4723649,4378629,345020
2013-11-01,Hawaii,1076475,656613,626164,30449
2013-11-01,Idaho,1215253,780848,731601,49247
2013-11-01,Illinois,10038967,6527260,5983522,543738
2013-11-01,Indiana,5077084,3215846,3002981,212865
2013-11-01,Iowa,2411521,1681097,1612616,68481
2013-11-01,Kansas,2187720,1487865,1420435,67430
2013-11-01,Kentucky,3418877,2035383,1890496,144887
2013-11-01,Louisiana,3534161,2104277,1989276,115001
2013-11-01,Maine,1086870,700291,656943,43348
2013-11-01,Maryland,4652421,3111578,2926264,185314
2013-11-01,Massachusetts,5429678,3504612,3297772,206840
2013-11-01,Michigan,7841202,4729365,4365720,363645
2013-11-01,Minnesota,4232451,2959240,2835467,123773
2013-11-01,Mississippi,2267787,1245045,1149460,95585
2013-11-01,Missouri,4699421,2992009,2811710,180299
2013-11-01,Montana,802467,510838,485219,25619
2013-11-01,Nebraska,1424973,1008054,977371,30683
2013-11-01,Nevada,2168144,1370550,1248012,122538
2013-11-01,Ohio,9076263,5707261,5319513,387748
2013-11-01,Oklahoma,2930743,1803315,1715333,87982
2013-11-01,Oregon,3139813,1927100,1795172,131928
2013-11-01,Pennsylvania,10192700,6368267,5967137,401130
2013-11-01,Tennessee,5082093,3061999,2849652,212347
2013-11-01,Texas,19832481,12908869,12166279,742590
2013-11-01,Utah,2076934,1402785,1352331,50454
2013-11-01,Vermont,513249,349133,335005,14128
2013-11-01,Virginia,6405584,4224587,4007230,217357
2013-11-01,Washington,5469691,3471591,3255231,216360
2013-11-01,Wisconsin,4514392,3067691,2886806,180885
2013-11-01,Wyoming,449390,302407,288743,13664
2013-12-01,Alabama,3774572,2153731,2007899,145832
2013-12-01,Alaska,539431,358870,333968,24902
2013-12-01,Arizona,5127350,3067056,2851975,215081
2013-12-01,Arkansas,2281785,1310081,1226032,84049
2013-12-01,California,29783733,18461766,16979247,1482519
2013-12-01,Colorado,4099604,2753658,2596318,157340
2013-12-01,Connecticut,2862341,1853308,1729209,124099
2013-12-01,Delaware,732002,444769,420205,24564
2013-12-01,Florida,15795270,9404806,8781477,623329
2013-12-01,Georgia,7600196,4725377,4380789,344588
2013-12-01,Hawaii,1077144,657088,629182,27906
2013-12-01,Idaho,1216693,775808,729788,46020
2013-12-01,Illinois,10040361,6504649,5963157,541492
2013-12-01,Indiana,5079216,3189156,2991772,197384
2013-12-01,Iowa,2412622,1676810,1602082,74728
2013-12-01,Kansas,2188613,1481227,1416258,64969
2013-12-01,Kentucky,3419898,2021987,1880398,141589
2013-12-01,Louisiana,3535754,2083492,1979558,103934
2013-12-01,Maine,1087193,695671,653643,42028
2013-12-01,Maryland,4654826,3095297,2919567,175730
2013-12-01,Massachusetts,5433952,3501116,3296114,205002
2013-12-01,Michigan,7843590,4706302,4347818,358484
2013-12-01,Minnesota,4234970,2953664,2816187,137477
2013-12-01,Mississippi,2268395,1240239,1147052,93187
2013-12-01,Missouri,4701109,2995211,2807506,187705
2013-12-01,Montana,803034,507497,480581,26916
2013-12-01,Nebraska,1425825,1006172,973032,33140
2013-12-01,Nevada,2171241,1363471,1242428,121043
2013-12-01,Ohio,9078805,5661377,5295208,366169
2013-12-01,Oklahoma,2932602,1786211,1702520,83691
2013-12-01,Oregon,3142820,1912147,1781104,131043
2013-12-01,Pennsylvania,10194255,6345373,5955761,389612
2013-12-01,Tennessee,5085584,3040922,2835208,205714
2013-12-01,Texas,19865772,12878571,12176680,701891
2013-12-01,Utah,2079764,1395170,1345552,49618
2013-12-01,Vermont,513269,346885,333466,13419
2013-12-01,Virginia,6410731,4215791,4005270,210521
2013-12-01,Washington,5476537,3457949,3238324,219625
2013-12-01,Wisconsin,4515931,3057183,2876151,181032
2013-12-01,Wyoming,449393,300319,285981,14338
2014-01-01,Alabama,3775896,2150089,1987422,162667
2014-01-01,Alaska,539619,359562,331954,27608
2014-01-01,Arizona,5135007,3074916,2852543,222373
2014-01-01,Arkansas,2282487,1301905,1210199,91706
2014-01-01,California,29812266,18496360,16922635,1573725
2014-01-01,Colorado,4105799,2760249,2586058,174191
2014-01-01,Connecticut,2863185,1867295,1724789,142506
2014-01-01,Delaware,732837,445393,416871,28522
2014-01-01,Florida,15818006,9431721,8775597,656124
2014-01-01,Georgia,7608115,4730357,4373925,356432
2014-01-01,Hawaii,1077742,660725,630540,30185
2014-01-01,Idaho,1218117,772453,721749,50704
2014-01-01,Illinois,10041949,6500249,5920699,579550
2014-01-01,Indiana,5081350,3172684,2958882,213802
2014-01-01,Iowa,2413708,1673798,1585498,88300
2014-01-01,Kansas,2189481,1482431,1408479,73952
2014-01-01,Kentucky,3420974,2014292,1854655,159637
2014-01-01,Louisiana,3537379,2077769,1957994,119775
2014-01-01,Maine,1087515,692314,643638,48676
2014-01-01,Maryland,4657298,3097341,2901440,195901
2014-01-01,Massachusetts,5438307,3505358,3270467,234891
2014-01-01,Michigan,7846050,4705473,4309248,396225
2014-01-01,Minnesota,4237487,2946420,2785240,161180
2014-01-01,Mississippi,2269079,1238130,1134468,103662
2014-01-01,Missouri,4702832,3000276,2786484,213792
2014-01-01,Montana,803600,506069,475957,30112
2014-01-01,Nebraska,1426584,1004994,966907,38087
2014-01-01,Nevada,2174343,1366558,1241153,125405
2014-01-01,Ohio,9081389,5631860,5214929,416931
2014-01-01,Oklahoma,2934523,1784254,1694675,89579
2014-01-01,Oregon,3145835,1917894,1772083,145811
2014-01-01,Pennsylvania,10195861,6349260,5918629,430631
2014-01-01,Tennessee,5089069,3025858,2811555,214303
2014-01-01,Texas,19899461,12862297,12117981,744316
2014-01-01,Utah,2082531,1397032,1341020,56012
2014-01-01,Vermont,513280,348055,332088,15967
2014-01-01,Virginia,6415418,4226372,3989618,236754
2014-01-01,Washington,5483240,3455705,3222927,232778
2014-01-01,Wisconsin,4517494,3043168,2852591,190577
2014-01-01,Wyoming,449367,300163,284285,15878
2014-02-01,Alabama,3776877,2161568,1997848,163720
2014-02-01,Alaska,539509,360885,332193,28692
2014-02-01,Arizona,5142282,3078540,2863675,214865
2014-02-01,Arkansas,2283060,1318878,1227147,91731
2014-02-01,California,29837518,18605215,17033754,1571461
2014-02-01,Colorado,4111541,2785904,2608241,177663
2014-02-01,Connecticut,2863789,1862505,1720499,142006
2014-02-01,Delaware,733503,446428,417942,28486
2014-02-01,Florida,15838937,9467751,8827559,640192
2014-02-01,Georgia,7615165,4746876,4389279,357597
2014-02-01,Hawaii,1077845,659528,629810,29718
2014-02-01,Idaho,1219442,772167,724930,47237
2014-02-01,Illinois,10042715,6523053,5944396,578657
2014-02-01,Indiana,5083309,3190134,2967352,222782
2014-02-01,Iowa,2414682,1684241,1599461,84780
2014-02-01,Kansas,2190055,1491656,1414471,77185
2014-02-01,Kentucky,3421719,2017369,1852145,165224
2014-02-01,Louisiana,3538761,2083083,1973656,109427
2014-02-01,Maine,1087757,693066,643871,49195
2014-02-01,Maryland,4659350,3101090,2904390,196700
2014-02-01,Massachusetts,5442411,3525415,3290774,234641
2014-02-01,Michigan,7848175,4735195,4332757,402438
2014-02-01,Minnesota,4239854,2951810,2791504,160306
2014-02-01,Mississippi,2269514,1239456,1138801,100655
2014-02-01,Missouri,4704124,3019168,2793550,225618
2014-02-01,Montana,804113,509421,480443,28978
2014-02-01,Nebraska,1427283,1010531,971842,38689
2014-02-01,Nevada,2177240,1377291,1254436,122855
2014-02-01,Ohio,9083600,5642512,5241958,400554
2014-02-01,Oklahoma,2936088,1786885,1697329,89556
2014-02-01,Oregon,3148678,1927204,1776721,150483
2014-02-01,Pennsylvania,10197005,6363192,5922213,440979
2014-02-01,Tennessee,5092218,3028084,2812656,215428
2014-02-01,Texas,19931260,12948549,12202532,746017
2014-02-01,Utah,2085290,1403245,1344634,58611
2014-02-01,Vermont,513290,347646,332316,15330
2014-02-01,Virginia,6418890,4248481,4010138,238343
2014-02-01,Washington,5489276,3479129,3238709,240420
2014-02-01,Wisconsin,4518845,3057569,2854793,202776
2014-02-01,Wyoming,449336,299953,284800,15153
2014-03-01,Alabama,3777962,2168460,2011264,157196
2014-03-01,Alaska,539754,363208,335244,27964
2014-03-01,Arizona,5149581,3107792,2891903,215889
2014-03-01,Arkansas,2283711,1326172,1242514,83658
2014-03-01,California,29863107,18669019,17103956,1565063
2014-03-01,Colorado,4117658,2789681,2623388,166293
2014-03-01,Connecticut,2864494,1872613,1735511,137102
2014-03-01,Delaware,734258,449836,422089,27747
2014-03-01,Florida,15860256,9498594,8862773,635821
2014-03-01,Georgia,7622847,4767805,4415064,352741
2014-03-01,Hawaii,1078425,664587,635596,28991
2014-03-01,Idaho,1220865,773994,730393,43601
2014-03-01,Illinois,10043753,6539017,6000328,538689
2014-03-01,Indiana,5085349,3214302,3002265,212037
2014-03-01,Iowa,2415666,1691776,1608693,83083
2014-03-01,Kansas,2190902,1492330,1420471,71859
2014-03-01,Kentucky,3422732,2031746,1873275,158471
2014-03-01,Louisiana,3540264,2107540,1991531,116009
2014-03-01,Maine,1088088,695645,648829,46816
2014-03-01,Maryland,4661547,3117819,2926956,190863
2014-03-01,Massachusetts,5446508,3547094,3320776,226318
2014-03-01,Michigan,7850278,4751719,4354242,397477
2014-03-01,Minnesota,4242288,2963914,2804011,159903
2014-03-01,Mississippi,2270082,1243806,1145801,98005
2014-03-01,Missouri,4705663,3032158,2816599,215559
2014-03-01,Montana,804660,511619,482739,28880
2014-03-01,Nebraska,1428099,1016243,976496,39747
2014-03-01,Nevada,2180188,1381264,1258419,122845
2014-03-01,Ohio,9085936,5661605,5293688,367917
2014-03-01,Oklahoma,2937906,1791782,1708793,82989
2014-03-01,Oregon,3151548,1935421,1787530,147891
2014-03-01,Pennsylvania,10198199,6366283,5944306,421977
2014-03-01,Tennessee,5095612,3040807,2830628,210179
2014-03-01,Texas,19963437,12982531,12268902,713629
2014-03-01,Utah,2088050,1407377,1351478,55899
2014-03-01,Vermont,513286,349151,333713,15438
2014-03-01,Virginia,6423820,4278747,4043119,235628
2014-03-01,Washington,5495957,3484145,3255723,228422
2014-03-01,Wisconsin,4520263,3064206,2866638,197568
2014-03-01,Wyoming,449330,301417,286828,14589
2014-04-01,Alabama,3779148,2155471,2021710,133761
2014-04-01,Alaska,539920,359341,334826,24515
2014-04-01,Arizona,5157085,3078306,2886741,191565
2014-04-01,Arkansas,2284412,1322489,1251334,71155
2014-04-01,California,29890084,18519169,17163306,1355863
2014-04-01,Colorado,4123834,2786433,2632634,153799
2014-04-01,Connecticut,2865227,1860800,1744001,116799
2014-04-01,Delaware,735008,448748,424340,24408
2014-04-01,Florida,15881941,9477371,8900332,577039
2014-04-01,Georgia,7630658,4723107,4403747,319360
2014-04-01,Hawaii,1078966,663916,636701,27215
2014-04-01,Idaho,1222312,769844,735995,33849
2014-04-01,Illinois,10045091,6481636,6022334,459302
2014-04-01,Indiana,5087465,3215833,3036248,179585
2014-04-01,Iowa,2416760,1693438,1626712,66726
2014-04-01,Kansas,2191747,1488700,1426904,61796
2014-04-01,Kentucky,3423820,2014072,1885050,129022
2014-04-01,Louisiana,3541777,2109929,2001656,108273
2014-04-01,Maine,1088386,691384,650294,41090
2014-04-01,Maryland,4663823,3097787,2933520,164267
2014-04-01,Massachusetts,5450754,3525606,3333341,192265
2014-04-01,Michigan,7852565,4705239,4365530,339709
2014-04-01,Minnesota,4244776,2962460,2832832,129628
2014-04-01,Mississippi,2270655,1236679,1150861,85818
2014-04-01,Missouri,4707337,3023452,2849823,173629
2014-04-01,Montana,805196,508136,485673,22463
2014-04-01,Nebraska,1428903,1014230,983434,30796
2014-04-01,Nevada,2183244,1366459,1258126,108333
2014-04-01,Ohio,9088443,5661337,5351932,309405
2014-04-01,Oklahoma,2939772,1779730,1710603,69127
2014-04-01,Oregon,3154549,1929577,1803936,125641
2014-04-01,Pennsylvania,10199621,6348311,5994184,354127
2014-04-01,Tennessee,5099031,3022794,2840080,182714
2014-04-01,Texas,19996449,12965270,12339799,625471
2014-04-01,Utah,2090879,1396449,1350783,45666
2014-04-01,Vermont,513303,344362,330120,14242
2014-04-01,Virginia,6428555,4266242,4063854,202388
2014-04-01,Washington,5502692,3450165,3259499,190666
2014-04-01,Wisconsin,4521748,3050685,2884034,166651
2014-04-01,Wyoming,449340,299933,287064,12869
2014-05-01,Alabama,3780402,2164853,2024362,140491
2014-05-01,Alaska,539952,367311,342795,24516
2014-05-01,Arizona,5164679,3101594,2894353,207241
2014-05-01,Arkansas,2285227,1333455,1255667,77788
2014-05-01,California,29916600,18622870,17270593,1352277
2014-05-01,Colorado,4129980,2785050,2646474,138576
2014-05-01,Connecticut,2866111,1894615,1768214,126401
2014-05-01,Delaware,735746,450431,425861,24570
2014-05-01,Florida,15903940,9573103,8961107,611996
2014-05-01,Georgia,7638321,4754201,4410600,343601
2014-05-01,Hawaii,1079174,663307,635377,27930
2014-05-01,Idaho,1223807,776444,745022,31422
2014-05-01,Illinois,10046805,6498458,6041575,456883
2014-05-01,Indiana,5090010,3240311,3050596,189715
2014-05-01,Iowa,2418089,1698338,1630518,67820
2014-05-01,Kansas,2192602,1494922,1427444,67478
2014-05-01,Kentucky,3425003,2024403,1889289,135114
2014-05-01,Louisiana,3543376,2127680,2001870,125810
2014-05-01,Maine,1088766,694370,655351,39019
2014-05-01,Maryland,4666100,3118929,2942522,176407
2014-05-01,Massachusetts,5455405,3547299,3344567,202732
2014-05-01,Michigan,7855445,4771175,4419823,351352
2014-05-01,Minnesota,4247681,2978692,2860165,118527
2014-05-01,Mississippi,2271250,1251239,1152864,98375
2014-05-01,Missouri,4709237,3043672,2857065,186607
2014-05-01,Montana,805821,513845,492301,21544
2014-05-01,Nebraska,1429800,1018477,986430,32047
2014-05-01,Nevada,2186235,1380382,1267922,112460
2014-05-01,Ohio,9091567,5708718,5389904,318814
2014-05-01,Oklahoma,2941732,1792941,1713678,79263
2014-05-01,Oregon,3157729,1939353,1817145,122208
2014-05-01,Pennsylvania,10201740,6399956,6014867,385089
2014-05-01,Tennessee,5102669,3040990,2848382,192608
2014-05-01,Texas,20029222,13000850,12337197,663653
2014-05-01,Utah,2093891,1409649,1361299,48350
2014-05-01,Vermont,513384,346845,333639,13206
2014-05-01,Virginia,6432887,4290614,4067083,223531
2014-05-01,Washington,5509350,3468440,3268431,200009
2014-05-01,Wisconsin,4523688,3059778,2898612,161166
2014-05-01,Wyoming,449389,302018,289087,12931
2014-06-01,Alabama,3781842,2185261,2028825,156436
2014-06-01,Alaska,540093,371501,346012,25489
2014-06-01,Arizona,5172489,3120026,2897220,222806
2014-06-01,Arkansas,2286089,1342354,1261954,80400
2014-06-01,California,29944683,18661147,17246600,1414547
2014-06-01,Colorado,4136443,2816961,2675607,141354
2014-06-01,Connecticut,2867060,1909249,1781353,127896
2014-06-01,Delaware,736544,456884,430043,26841
2014-06-01,Florida,15926650,9575839,8943336,632503
2014-06-01,Georgia,7646501,4765726,4404130,361596
2014-06-01,Hawaii,1079608,666706,634338,32368
2014-06-01,Idaho,1225357,780427,752447,27980
2014-06-01,Illinois,10048895,6583501,6106483,477018
2014-06-01,Indiana,5092587,3270924,3074345,196579
2014-06-01,Iowa,2419419,1714373,1641937,72436
2014-06-01,Kansas,2193633,1509889,1439284,70605
2014-06-01,Kentucky,3426320,2038501,1901059,137442
2014-06-01,Louisiana,3545128,2163329,2015369,147960
2014-06-01,Maine,1089198,708542,671912,36630
2014-06-01,Maryland,4668668,3152439,2964663,187776
2014-06-01,Massachusetts,5460196,3608542,3396718,211824
2014-06-01,Michigan,7858371,4818947,4457308,361639
2014-06-01,Minnesota,4250635,3006618,2876648,129970
2014-06-01,Mississippi,2271966,1261491,1153531,107960
2014-06-01,Missouri,4711311,3074889,2881587,193302
2014-06-01,Montana,806454,519803,496411,23392
2014-06-01,Nebraska,1430764,1022075,986881,35194
2014-06-01,Nevada,2189378,1379914,1265694,114220
2014-06-01,Ohio,9094839,5775222,5426591,348631
2014-06-01,Oklahoma,2943814,1807957,1724887,83070
2014-06-01,Oregon,3160985,1960465,1830725,129740
2014-06-01,Pennsylvania,10204125,6439187,6052405,386782
2014-06-01,Tennessee,5106517,3068213,2849793,218420
2014-06-01,Texas,20063200,13046149,12328447,717702
2014-06-01,Utah,2096947,1419753,1364717,55036
2014-06-01,Vermont,513456,352611,338662,13949
2014-06-01,Virginia,6437866,4306716,4080899,225817
2014-06-01,Washington,5516406,3489275,3294401,194874
2014-06-01,Wisconsin,4525650,3118196,2943496,174700
2014-06-01,Wyoming,449410,307418,294174,13244
2014-07-01,Alabama,3783338,2182039,2022976,159063
2014-07-01,Alaska,540362,374747,350829,23918
2014-07-01,Arizona,5180459,3128413,2898146,230267
2014-07-01,Arkansas,2287037,1342939,1257501,85438
2014-07-01,California,29973268,18773584,17269489,1504095
2014-07-01,Colorado,4143100,2824839,2687087,137752
2014-07-01,Connecticut,2868086,1927171,1792216,134955
2014-07-01,Delaware,737354,458619,431188,27431
2014-07-01,Florida,15949789,9616501,8952601,663900
2014-07-01,Georgia,7654601,4784583,4409383,375200
2014-07-01,Hawaii,1080312,668009,638633,29376
2014-07-01,Idaho,1226932,785027,754706,30321
2014-07-01,Illinois,10050873,6596123,6118545,477578
2014-07-01,Indiana,5095338,3269888,3071655,198233
2014-07-01,Iowa,2420807,1716846,1642735,74111
2014-07-01,Kansas,2194773,1517101,1437339,79762
2014-07-01,Kentucky,3427780,2019719,1883759,135960
2014-07-01,Louisiana,3547016,2182320,2024377,157943
2014-07-01,Maine,1089642,715187,677587,37600
2014-07-01,Maryland,4671342,3176233,2981208,195025
2014-07-01,Massachusetts,5465033,3629303,3407757,221546
2014-07-01,Michigan,7861502,4836630,4441400,395230
2014-07-01,Minnesota,4253663,3015123,2889378,125745
2014-07-01,Mississippi,2272687,1259469,1151807,107662
2014-07-01,Missouri,4713419,3077270,2873617,203653
2014-07-01,Montana,807113,522200,499584,22616
2014-07-01,Nebraska,1431772,1026135,987908,38227
2014-07-01,Nevada,2192599,1389217,1271090,118127
2014-07-01,Ohio,9098363,5789141,5436364,352777
2014-07-01,Oklahoma,2945898,1803124,1721572,81552
2014-07-01,Oregon,3164306,1976067,1837966,138101
2014-07-01,Pennsylvania,10206633,6479612,6058555,421057
2014-07-01,Tennessee,5110481,3069965,2845377,224588
2014-07-01,Texas,20097595,13077349,12338362,738987
2014-07-01,Utah,2100046,1424445,1370702,53743
2014-07-01,Vermont,513527,354060,339497,14563
2014-07-01,Virginia,6443321,4314152,4083450,230702
2014-07-01,Washington,5523748,3517112,3312330,204782
2014-07-01,Wisconsin,4527717,3125583,2956440,169143
2014-07-01,Wyoming,449473,307117,294253,12864
2014-08-01,Alabama,3785171,2166579,2014992,151587
2014-08-01,Alaska,540603,368559,345941,22618
2014-08-01,Arizona,5189451,3121749,2894856,226893
2014-08-01,Arkansas,2288351,1330627,1252103,78524
2014-08-01,California,30003777,18724292,17283256,1441036
2014-08-01,Colorado,4151522,2813579,2683490,130089
2014-08-01,Connecticut,2868777,1904808,1774488,130320
2014-08-01,Delaware,738197,456198,429145,27053
2014-08-01,Florida,15979383,9589028,8937339,651689
2014-08-01,Georgia,7664292,4730366,4374145,356221
2014-08-01,Hawaii,1080863,663281,635486,27795
2014-08-01,Idaho,1228689,778651,748487,30164
2014-08-01,Illinois,10052122,6511054,6061709,449345
2014-08-01,Indiana,5097721,3238147,3051147,187000
2014-08-01,Iowa,2422082,1703892,1631701,72191
2014-08-01,Kansas,2195906,1486409,1416547,69862
2014-08-01,Kentucky,3429552,1994429,1876319,118110
2014-08-01,Louisiana,3549310,2168017,2012330,155687
2014-08-01,Maine,1089878,713378,678927,34451
2014-08-01,Maryland,4674244,3139344,2953413,185931
2014-08-01,Massachusetts,5469190,3611079,3405239,205840
2014-08-01,Michigan,7864342,4790402,4455389,335013
2014-08-01,Minnesota,4256649,2992120,2875229,116891
2014-08-01,Mississippi,2273462,1237521,1142034,95487
2014-08-01,Missouri,4715848,3034968,2844026,190942
2014-08-01,Montana,807887,518339,496239,22100
2014-08-01,Nebraska,1432717,1009978,977578,32400
2014-08-01,Nevada,2196560,1380518,1267442,113076
2014-08-01,Ohio,9102012,5766977,5448739,318238
2014-08-01,Oklahoma,2948530,1794130,1716700,77430
2014-08-01,Oregon,3168976,1973759,1840027,133732
2014-08-01,Pennsylvania,10209072,6414748,6025098,389650
2014-08-01,Tennessee,5115278,3034237,2826102,208135
2014-08-01,Texas,20135749,13021260,12311636,709624
2014-08-01,Utah,2103664,1419683,1364953,54730
2014-08-01,Vermont,513704,351420,337509,13911
2014-08-01,Virginia,6448300,4262246,4033221,229025
2014-08-01,Washington,5532478,3508351,3303791,204560
2014-08-01,Wisconsin,4529784,3103353,2944480,158873
2014-08-01,Wyoming,449719,304969,292600,12369
2014-09-01,Alabama,3787004,2153952,2016904,137048
2014-09-01,Alaska,540851,365139,343070,22069
2014-09-01,Arizona,5198387,3141988,2928416,213572
2014-09-01,Arkansas,2289722,1330394,1257748,72646
2014-09-01,California,30034552,18764016,17440076,1323940
2014-09-01,Colorado,4159972,2814409,2699435,114974
2014-09-01,Connecticut,2869566,1891653,1774162,117491
2014-09-01,Delaware,739121,450107,426128,23979
2014-09-01,Florida,16009146,9612185,9003526,608659
2014-09-01,Georgia,7674134,4734607,4410002,324605
2014-09-01,Hawaii,1081629,662020,634239,27781
2014-09-01,Idaho,1230456,776040,749056,26984
2014-09-01,Illinois,10053396,6479833,6068196,411637
2014-09-01,Indiana,5100064,3213442,3041795,171647
2014-09-01,Iowa,2423284,1706075,1640635,65440
2014-09-01,Kansas,2197146,1488247,1427313,60934
2014-09-01,Kentucky,3431380,1981491,1872692,108799
2014-09-01,Louisiana,3551647,2162891,2016144,146747
2014-09-01,Maine,1090164,694452,661548,32904
2014-09-01,Maryland,4677269,3118236,2951855,166381
2014-09-01,Massachusetts,5473295,3556645,3360483,196162
2014-09-01,Michigan,7867142,4756862,4443772,313090
2014-09-01,Minnesota,4259600,2977259,2871064,106195
2014-09-01,Mississippi,2274286,1239724,1150077,89647
2014-09-01,Missouri,4718289,3029144,2859097,170047
2014-09-01,Montana,808672,512187,492523,19664
2014-09-01,Nebraska,1433715,1003490,974493,28997
2014-09-01,Nevada,2200552,1383461,1276358,107103
2014-09-01,Ohio,9105659,5717454,5420701,296753
2014-09-01,Oklahoma,2951189,1802381,1729596,72785
2014-09-01,Oregon,3173535,1961030,1843033,117997
2014-09-01,Pennsylvania,10211398,6371399,6034590,336809
2014-09-01,Tennessee,5120089,3030492,2837233,193259
2014-09-01,Texas,20174227,13029382,12375704,653678
2014-09-01,Utah,2107319,1421732,1373945,47787
2014-09-01,Vermont,513902,346831,333062,13769
2014-09-01,Virginia,6453876,4231725,4022999,208726
2014-09-01,Washington,5541439,3509148,3316361,192787
2014-09-01,Wisconsin,4531863,3078609,2938085,140524
2014-09-01,Wyoming,449959,303822,292286,11536
2014-10-01,Alabama,3788819,2173770,2039556,134214
2014-10-01,Alaska,541178,362184,340499,21685
2014-10-01,Arizona,5207290,3152083,2945314,206769
2014-10-01,Arkansas,2291014,1332131,1265243,66888
2014-10-01,California,30065291,18797649,17496129,1301520
2014-10-01,Colorado,4168412,2822265,2708388,113877
2014-10-01,Connecticut,2870249,1897841,1783086,114755
2014-10-01,Delaware,739991,455334,432263,23071
2014-10-01,Florida,16038837,9621112,9035992,585120
2014-10-01,Georgia,7684016,4746494,4428601,317893
2014-10-01,Hawaii,1082361,662847,636857,25990
2014-10-01,Idaho,1232213,781119,754485,26634
2014-10-01,Illinois,10054590,6522001,6117286,404715
2014-10-01,Indiana,5102418,3247908,3071853,176055
2014-10-01,Iowa,2424508,1709564,1648396,61168
2014-10-01,Kansas,2198312,1495831,1437205,58626
2014-10-01,Kentucky,3433119,1986074,1883954,102120
2014-10-01,Louisiana,3553983,2179838,2037203,142635
2014-10-01,Maine,1090411,698296,665772,32524
2014-10-01,Maryland,4680246,3137965,2971592,166373
2014-10-01,Massachusetts,5477355,3592972,3412940,180032
2014-10-01,Michigan,7869825,4767077,4475088,291989
2014-10-01,Minnesota,4262535,2992335,2893792,98543
2014-10-01,Mississippi,2275099,1243199,1157355,85844
2014-10-01,Missouri,4720710,3038490,2885970,152520
2014-10-01,Montana,809429,511802,491209,20593
2014-10-01,Nebraska,1434661,1012279,985039,27240
2014-10-01,Nevada,2204509,1388145,1284303,103842
2014-10-01,Ohio,9109182,5758762,5478964,279798
2014-10-01,Oklahoma,2953863,1814438,1742228,72210
2014-10-01,Oregon,3178139,1971776,1852479,119297
2014-10-01,Pennsylvania,10213628,6402781,6071370,331411
2014-10-01,Tennessee,5124892,3056830,2869592,187238
2014-10-01,Texas,20212629,13055188,12446728,608460
2014-10-01,Utah,2110926,1429649,1381692,47957
2014-10-01,Vermont,514074,348600,337353,11247
2014-10-01,Virginia,6459517,4246756,4047591,199165
2014-10-01,Washington,5550339,3534383,3341895,192488
2014-10-01,Wisconsin,4533838,3087982,2953238,134744
2014-10-01,Wyoming,450204,304067,292478,11589
2014-11-01,Alabama,3790314,2163471,2032969,130502
2014-11-01,Alaska,541342,360971,337800,23171
2014-11-01,Arizona,5215731,3166639,2965963,200676
2014-11-01,Arkansas,2292159,1330875,1262565,68310
2014-11-01,California,30094154,18803940,17501837,1302103
2014-11-01,Colorado,4176464,2810876,2696168,114708
2014-11-01,Connecticut,2870767,1899536,1791281,108255
2014-11-01,Delaware,740761,457179,435994,21185
2014-11-01,Florida,16066665,9558486,8981858,576628
2014-11-01,Georgia,7693498,4740296,4436551,303745
2014-11-01,Hawaii,1082878,668073,641856,26217
2014-11-01,Idaho,1233894,779533,748860,30673
2014-11-01,Illinois,10055199,6505437,6111584,393853
2014-11-01,Indiana,5104411,3245739,3062460,183279
2014-11-01,Iowa,2425484,1698323,1637593,60730
2014-11-01,Kansas,2199173,1495867,1436947,58920
2014-11-01,Kentucky,3434586,1983300,1882370,100930
2014-11-01,Louisiana,3555955,2178158,2034775,143383
2014-11-01,Maine,1090608,691021,655782,35239
2014-11-01,Maryland,4682816,3128967,2963455,165512
2014-11-01,Massachusetts,5481096,3599305,3421341,177964
2014-11-01,Michigan,7871987,4750664,4477310,273354
2014-11-01,Minnesota,4265112,2989476,2885612,103864
2014-11-01,Mississippi,2275694,1237969,1157417,80552
2014-11-01,Missouri,4722848,3029635,2870916,158719
2014-11-01,Montana,810110,511142,487908,23234
2014-11-01,Nebraska,1435461,1009231,983236,25995
2014-11-01,Nevada,2208283,1388485,1285499,102986
2014-11-01,Ohio,9111983,5742189,5460867,281322
2014-11-01,Oklahoma,2956288,1815132,1743607,71525
2014-11-01,Oregon,3182459,1964076,1846722,117354
2014-11-01,Pennsylvania,10215030,6379681,6055905,323776
2014-11-01,Tennessee,5129292,3059176,2872659,186517
2014-11-01,Texas,20249578,13078274,12475105,603169
2014-11-01,Utah,2114402,1434983,1387565,47418
2014-11-01,Vermont,514237,348581,335447,13134
2014-11-01,Virginia,6463917,4223717,4027967,195750
2014-11-01,Washington,5558599,3530135,3327807,202328
2014-11-01,Wisconsin,4535533,3083653,2947253,136400
2014-11-01,Wyoming,450360,304238,290518,13720
2014-12-01,Alabama,3791522,2151064,2025635,125429
2014-12-01,Alaska,541292,357956,335280,22676
2014-12-01,Arizona,5223652,3149237,2955181,194056
2014-12-01,Arkansas,2293069,1323283,1253217,70066
2014-12-01,California,30119935,18683050,17442587,1240463
2014-12-01,Colorado,4183994,2797749,2685875,111874
2014-12-01,Connecticut,2871003,1881135,1779814,101321
2014-12-01,Delaware,741480,457380,436935,20445
2014-12-01,Florida,16093012,9535182,8995254,539928
2014-12-01,Georgia,7702197,4725890,4429379,296511
2014-12-01,Hawaii,1083135,665175,641524,23651
2014-12-01,Idaho,1235428,777539,747525,30014
2014-12-01,Illinois,10055054,6456093,6075569,380524
2014-12-01,Indiana,5106016,3222977,3051622,171355
2014-12-01,Iowa,2426356,1693954,1626237,67717
2014-12-01,Kansas,2199786,1487052,1430294,56758
2014-12-01,Kentucky,3435694,1972821,1876042,96779
2014-12-01,Louisiana,3557592,2157670,2025107,132563
2014-12-01,Maine,1090665,688756,654580,34176
2014-12-01,Maryland,4684903,3114060,2955920,158140
2014-12-01,Massachusetts,5484347,3586060,3413827,172233
2014-12-01,Michigan,7873568,4727250,4460331,266919
2014-12-01,Minnesota,4267379,2981351,2864380,116971
2014-12-01,Mississippi,2276091,1238518,1156307,82211
2014-12-01,Missouri,4724514,3024070,2864119,159951
2014-12-01,Montana,810716,506797,483868,22929
2014-12-01,Nebraska,1436119,1005064,976492,28572
2014-12-01,Nevada,2211859,1379319,1278651,100668
2014-12-01,Ohio,9114058,5702333,5416805,285528
2014-12-01,Oklahoma,2958392,1800474,1734241,66233
2014-12-01,Oregon,3186524,1944909,1834056,110853
2014-12-01,Pennsylvania,10215558,6354302,6028783,325519
2014-12-01,Tennessee,5133124,3045431,2866428,179003
2014-12-01,Texas,20284449,13007327,12454520,552807
2014-12-01,Utah,2117704,1425346,1379448,45898
2014-12-01,Vermont,514348,346198,333499,12699
2014-12-01,Virginia,6467759,4210511,4020960,189551
2014-12-01,Washington,5566204,3515847,3312968,202879
2014-12-01,Wisconsin,4536913,3062988,2925508,137480
2014-12-01,Wyoming,450507,299266,287956,11310
2015-01-01,Alabama,3792717,2148669,2006508,142161
2015-01-01,Alaska,541541,360028,334704,25324
2015-01-01,Arizona,5231632,3164466,2957918,206548
2015-01-01,Arkansas,2293962,1316392,1234566,81826
2015-01-01,California,30147095,18764124,17402371,1361753
2015-01-01,Colorado,4191682,2799322,2671519,127803
2015-01-01,Connecticut,2871234,1891204,1767184,124020
2015-01-01,Delaware,742189,456962,431695,25267
2015-01-01,Florida,16119608,9562037,8979043,582994
2015-01-01,Georgia,7711426,4738576,4421654,316922
2015-01-01,Hawaii,1083804,670371,643673,26698
2015-01-01,Idaho,1236985,780799,742878,37921
2015-01-01,Illinois,10054926,6449585,6006026,443559
2015-01-01,Indiana,5107398,3229717,3033456,196261
2015-01-01,Iowa,2427052,1696311,1615748,80563
2015-01-01,Kansas,2200557,1486758,1417765,68993
2015-01-01,Kentucky,3436806,1967329,1850249,117080
2015-01-01,Louisiana,3559303,2148595,1997865,150730
2015-01-01,Maine,1090698,685889,645318,40571
2015-01-01,Maryland,4687116,3117792,2935328,182464
2015-01-01,Massachusetts,5487464,3580628,3372883,207745
2015-01-01,Michigan,7874799,4720132,4408101,312031
2015-01-01,Minnesota,4269426,2973994,2834801,139193
2015-01-01,Mississippi,2276579,1235226,1145506,89720
2015-01-01,Missouri,4726122,3030611,2843261,187350
2015-01-01,Montana,811282,510879,482930,27949
2015-01-01,Nebraska,1436792,1001450,968105,33345
2015-01-01,Nevada,2215425,1385693,1277948,107745
2015-01-01,Ohio,9115824,5665940,5318609,347331
2015-01-01,Oklahoma,2960645,1811579,1734190,77389
2015-01-01,Oregon,3190400,1940921,1819328,121593
2015-01-01,Pennsylvania,10215735,6377962,5992307,385655
2015-01-01,Tennessee,5136969,3046006,2844653,201353
2015-01-01,Texas,20320317,13015279,12391013,624266
2015-01-01,Utah,2120965,1431036,1376087,54949
2015-01-01,Vermont,514435,348287,333138,15149
2015-01-01,Virginia,6472206,4220096,4002768,217328
2015-01-01,Washington,5574083,3517438,3295498,221940
2015-01-01,Wisconsin,4538023,3058370,2898136,160234
2015-01-01,Wyoming,450619,299782,285809,13973
2015-02-01,Alabama,3793390,2162030,2025374,136656
2015-02-01,Alaska,541749,359253,333642,25611
2015-02-01,Arizona,5238741,3153259,2962787,190472
2015-02-01,Arkansas,2294489,1329398,1250883,78515
2015-02-01,California,30170177,18801829,17499566,1302263
2015-02-01,Colorado,4199004,2807058,2682105,124953
2015-02-01,Connecticut,2871089,1889721,1770668,119053
2015-02-01,Delaware,742821,456412,432450,23962
2015-02-01,Florida,16143433,9546970,9006368,540602
2015-02-01,Georgia,7719736,4734126,4430399,303727
2015-02-01,Hawaii,1084437,667654,643069,24585
2015-02-01,Idaho,1238342,783384,747444,35940
2015-02-01,Illinois,10053295,6456914,6033732,423182
2015-02-01,Indiana,5108171,3213612,3031910,181702
2015-02-01,Iowa,2427387,1699733,1626260,73473
2015-02-01,Kansas,2201056,1493333,1424572,68761
2015-02-01,Kentucky,3437547,1967414,1853354,114060
2015-02-01,Louisiana,3560608,2142067,2007050,135017
2015-02-01,Maine,1090572,682620,644091,38529
2015-02-01,Maryland,4688804,3114583,2942181,172402
2015-02-01,Massachusetts,5489882,3581209,3382959,198250
2015-02-01,Michigan,7874962,4710288,4420776,289512
2015-02-01,Minnesota,4271024,2978790,2844487,134303
2015-02-01,Mississippi,2276813,1243527,1161391,82136
2015-02-01,Missouri,4727116,3040928,2853647,187281
2015-02-01,Montana,811751,513322,487619,25703
2015-02-01,Nebraska,1437272,1005490,973953,31537
2015-02-01,Nevada,2218759,1393239,1291066,102173
2015-02-01,Ohio,9116352,5663852,5337744,326108
2015-02-01,Oklahoma,2962478,1816954,1740486,76468
2015-02-01,Oregon,3193924,1948332,1830433,117899
2015-02-01,Pennsylvania,10214411,6366355,5988272,378083
2015-02-01,Tennessee,5140220,3042517,2854655,187862
2015-02-01,Texas,20353602,13035400,12443993,591407
2015-02-01,Utah,2124081,1436544,1380393,56151
2015-02-01,Vermont,514456,347993,334010,13983
2015-02-01,Virginia,6476073,4227756,4017431,210325
2015-02-01,Washington,5581414,3528877,3313937,214940
2015-02-01,Wisconsin,4538575,3063370,2900058,163312
2015-02-01,Wyoming,450732,299274,286328,12946
2015-03-01,Alabama,3794218,2170786,2041579,129207
2015-03-01,Alaska,541763,360475,335754,24721
2015-03-01,Arizona,5246030,3164078,2979290,184788
2015-03-01,Arkansas,2295183,1332123,1260385,71738
2015-03-01,California,30192273,18790016,17519675,1270341
2015-03-01,Colorado,4206284,2806840,2687373,119467
2015-03-01,Connecticut,2871016,1893256,1781204,112052
2015-03-01,Delaware,743467,459782,437018,22764
2015-03-01,Florida,16167449,9542059,9018956,523103
2015-03-01,Georgia,7727931,4737319,4447326,289993
2015-03-01,Hawaii,1084597,670423,647002,23421
2015-03-01,Idaho,1239788,785827,751861,33966
2015-03-01,Illinois,10052133,6463599,6064497,399102
2015-03-01,Indiana,5109371,3223620,3053570,170050
2015-03-01,Iowa,2428014,1698009,1627909,70100
2015-03-01,Kansas,2201561,1488118,1423054,65064
2015-03-01,Kentucky,3438481,1979507,1866380,113127
2015-03-01,Louisiana,3561944,2152831,2017236,135595
2015-03-01,Maine,1090565,681936,646088,35848
2015-03-01,Maryland,4690491,3127563,2962529,165034
2015-03-01,Massachusetts,5492682,3581641,3396306,185335
2015-03-01,Michigan,7875796,4719463,4434994,284469
2015-03-01,Minnesota,4272956,2984503,2851273,133230
2015-03-01,Mississippi,2277021,1249193,1172117,77076
2015-03-01,Missouri,4728406,3044173,2865962,178211
2015-03-01,Montana,812295,515738,490810,24928
2015-03-01,Nebraska,1437833,1007008,975366,31642
2015-03-01,Nevada,2222091,1389734,1292663,97071
2015-03-01,Ohio,9117696,5672809,5369590,303219
2015-03-01,Oklahoma,2964358,1823883,1750909,72974
2015-03-01,Oregon,3197709,1948352,1832323,116029
2015-03-01,Pennsylvania,10213980,6346209,5984503,361706
2015-03-01,Tennessee,5143697,3037618,2859384,178234
2015-03-01,Texas,20386355,13017214,12446732,570482
2015-03-01,Utah,2127259,1438566,1385542,53024
2015-03-01,Vermont,514531,347984,334346,13638
2015-03-01,Virginia,6479492,4230864,4030130,200734
2015-03-01,Washington,5588657,3527629,3329902,197727
2015-03-01,Wisconsin,4539542,3063578,2907403,156175
2015-03-01,Wyoming,450837,301009,287643,13366
2015-04-01,Alabama,3795273,2170224,2050976,119248
2015-04-01,Alaska,541860,358599,335693,22906
2015-04-01,Arizona,5253623,3166908,2981891,185017
2015-04-01,Arkansas,2296029,1341241,1275856,65385
2015-04-01,California,30216829,18768380,17596212,1172168
2015-04-01,Colorado,4213837,2797891,2688855,109036
2015-04-01,Connecticut,2871086,1886564,1784576,101988
2015-04-01,Delaware,744119,461196,439651,21545
2015-04-01,Florida,16192418,9584999,9075810,509189
2015-04-01,Georgia,7736619,4724011,4449589,274422
2015-04-01,Hawaii,1084940,670908,648013,22895
2015-04-01,Idaho,1241296,786755,756301,30454
2015-04-01,Illinois,10051577,6468839,6102816,366023
2015-04-01,Indiana,5110758,3237960,3096286,141674
2015-04-01,Iowa,2428690,1700327,1640913,59414
2015-04-01,Kansas,2202145,1490727,1427665,63062
2015-04-01,Kentucky,3439530,1978538,1881611,96927
2015-04-01,Louisiana,3563437,2162047,2030841,131206
2015-04-01,Maine,1090579,683465,651447,32018
2015-04-01,Maryland,4692382,3124445,2978787,145658
2015-04-01,Massachusetts,5495719,3580173,3414161,166012
2015-04-01,Michigan,7876897,4705447,4457929,247518
2015-04-01,Minnesota,4275054,2997044,2889469,107575
2015-04-01,Mississippi,2277330,1253436,1179596,73840
2015-04-01,Missouri,4729926,3062297,2903842,158455
2015-04-01,Montana,812851,515099,494289,20810
2015-04-01,Nebraska,1438471,1011801,982710,29091
2015-04-01,Nevada,2225535,1392466,1294872,97594
2015-04-01,Ohio,9119310,5691230,5421747,269483
2015-04-01,Oklahoma,2966457,1825105,1753425,71680
2015-04-01,Oregon,3201589,1953104,1848411,104693
2015-04-01,Pennsylvania,10213906,6377394,6061360,316034
2015-04-01,Tennessee,5147408,3060045,2897052,162993
2015-04-01,Texas,20420653,13064682,12531130,533552
2015-04-01,Utah,2130584,1436801,1388367,48434
2015-04-01,Vermont,514616,344431,331493,12938
2015-04-01,Virginia,6483301,4249608,4069869,179739
2015-04-01,Washington,5596195,3523018,3345749,177269
2015-04-01,Wisconsin,4540646,3059066,2926523,132543
2015-04-01,Wyoming,450938,300184,287710,12474
2015-05-01,Alabama,3796534,2170182,2040588,129594
2015-05-01,Alaska,542036,365370,342386,22984
2015-05-01,Arizona,5261501,3188149,2997014,191135
2015-05-01,Arkansas,2296996,1353897,1282975,70922
2015-05-01,California,30242644,18878300,17716302,1161998
2015-05-01,Colorado,4221620,2822268,2712420,109848
2015-05-01,Connecticut,2871419,1907447,1796725,110722
2015-05-01,Delaware,744838,461548,439918,21630
2015-05-01,Florida,16218527,9687793,9145452,542341
2015-05-01,Georgia,7745959,4757917,4463145,294772
2015-05-01,Hawaii,1085320,671629,648162,23467
2015-05-01,Idaho,1242885,797661,768853,28808
2015-05-01,Illinois,10051696,6513706,6136859,376847
2015-05-01,Indiana,5112558,3280061,3124612,155449
2015-05-01,Iowa,2429607,1702297,1641842,60455
2015-05-01,Kansas,2202959,1492815,1428408,64407
2015-05-01,Kentucky,3440841,1989116,1884328,104788
2015-05-01,Louisiana,3565205,2168456,2028699,139757
2015-05-01,Maine,1090689,688385,657208,31177
2015-05-01,Maryland,4694501,3149753,2990404,159349
2015-05-01,Massachusetts,5499163,3595782,3419902,175880
2015-05-01,Michigan,7878551,4790462,4517482,272980
2015-05-01,Minnesota,4277518,3021296,2914229,107067
2015-05-01,Mississippi,2277791,1271468,1183716,87752
2015-05-01,Missouri,4731896,3081525,2917066,164459
2015-05-01,Montana,813497,520778,500785,19993
2015-05-01,Nebraska,1439238,1016716,986577,30139
2015-05-01,Nevada,2229088,1403467,1307292,96175
2015-05-01,Ohio,9121634,5749913,5466865,283048
2015-05-01,Oklahoma,2968807,1845713,1761383,84330
2015-05-01,Oregon,3205720,1972228,1866132,106096
2015-05-01,Pennsylvania,10214662,6450711,6094674,356037
2015-05-01,Tennessee,5151480,3082662,2909720,172942
2015-05-01,Texas,20455987,13104709,12536370,568339
2015-05-01,Utah,2134048,1453492,1402851,50641
2015-05-01,Vermont,514728,346258,334036,12222
2015-05-01,Virginia,6487589,4270914,4073053,197861
2015-05-01,Washington,5604203,3548064,3357481,190583
2015-05-01,Wisconsin,4542174,3078612,2939996,138616
2015-05-01,Wyoming,451154,302758,289613,13145
2015-06-01,Alabama,3798019,2175315,2032289,143026
2015-06-01,Alaska,542351,368290,344607,23683
2015-06-01,Arizona,5269624,3188280,2982338,205942
2015-06-01,Arkansas,2298077,1358755,1287157,71598
2015-06-01,California,30269968,18835542,17631893,1203649
2015-06-01,Colorado,4229782,2839821,2725613,114208
2015-06-01,Connecticut,2871838,1912583,1802055,110528
2015-06-01,Delaware,745615,466121,442524,23597
2015-06-01,Florida,16245473,9663514,9107464,556050
2015-06-01,Georgia,7755736,4751889,4444797,307092
2015-06-01,Hawaii,1086160,672323,645474,26849
2015-06-01,Idaho,1244553,803720,774754,28966
2015-06-01,Illinois,10052135,6592531,6184413,408118
2015-06-01,Indiana,5114416,3311037,3151208,159829
2015-06-01,Iowa,2430604,1715715,1652387,63328
2015-06-01,Kansas,2204047,1505683,1440182,65501
2015-06-01,Kentucky,3442383,2005757,1894053,111704
2015-06-01,Louisiana,3567129,2184068,2029587,154481
2015-06-01,Maine,1090869,697928,668675,29253
2015-06-01,Maryland,4697090,3175190,3008284,166906
2015-06-01,Massachusetts,5502715,3641524,3460312,181212
2015-06-01,Michigan,7880361,4807234,4533498,273736
2015-06-01,Minnesota,4280102,3033992,2915277,118715
2015-06-01,Mississippi,2278424,1277472,1183952,93520
2015-06-01,Missouri,4734012,3100561,2935987,164574
2015-06-01,Montana,814167,524359,502331,22028
2015-06-01,Nebraska,1440080,1020253,987126,33127
2015-06-01,Nevada,2232794,1398835,1300777,98058
2015-06-01,Ohio,9124155,5779411,5480113,299298
2015-06-01,Oklahoma,2971286,1852051,1763985,88066
2015-06-01,Oregon,3209931,1990979,1877276,113703
2015-06-01,Pennsylvania,10215636,6491734,6130380,361354
2015-06-01,Tennessee,5155812,3111794,2919130,192664
2015-06-01,Texas,20492589,13116908,12494852,622056
2015-06-01,Utah,2137565,1458297,1402875,55422
2015-06-01,Vermont,514899,350687,338086,12601
2015-06-01,Virginia,6493089,4272759,4076961,195798
2015-06-01,Washington,5612692,3563634,3377865,185769
2015-06-01,Wisconsin,4543797,3126634,2976862,149772
2015-06-01,Wyoming,451324,306610,293364,13246
2015-07-01,Alabama,3799477,2162400,2020381,142019
2015-07-01,Alaska,542488,371753,350664,21089
2015-07-01,Arizona,5277926,3190561,2979386,211175
2015-07-01,Arkansas,2299219,1354606,1281671,72935
2015-07-01,California,30296923,18896158,17655486,1240672
2015-07-01,Colorado,4237868,2840597,2736370,104227
2015-07-01,Connecticut,2872304,1921581,1808181,113400
2015-07-01,Delaware,746397,467489,443852,23637
2015-07-01,Florida,16272655,9679119,9109409,569710
2015-07-01,Georgia,7764701,4753850,4446608,307242
2015-07-01,Hawaii,1086606,670470,648385,22085
2015-07-01,Idaho,1246242,806577,776441,30136
2015-07-01,Illinois,10052479,6591159,6183083,408076
2015-07-01,Indiana,5116564,3299492,3142812,156680
2015-07-01,Iowa,2431720,1716912,1654327,62585
2015-07-01,Kansas,2205000,1513154,1440532,72622
2015-07-01,Kentucky,3443963,1989939,1876378,113561
2015-07-01,Louisiana,3569129,2177733,2029415,148318
2015-07-01,Maine,1091034,702141,674058,28083
2015-07-01,Maryland,4699564,3189093,3021772,167321
2015-07-01,Massachusetts,5506549,3640398,3456627,183771
2015-07-01,Michigan,7882629,4818499,4522781,295718
2015-07-01,Minnesota,4282892,3037605,2924145,113460
2015-07-01,Mississippi,2278975,1277030,1185469,91561
2015-07-01,Missouri,4736104,3097867,2927483,170384
2015-07-01,Montana,814872,525767,504914,20853
2015-07-01,Nebraska,1440957,1024348,989606,34742
2015-07-01,Nevada,2236496,1405212,1305896,99316
2015-07-01,Ohio,9127172,5782022,5494297,287725
2015-07-01,Oklahoma,2973610,1837478,1754141,83337
2015-07-01,Oregon,3214297,2001875,1885481,116394
2015-07-01,Pennsylvania,10217178,6512593,6129885,382708
2015-07-01,Tennessee,5160228,3106189,2920285,185904
2015-07-01,Texas,20528677,13119654,12486933,632721
2015-07-01,Utah,2141186,1463925,1409947,53978
2015-07-01,Vermont,515055,350425,338139,12286
2015-07-01,Virginia,6497687,4286499,4095947,190552
2015-07-01,Washington,5621018,3574268,3384808,189460
2015-07-01,Wisconsin,4545633,3124322,2984176,140146
2015-07-01,Wyoming,451543,305519,293511,12008
2015-08-01,Alabama,3801201,2147204,2011994,135210
2015-08-01,Alaska,542917,367393,347941,19452
2015-08-01,Arizona,5287701,3186008,2980885,205123
2015-08-01,Arkansas,2300521,1341848,1278661,63187
2015-08-01,California,30322827,18812629,17657726,1154903
2015-08-01,Colorado,4245694,2833365,2736148,97217
2015-08-01,Connecticut,2872668,1893924,1787210,106714
2015-08-01,Delaware,747145,465293,442130,23163
2015-08-01,Florida,16304520,9666858,9117308,549550
2015-08-01,Georgia,7775261,4709567,4422437,287130
2015-08-01,Hawaii,1087442,670044,648143,21901
2015-08-01,Idaho,1248753,798665,770298,28367
2015-08-01,Illinois,10052472,6521487,6142268,379219
2015-08-01,Indiana,5119646,3271854,3126676,145178
2015-08-01,Iowa,2432799,1695089,1635768,59321
2015-08-01,Kansas,2206043,1486677,1424350,62327
2015-08-01,Kentucky,3445559,1971541,1876447,95094
2015-08-01,Louisiana,3570825,2145563,2009078,136485
2015-08-01,Maine,1091444,701006,676063,24943
2015-08-01,Maryland,4701204,3150210,2993686,156524
2015-08-01,Massachusetts,5510088,3622137,3458026,164111
2015-08-01,Michigan,7886210,4790565,4538672,251893
2015-08-01,Minnesota,4286218,3013324,2908523,104801
2015-08-01,Mississippi,2279661,1257607,1178766,78841
2015-08-01,Missouri,4738008,3056647,2902267,154380
2015-08-01,Montana,815722,521903,502021,19882
2015-08-01,Nebraska,1442076,1012730,982437,30293
2015-08-01,Nevada,2240387,1396155,1302361,93794
2015-08-01,Ohio,9130533,5731470,5480563,250907
2015-08-01,Oklahoma,2975237,1822840,1744332,78508
2015-08-01,Oregon,3220392,1998837,1889594,109243
2015-08-01,Pennsylvania,10219328,6458270,6103401,354869
2015-08-01,Tennessee,5165233,3067062,2899417,167645
2015-08-01,Texas,20562773,13079390,12480252,599138
2015-08-01,Utah,2145803,1459471,1405605,53866
2015-08-01,Vermont,515083,347558,336001,11557
2015-08-01,Virginia,6502056,4231393,4051054,180339
2015-08-01,Washington,5631123,3560258,3378505,181753
2015-08-01,Wisconsin,4547707,3101514,2973077,128437
2015-08-01,Wyoming,451558,303045,291632,11413
2015-09-01,Alabama,3802943,2126680,2000072,126608
2015-09-01,Alaska,543357,361767,341819,19948
2015-09-01,Arizona,5297456,3198547,3002685,195862
2015-09-01,Arkansas,2301817,1337444,1278535,58909
2015-09-01,California,30348765,18809877,17746088,1063789
2015-09-01,Colorado,4253521,2835986,2747132,88854
2015-09-01,Connecticut,2873060,1876383,1778391,97992
2015-09-01,Delaware,747902,459176,438157,21019
2015-09-01,Florida,16336389,9680996,9157331,523665
2015-09-01,Georgia,7785882,4708641,4438359,270282
2015-09-01,Hawaii,1088175,667572,644619,22953
2015-09-01,Idaho,1251267,797330,770166,27164
2015-09-01,Illinois,10052588,6477546,6126305,351241
2015-09-01,Indiana,5122740,3254534,3119117,135417
2015-09-01,Iowa,2433958,1689462,1634027,55435
2015-09-01,Kansas,2207110,1486577,1433099,53478
2015-09-01,Kentucky,3447166,1963764,1871134,92630
2015-09-01,Louisiana,3572509,2128853,1998192,130661
2015-09-01,Maine,1091811,683423,658974,24449
2015-09-01,Maryland,4702765,3123906,2979858,144048
2015-09-01,Massachusetts,5513606,3539247,3379357,159890
2015-09-01,Michigan,7889755,4746483,4519861,226622
2015-09-01,Minnesota,4289567,2991695,2895153,96542
2015-09-01,Mississippi,2280319,1259786,1183137,76649
2015-09-01,Missouri,4739901,3042138,2908910,133228
2015-09-01,Montana,816595,515397,497202,18195
2015-09-01,Nebraska,1443217,1003812,976551,27261
2015-09-01,Nevada,2244284,1398135,1306555,91580
2015-09-01,Ohio,9133856,5664602,5414308,250294
2015-09-01,Oklahoma,2976904,1825486,1749948,75538
2015-09-01,Oregon,3226425,1992201,1892943,99258
2015-09-01,Pennsylvania,10221392,6412366,6089803,322563
2015-09-01,Tennessee,5170211,3060966,2901561,159405
2015-09-01,Texas,20597035,13073700,12484848,588852
2015-09-01,Utah,2150498,1458479,1410899,47580
2015-09-01,Vermont,515145,343019,331264,11755
2015-09-01,Virginia,6506333,4190597,4021205,169392
2015-09-01,Washington,5641221,3558953,3380335,178618
2015-09-01,Wisconsin,4549782,3074374,2956837,117537
2015-09-01,Wyoming,451548,301031,290265,10766
2015-10-01,Alabama,3804782,2140809,2012847,127962
2015-10-01,Alaska,543664,358982,337462,21520
2015-10-01,Arizona,5307253,3198229,3007620,190609
2015-10-01,Arkansas,2303143,1337280,1282674,54606
2015-10-01,California,30374660,18838183,17766520,1071663
2015-10-01,Colorado,4261240,2841176,2750736,90440
2015-10-01,Connecticut,2873493,1881358,1783380,97978
2015-10-01,Delaware,748677,464744,443636,21108
2015-10-01,Florida,16368317,9705403,9190314,515089
2015-10-01,Georgia,7796741,4723075,4449640,273435
2015-10-01,Hawaii,1088651,667598,646646,20952
2015-10-01,Idaho,1253815,799951,772911,27040
2015-10-01,Illinois,10052875,6525090,6155576,369514
2015-10-01,Indiana,5125961,3283324,3141609,141715
2015-10-01,Iowa,2435125,1701075,1647345,53730
2015-10-01,Kansas,2208046,1492761,1438177,54584
2015-10-01,Kentucky,3448760,1970182,1877589,92593
2015-10-01,Louisiana,3574214,2142671,2014524,128147
2015-10-01,Maine,1092251,686308,661653,24655
2015-10-01,Maryland,4704406,3144314,2997159,147155
2015-10-01,Massachusetts,5517301,3566539,3417842,148697
2015-10-01,Michigan,7893558,4771973,4549013,222960
2015-10-01,Minnesota,4293032,3009622,2914838,94784
2015-10-01,Mississippi,2281019,1260160,1184750,75410
2015-10-01,Missouri,4741883,3050581,2925769,124812
2015-10-01,Montana,817456,517685,497509,20176
2015-10-01,Nebraska,1444360,1011545,983716,27829
2015-10-01,Nevada,2248135,1399900,1310712,89188
2015-10-01,Ohio,9137348,5714213,5467680,246533
2015-10-01,Oklahoma,2978633,1831140,1751919,79221
2015-10-01,Oregon,3232588,2004095,1904774,99321
2015-10-01,Pennsylvania,10223727,6433766,6117178,316588
2015-10-01,Tennessee,5175203,3092836,2937798,155038
2015-10-01,Texas,20631313,13116560,12538675,577885
2015-10-01,Utah,2155154,1463929,1415636,48293
2015-10-01,Vermont,515203,343769,334551,9218
2015-10-01,Virginia,6510187,4214665,4047300,167365
2015-10-01,Washington,5651071,3579362,3396620,182742
2015-10-01,Wisconsin,4551926,3087185,2970623,116562
2015-10-01,Wyoming,451574,301007,289074,11933
2015-11-01,Alabama,3806253,2125513,2000569,124944
2015-11-01,Alaska,544206,358930,335950,22980
2015-11-01,Arizona,5316586,3211694,3029317,182377
2015-11-01,Arkansas,2304202,1335651,1282351,53300
2015-11-01,California,30399646,18874236,17806455,1067781
2015-11-01,Colorado,4268872,2841121,2749626,91495
2015-11-01,Connecticut,2873656,1880647,1789096,91551
2015-11-01,Delaware,749351,466684,447343,19341
2015-11-01,Florida,16398883,9667876,9165255,502621
2015-11-01,Georgia,7807629,4730615,4469000,261615
2015-11-01,Hawaii,1089768,673163,652221,20942
2015-11-01,Idaho,1256189,798750,768384,30366
2015-11-01,Illinois,10052412,6542790,6159025,383765
2015-11-01,Indiana,5128517,3298688,3149656,149032
2015-11-01,Iowa,2435921,1693896,1639102,54794
2015-11-01,Kansas,2208941,1495809,1441692,54117
2015-11-01,Kentucky,3450120,1982234,1888225,94009
2015-11-01,Louisiana,3575593,2132851,2013776,119075
2015-11-01,Maine,1092544,680555,653469,27086
2015-11-01,Maryland,4705748,3135060,2993014,142046
2015-11-01,Massachusetts,5520358,3570955,3424342,146613
2015-11-01,Michigan,7896257,4773839,4565907,207932
2015-11-01,Minnesota,4295969,3009188,2911921,97267
2015-11-01,Mississippi,2281545,1263695,1187527,76168
2015-11-01,Missouri,4743494,3042567,2916499,126068
2015-11-01,Montana,818218,517942,495939,22003
2015-11-01,Nebraska,1445350,1013143,986591,26552
2015-11-01,Nevada,2251878,1401763,1313610,88153
2015-11-01,Ohio,9139608,5710364,5451828,258536
2015-11-01,Oklahoma,2980187,1833698,1755083,78615
2015-11-01,Oregon,3238237,2004137,1906820,97317
2015-11-01,Pennsylvania,10224547,6430787,6115377,315410
2015-11-01,Tennessee,5179769,3089920,2939534,150386
2015-11-01,Texas,20664893,13179187,12594402,584785
2015-11-01,Utah,2159614,1472655,1424496,48159
2015-11-01,Vermont,515222,344885,333722,11163
2015-11-01,Virginia,6515086,4204768,4042203,162565
2015-11-01,Washington,5661008,3583433,3388477,194956
2015-11-01,Wisconsin,4553525,3088875,2968493,120382
2015-11-01,Wyoming,451526,300575,287203,13372
2015-12-01,Alabama,3807670,2127731,2002140,125591
2015-12-01,Alaska,544288,358266,334627,23639
2015-12-01,Arizona,5325671,3203163,3025413,177750
2015-12-01,Arkansas,2305251,1332975,1277702,55273
2015-12-01,California,30422273,18820417,17770611,1049806
2015-12-01,Colorado,4275910,2843689,2752065,91624
2015-12-01,Connecticut,2873797,1870374,1780781,89593
2015-12-01,Delaware,749992,467611,448286,19325
2015-12-01,Florida,16428472,9689217,9208551,480666
2015-12-01,Georgia,7817713,4739467,4475227,264240
2015-12-01,Hawaii,1089802,674982,655989,18993
2015-12-01,Idaho,1258579,800749,769160,31589
2015-12-01,Illinois,10051892,6538313,6144607,393706
2015-12-01,Indiana,5131265,3292802,3146574,146228
2015-12-01,Iowa,2436877,1697756,1633970,63786
2015-12-01,Kansas,2209453,1492973,1438900,54073
2015-12-01,Kentucky,3451246,1990373,1892359,98014
2015-12-01,Louisiana,3576862,2114854,2004704,110150
2015-12-01,Maine,1092829,680642,653550,27092
2015-12-01,Maryland,4706659,3127946,2993989,133957
2015-12-01,Massachusetts,5523499,3572670,3424835,147835
2015-12-01,Michigan,7899267,4768096,4552777,215319
2015-12-01,Minnesota,4298949,3013907,2895958,117949
2015-12-01,Mississippi,2281963,1271576,1190289,81287
2015-12-01,Missouri,4745022,3044411,2916912,127499
2015-12-01,Montana,818959,515952,492355,23597
2015-12-01,Nebraska,1446285,1011694,983175,28519
2015-12-01,Nevada,2255466,1396531,1309375,87156
2015-12-01,Ohio,9142204,5703489,5430858,272631
2015-12-01,Oklahoma,2981527,1822630,1746213,76417
2015-12-01,Oregon,3244022,1998635,1901914,96721
2015-12-01,Pennsylvania,10225852,6419711,6109681,310030
2015-12-01,Tennessee,5184152,3092976,2949017,143959
2015-12-01,Texas,20696766,13168839,12612362,556477
2015-12-01,Utah,2164055,1468287,1420643,47644
2015-12-01,Vermont,515234,342854,332362,10492
2015-12-01,Virginia,6517537,4207850,4049051,158799
2015-12-01,Washington,5669906,3592985,3385813,207172
2015-12-01,Wisconsin,4555288,3084578,2962389,122189
2015-12-01,Wyoming,451469,298503,284575,13928
2016-01-01,Alabama,3808871,2123167,1985989,137178
2016-01-01,Alaska,545180,356568,331617,24951
2016-01-01,Arizona,5334647,3216525,3035487,181038
2016-01-01,Arkansas,2306098,1321205,1259280,61925
2016-01-01,California,30446733,18854686,17733459,1121227
2016-01-01,Colorado,4283491,2845418,2743896,101522
2016-01-01,Connecticut,2873756,1873999,1767087,106912
2016-01-01,Delaware,750671,466789,443948,22841
2016-01-01,Florida,16458012,9710085,9209244,500841
2016-01-01,Georgia,7828808,4747162,4472310,274852
2016-01-01,Hawaii,1091566,677674,657186,20488
2016-01-01,Idaho,1260815,798569,761590,36979
2016-01-01,Illinois,10050720,6537306,6091153,446153
2016-01-01,Indiana,5133138,3298344,3131030,167314
2016-01-01,Iowa,2437374,1696463,1621681,74782
2016-01-01,Kansas,2210492,1491185,1429895,61290
2016-01-01,Kentucky,3452439,1981834,1869688,112146
2016-01-01,Louisiana,3578098,2112155,1979189,132966
2016-01-01,Maine,1092946,678024,645875,32149
2016-01-01,Maryland,4707890,3124230,2975834,148396
2016-01-01,Massachusetts,5525824,3567809,3393650,174159
2016-01-01,Michigan,7900971,4764759,4513391,251368
2016-01-01,Minnesota,4301291,3002903,2866655,136248
2016-01-01,Mississippi,2282454,1260898,1180569,80329
2016-01-01,Missouri,4746243,3042656,2896279,146377
2016-01-01,Montana,819668,515538,487771,27767
2016-01-01,Nebraska,1447160,1009599,975954,33645
2016-01-01,Nevada,2259069,1398878,1308538,90340
2016-01-01,Ohio,9143345,5672766,5347197,325569
2016-01-01,Oklahoma,2982968,1819559,1736796,82763
2016-01-01,Oregon,3249240,1995592,1893111,102481
2016-01-01,Pennsylvania,10225383,6432171,6072651,359520
2016-01-01,Tennessee,5188358,3085712,2932793,152919
2016-01-01,Texas,20729955,13161299,12569046,592253
2016-01-01,Utah,2168291,1472899,1418852,54047
2016-01-01,Vermont,515143,344190,331242,12948
2016-01-01,Virginia,6523006,4193566,4015611,177955
2016-01-01,Washington,5679860,3592880,3381443,211437
2016-01-01,Wisconsin,4556269,3073174,2937062,136112
2016-01-01,Wyoming,451394,299280,281956,17324
2016-02-01,Alabama,3810043,2139583,2004932,134651
2016-02-01,Alaska,545399,358771,332663,26108
2016-02-01,Arizona,5343405,3226328,3052734,173594
2016-02-01,Arkansas,2306995,1341187,1278917,62270
2016-02-01,California,30467943,18970219,17866487,1103732
2016-02-01,Colorado,4290525,2871776,2767549,104227
2016-02-01,Connecticut,2873720,1874458,1770206,104252
2016-02-01,Delaware,751256,468022,445961,22061
2016-02-01,Florida,16486036,9744093,9275573,468520
2016-02-01,Georgia,7838741,4766752,4495873,270879
2016-02-01,Hawaii,1091817,677194,657469,19725
2016-02-01,Idaho,1263122,802837,767952,34885
2016-02-01,Illinois,10049562,6571218,6133369,437849
2016-02-01,Indiana,5135638,3313798,3143555,170243
2016-02-01,Iowa,2438141,1708714,1637760,70954
2016-02-01,Kansas,2210999,1499262,1436400,62862
2016-02-01,Kentucky,3453453,1992164,1878135,114029
2016-02-01,Louisiana,3579257,2113628,1993683,119945
2016-02-01,Maine,1093136,681061,649256,31805
2016-02-01,Maryland,4708745,3132804,2986754,146050
2016-02-01,Massachusetts,5528649,3587546,3418642,168904
2016-02-01,Michigan,7903525,4798768,4544379,254389
2016-02-01,Minnesota,4304127,3016002,2880520,135482
2016-02-01,Mississippi,2282748,1265708,1189844,75864
2016-02-01,Missouri,4747477,3061261,2910163,151098
2016-02-01,Montana,820356,519216,492958,26258
2016-02-01,Nebraska,1448030,1016154,983453,32701
2016-02-01,Nevada,2262476,1410638,1324495,86143
2016-02-01,Ohio,9145329,5715426,5395250,320176
2016-02-01,Oklahoma,2984249,1831744,1745520,86224
2016-02-01,Oregon,3254767,2019903,1915882,104021
2016-02-01,Pennsylvania,10225863,6450299,6082320,367979
2016-02-01,Tennessee,5192499,3102482,2954732,147750
2016-02-01,Texas,20761195,13284069,12694983,589086
2016-02-01,Utah,2172793,1483947,1427691,56256
2016-02-01,Vermont,515166,345140,333003,12137
2016-02-01,Virginia,6525781,4224923,4051559,173364
2016-02-01,Washington,5688716,3625496,3415217,210279
2016-02-01,Wisconsin,4557711,3096295,2953737,142558
2016-02-01,Wyoming,451385,299904,282934,16970
2016-03-01,Alabama,3811375,2145856,2015651,130205
2016-03-01,Alaska,545610,359843,334130,25713
2016-03-01,Arizona,5352249,3246694,3071139,175555
2016-03-01,Arkansas,2308015,1348302,1293311,54991
2016-03-01,California,30489297,19017213,17903929,1113284
2016-03-01,Colorado,4297576,2870570,2771118,99452
2016-03-01,Connecticut,2873702,1887540,1786701,100839
2016-03-01,Delaware,751898,471272,449714,21558
2016-03-01,Florida,16514110,9761578,9291336,470242
2016-03-01,Georgia,7849068,4819888,4552961,266927
2016-03-01,Hawaii,1091983,679981,660237,19744
2016-03-01,Idaho,1265474,808411,773446,34965
2016-03-01,Illinois,10048662,6604724,6178618,426106
2016-03-01,Indiana,5138247,3336700,3169978,166722
2016-03-01,Iowa,2438939,1711224,1643367,67857
2016-03-01,Kansas,2211607,1493769,1433006,60763
2016-03-01,Kentucky,3454600,2004382,1893423,110959
2016-03-01,Louisiana,3580477,2129390,2003592,125798
2016-03-01,Maine,1093359,684727,653790,30937
2016-03-01,Maryland,4709564,3145666,3005895,139771
2016-03-01,Massachusetts,5531634,3606643,3444159,162484
2016-03-01,Michigan,7906243,4825789,4563116,262673
2016-03-01,Minnesota,4307033,3021678,2882574,139104
2016-03-01,Mississippi,2283174,1264891,1192018,72873
2016-03-01,Missouri,4748932,3069228,2919881,149347
2016-03-01,Montana,821079,522886,496364,26522
2016-03-01,Nebraska,1448888,1020034,987012,33022
2016-03-01,Nevada,2265948,1412514,1326013,86501
2016-03-01,Ohio,9147631,5750011,5442892,307119
2016-03-01,Oklahoma,2985654,1836876,1752735,84141
2016-03-01,Oregon,3260421,2032483,1926566,105917
2016-03-01,Pennsylvania,10226626,6446704,6087602,359102
2016-03-01,Tennessee,5196802,3113394,2967833,145561
2016-03-01,Texas,20792661,13307365,12708482,598883
2016-03-01,Utah,2177280,1489824,1434191,55633
2016-03-01,Vermont,515178,346202,334026,12176
2016-03-01,Virginia,6528060,4252842,4082315,170527
2016-03-01,Washington,5697581,3640036,3432921,207115
2016-03-01,Wisconsin,4559314,3099030,2961146,137884
2016-03-01,Wyoming,451294,302071,284074,17997
2016-04-01,Alabama,3812782,2145498,2029397,116101
2016-04-01,Alaska,545942,359210,334907,24303
2016-04-01,Arizona,5361241,3233673,3059054,174619
2016-04-01,Arkansas,2309079,1345958,1297856,48102
2016-04-01,California,30512396,18918963,17899662,1019301
2016-04-01,Colorado,4304871,2867792,2774191,93601
2016-04-01,Connecticut,2873785,1876208,1786507,89701
2016-04-01,Delaware,752531,469422,449349,20073
2016-04-01,Florida,16542894,9768997,9314007,454990
2016-04-01,Georgia,7859831,4819662,4568591,251071
2016-04-01,Hawaii,1092461,677916,658226,19690
2016-04-01,Idaho,1267849,806711,776770,29941
2016-04-01,Illinois,10048172,6569980,6175093,394887
2016-04-01,Indiana,5140915,3336753,3194290,142463
2016-04-01,Iowa,2439789,1711728,1653098,58630
2016-04-01,Kansas,2212288,1490731,1434752,55979
2016-04-01,Kentucky,3455877,2003544,1909988,93556
2016-04-01,Louisiana,3581804,2128111,2007467,120644
2016-04-01,Maine,1093632,686591,659034,27557
2016-04-01,Maryland,4710558,3131724,3007540,124184
2016-04-01,Massachusetts,5534696,3597710,3455979,141731
2016-04-01,Michigan,7909088,4800346,4575856,224490
2016-04-01,Minnesota,4310025,3019151,2907944,111207
2016-04-01,Mississippi,2283610,1265167,1196618,68549
2016-04-01,Missouri,4750527,3074954,2942769,132185
2016-04-01,Montana,821797,519778,497615,22163
2016-04-01,Nebraska,1449875,1018959,988784,30175
2016-04-01,Nevada,2269583,1406794,1323100,83694
2016-04-01,Ohio,9150016,5759982,5481870,278112
2016-04-01,Oklahoma,2987151,1824837,1746006,78831
2016-04-01,Oregon,3266109,2029533,1934274,95259
2016-04-01,Pennsylvania,10227506,6437380,6114263,323117
2016-04-01,Tennessee,5201269,3117559,2983695,133864
2016-04-01,Texas,20825236,13311301,12743621,567680
2016-04-01,Utah,2181885,1484052,1432884,51168
2016-04-01,Vermont,515160,342207,330980,11227
2016-04-01,Virginia,6531334,4244107,4094310,149797
2016-04-01,Washington,5706896,3626838,3440339,186499
2016-04-01,Wisconsin,4560930,3092313,2970525,121788
2016-04-01,Wyoming,451233,301269,282792,18477
2016-05-01,Alabama,3814145,2151288,2035510,115778
2016-05-01,Alaska,546309,362606,339484,23122
2016-05-01,Arizona,5370157,3237155,3068861,168294
2016-05-01,Arkansas,2310084,1350814,1298945,51869
2016-05-01,California,30534603,18934864,17995777,939087
2016-05-01,Colorado,4312234,2872824,2784455,88369
2016-05-01,Connecticut,2873870,1892434,1801766,90668
2016-05-01,Delaware,753166,466371,447490,18881
2016-05-01,Florida,16571697,9825507,9376480,449027
2016-05-01,Georgia,7870375,4867706,4617041,250665
2016-05-01,Hawaii,1092967,676808,657950,18858
2016-05-01,Idaho,1270248,811466,785381,26085
2016-05-01,Illinois,10047560,6545940,6189962,355978
2016-05-01,Indiana,5143600,3345054,3207501,137553
2016-05-01,Iowa,2440696,1701621,1644940,56681
2016-05-01,Kansas,2213068,1489516,1433679,55837
2016-05-01,Kentucky,3457188,2016104,1919459,96645
2016-05-01,Louisiana,3583030,2128966,2005400,123566
2016-05-01,Maine,1093899,689082,664201,24881
2016-05-01,Maryland,4711468,3138306,3013100,125206
2016-05-01,Massachusetts,5537771,3587038,3448451,138587
2016-05-01,Michigan,7911815,4846862,4622689,224173
2016-05-01,Minnesota,4313066,3019444,2919583,99861
2016-05-01,Mississippi,2284042,1277921,1201457,76464
2016-05-01,Missouri,4752183,3085647,2954064,131583
2016-05-01,Montana,822573,522658,502949,19709
2016-05-01,Nebraska,1450843,1022459,994215,28244
2016-05-01,Nevada,2273098,1411202,1332535,78667
2016-05-01,Ohio,9152322,5757787,5493106,264681
2016-05-01,Oklahoma,2988671,1828816,1743628,85188
2016-05-01,Oregon,3271771,2030618,1941835,88783
2016-05-01,Pennsylvania,10228380,6478293,6142910,335383
2016-05-01,Tennessee,5205703,3115223,2985631,129592
2016-05-01,Texas,20857325,13301888,12735406,566482
2016-05-01,Utah,2186473,1493060,1445433,47627
2016-05-01,Vermont,515170,343918,333961,9957
2016-05-01,Virginia,6534789,4249724,4089988,159736
2016-05-01,Washington,5716292,3632210,3450946,181264
2016-05-01,Wisconsin,4562657,3095951,2982096,113855
2016-05-01,Wyoming,451222,301076,284086,16990
2016-06-01,Alabama,3815642,2173899,2037600,136299
2016-06-01,Alaska,546635,368398,343829,24569
2016-06-01,Arizona,5379277,3253237,3063224,190013
2016-06-01,Arkansas,2311209,1361014,1302914,58100
2016-06-01,California,30557662,18993992,17920136,1073856
2016-06-01,Colorado,4319761,2906329,2805208,101121
2016-06-01,Connecticut,2874029,1911300,1814306,96994
2016-06-01,Delaware,753847,471567,448972,22595
2016-06-01,Florida,16601075,9849098,9349033,500065
2016-06-01,Georgia,7880992,4925233,4642564,282669
2016-06-01,Hawaii,1093490,680285,656054,24231
2016-06-01,Idaho,1272686,819888,791822,28066
2016-06-01,Illinois,10047244,6631537,6230696,400841
2016-06-01,Indiana,5146468,3376726,3223529,153197
2016-06-01,Iowa,2441687,1714046,1649830,64216
2016-06-01,Kansas,2213900,1507626,1444111,63515
2016-06-01,Kentucky,3458575,2040995,1931121,109874
2016-06-01,Louisiana,3584422,2159889,2008752,151137
2016-06-01,Maine,1094206,703862,678285,25577
2016-06-01,Maryland,4712540,3175980,3032495,143485
2016-06-01,Massachusetts,5541082,3648807,3495782,153025
2016-06-01,Michigan,7914881,4889051,4638074,250977
2016-06-01,Minnesota,4316269,3033706,2913250,120456
2016-06-01,Mississippi,2284502,1287798,1197904,89894
2016-06-01,Missouri,4753964,3124573,2974670,149903
2016-06-01,Montana,823348,528971,506139,22832
2016-06-01,Nebraska,1451894,1028838,994263,34575
2016-06-01,Nevada,2276707,1414193,1328997,85196
2016-06-01,Ohio,9155037,5797881,5502957,294924
2016-06-01,Oklahoma,2990230,1844213,1749758,94455
2016-06-01,Oregon,3277621,2058947,1950949,107998
2016-06-01,Pennsylvania,10229680,6520474,6160196,360278
2016-06-01,Tennessee,5210293,3159058,2993250,165808
2016-06-01,Texas,20889995,13363752,12700951,662801
2016-06-01,Utah,2191135,1504414,1449287,55127
2016-06-01,Vermont,515205,350370,338848,11522
2016-06-01,Virginia,6538478,4285570,4109953,175617
2016-06-01,Washington,5725845,3655491,3468804,186687
2016-06-01,Wisconsin,4564494,3158019,3019690,138329
2016-06-01,Wyoming,451169,305383,288371,17012
2016-07-01,Alabama,3817320,2167102,2035357,131745
2016-07-01,Alaska,547000,371194,348623,22571
2016-07-01,Arizona,5388764,3259413,3067321,192092
2016-07-01,Arkansas,2312505,1359734,1300231,59503
2016-07-01,California,30582360,19109220,17997498,1111722
2016-07-01,Colorado,4327483,2913559,2819934,93625
2016-07-01,Connecticut,2874369,1930345,1832940,97405
2016-07-01,Delaware,754560,473259,450669,22590
2016-07-01,Florida,16631565,9890961,9378028,512933
2016-07-01,Georgia,7891678,4970434,4686157,284277
2016-07-01,Hawaii,1094097,682001,661750,20251
2016-07-01,Idaho,1275237,824358,795828,28530
2016-07-01,Illinois,10047294,6637787,6249177,388610
2016-07-01,Indiana,5149720,3379307,3231004,148303
2016-07-01,Iowa,2442852,1721492,1658360,63132
2016-07-01,Kansas,2214883,1511581,1438881,72700
2016-07-01,Kentucky,3460228,2032924,1926479,106445
2016-07-01,Louisiana,3586053,2157686,2010629,147057
2016-07-01,Maine,1094627,711890,686889,25001
2016-07-01,Maryland,4714009,3199560,3054874,144686
2016-07-01,Massachusetts,5544738,3680180,3526232,153948
2016-07-01,Michigan,7918535,4916663,4633396,283267
2016-07-01,Minnesota,4319767,3049347,2934927,114420
2016-07-01,Mississippi,2285162,1285064,1198974,86090
2016-07-01,Missouri,4755898,3118966,2958712,160254
2016-07-01,Montana,824204,529176,508331,20845
2016-07-01,Nebraska,1453027,1028614,994009,34605
2016-07-01,Nevada,2280511,1420329,1336447,83882
2016-07-01,Ohio,9158454,5819096,5526225,292871
2016-07-01,Oklahoma,2991883,1833999,1743441,90558
2016-07-01,Oregon,3283694,2064962,1957642,107320
2016-07-01,Pennsylvania,10231756,6547445,6164929,382516
2016-07-01,Tennessee,5215287,3169704,3005694,164010
2016-07-01,Texas,20923730,13404061,12724437,679624
2016-07-01,Utah,2195928,1509383,1458972,50411
2016-07-01,Vermont,515265,350486,339622,10864
2016-07-01,Virginia,6542390,4302709,4123616,179093
2016-07-01,Washington,5735768,3672800,3483540,189260
2016-07-01,Wisconsin,4566737,3156370,3030219,126151
2016-07-01,Wyoming,451175,303819,288505,15314
2016-08-01,Alabama,3819041,2161631,2032229,129402
2016-08-01,Alaska,547166,367255,345836,21419
2016-08-01,Arizona,5398026,3254973,3066091,188882
2016-08-01,Arkansas,2313694,1345745,1292107,53638
2016-08-01,California,30603497,19044892,17969199,1075693
2016-08-01,Colorado,4333997,2912749,2821967,90782
2016-08-01,Connecticut,2874907,1902388,1808401,93987
2016-08-01,Delaware,755276,470520,447986,22534
2016-08-01,Florida,16660212,9883251,9371444,511807
2016-08-01,Georgia,7901048,4962782,4685919,276863
2016-08-01,Hawaii,1094428,678683,659690,18993
2016-08-01,Idaho,1277924,817269,789413,27856
2016-08-01,Illinois,10047320,6558809,6181614,377195
2016-08-01,Indiana,5152279,3343752,3199673,144079
2016-08-01,Iowa,2443877,1702902,1642214,60688
2016-08-01,Kansas,2215338,1481273,1416295,64978
2016-08-01,Kentucky,3461891,2020903,1924850,96053
2016-08-01,Louisiana,3586312,2120192,1980436,139756
2016-08-01,Maine,1095131,712203,689261,22942
2016-08-01,Maryland,4716465,3169290,3029244,140046
2016-08-01,Massachusetts,5548563,3669351,3529346,140005
2016-08-01,Michigan,7922091,4899121,4644918,254203
2016-08-01,Minnesota,4323214,3034249,2921661,112588
2016-08-01,Mississippi,2285881,1268068,1191832,76236
2016-08-01,Missouri,4757964,3079239,2921926,157313
2016-08-01,Montana,825155,525892,505464,20428
2016-08-01,Nebraska,1453909,1013675,982357,31318
2016-08-01,Nevada,2284685,1413917,1333221,80696
2016-08-01,Ohio,9162085,5787248,5506001,281247
2016-08-01,Oklahoma,2992749,1822899,1734208,88691
2016-08-01,Oregon,3288289,2067491,1963578,103913
2016-08-01,Pennsylvania,10234047,6500028,6128908,371120
2016-08-01,Tennessee,5220640,3146995,2990103,156892
2016-08-01,Texas,20954163,13378377,12714355,664022
2016-08-01,Utah,2200587,1506293,1455292,51001
2016-08-01,Vermont,515403,348099,337676,10423
2016-08-01,Virginia,6548312,4265501,4084037,181464
2016-08-01,Washington,5746009,3661891,3475781,186110
2016-08-01,Wisconsin,4568957,3139078,3017961,121117
2016-08-01,Wyoming,450983,301038,286815,14223
2016-09-01,Alabama,3820951,2158793,2031505,127288
2016-09-01,Alaska,547374,363575,340885,22690
2016-09-01,Arizona,5407618,3281818,3096786,185032
2016-09-01,Arkansas,2314999,1347060,1294934,52126
2016-09-01,California,30626494,19138832,18110336,1028496
2016-09-01,Colorado,4340722,2922393,2839672,82721
2016-09-01,Connecticut,2875660,1888931,1802449,86482
2016-09-01,Delaware,756102,464623,443293,21330
2016-09-01,Florida,16689784,9949583,9442810,506773
2016-09-01,Georgia,7910767,5000864,4728475,272389
2016-09-01,Hawaii,1094839,679154,658976,20178
2016-09-01,Idaho,1280709,816923,789885,27038
2016-09-01,Illinois,10047781,6523778,6157731,366047
2016-09-01,Indiana,5155140,3322245,3190856,131389
2016-09-01,Iowa,2445007,1704034,1648422,55612
2016-09-01,Kansas,2215863,1483268,1426055,57213
2016-09-01,Kentucky,3463726,2019854,1922839,97015
2016-09-01,Louisiana,3586737,2124559,1986106,138453
2016-09-01,Maine,1095713,695715,672538,23177
2016-09-01,Maryland,4719113,3156690,3027495,129195
2016-09-01,Massachusetts,5552657,3608499,3469985,138514
2016-09-01,Michigan,7925989,4867940,4634708,233232
2016-09-01,Minnesota,4326878,3023388,2918476,104912
2016-09-01,Mississippi,2286653,1272468,1198319,74149
2016-09-01,Missouri,4760235,3067036,2930463,136573
2016-09-01,Montana,826169,520816,501972,18844
2016-09-01,Nebraska,1454904,1006876,977373,29503
2016-09-01,Nevada,2289002,1420949,1340083,80866
2016-09-01,Ohio,9166161,5744912,5459586,285326
2016-09-01,Oklahoma,2993771,1826078,1739879,86199
2016-09-01,Oregon,3293114,2060664,1968453,92211
2016-09-01,Pennsylvania,10236775,6462234,6124840,337394
2016-09-01,Tennessee,5226225,3158157,3002955,155202
2016-09-01,Texas,20985782,13404600,12744681,659919
2016-09-01,Utah,2205274,1509652,1463226,46426
2016-09-01,Vermont,515579,343932,333366,10566
2016-09-01,Virginia,6554563,4251355,4076498,174857
2016-09-01,Washington,5756519,3673078,3492952,180126
2016-09-01,Wisconsin,4571331,3111756,3001000,110756
2016-09-01,Wyoming,450823,299837,285841,13996
2016-10-01,Alabama,3822861,2176930,2049216,127714
2016-10-01,Alaska,547373,359500,336819,22681
2016-10-01,Arizona,5417057,3277329,3101091,176238
2016-10-01,Arkansas,2316340,1341159,1295221,45938
2016-10-01,California,30648257,19091770,18074798,1016972
2016-10-01,Colorado,4347159,2923347,2841973,81374
2016-10-01,Connecticut,2876331,1895969,1811828,84141
2016-10-01,Delaware,756884,467189,446263,20926
2016-10-01,Florida,16718944,9943140,9456812,486328
2016-10-01,Georgia,7920402,5065870,4792800,273070
2016-10-01,Hawaii,1094781,678291,659544,18747
2016-10-01,Idaho,1283493,817968,791695,26273
2016-10-01,Illinois,10048334,6531835,6170870,360965
2016-10-01,Indiana,5158013,3323010,3193007,130003
2016-10-01,Iowa,2446168,1701379,1649952,51427
2016-10-01,Kansas,2216246,1487756,1430338,57418
2016-10-01,Kentucky,3465422,2023275,1927972,95303
2016-10-01,Louisiana,3587044,2117356,1993102,124254
2016-10-01,Maine,1096317,699220,676193,23027
2016-10-01,Maryland,4721604,3173020,3040532,132488
2016-10-01,Massachusetts,5556771,3614917,3490192,124725
2016-10-01,Michigan,7930030,4869080,4639737,229343
2016-10-01,Minnesota,4330635,3024712,2921929,102783
2016-10-01,Mississippi,2287376,1273882,1202315,71567
2016-10-01,Missouri,4762631,3063653,2941980,121673
2016-10-01,Montana,827139,520173,499793,20380
2016-10-01,Nebraska,1455876,1012128,982626,29502
2016-10-01,Nevada,2293207,1422918,1344559,78359
2016-10-01,Ohio,9170273,5763358,5487037,276321
2016-10-01,Oklahoma,2994760,1826764,1742838,83926
2016-10-01,Oregon,3297913,2062597,1971507,91090
2016-10-01,Pennsylvania,10239633,6450443,6123379,327064
2016-10-01,Tennessee,5231683,3161816,3012361,149455
2016-10-01,Texas,21016880,13388052,12773643,614409
2016-10-01,Utah,2210053,1514380,1467906,46474
2016-10-01,Vermont,515777,345637,337538,8099
2016-10-01,Virginia,6559961,4268773,4098253,170520
2016-10-01,Washington,5766564,3677054,3500834,176220
2016-10-01,Wisconsin,4573809,3111448,3004154,107294
2016-10-01,Wyoming,450635,298726,284600,14126
2016-11-01,Alabama,3824434,2166442,2050806,115636
2016-11-01,Alaska,547491,359062,335568,23494
2016-11-01,Arizona,5426062,3283615,3120150,163465
2016-11-01,Arkansas,2317392,1336386,1291700,44686
2016-11-01,California,30668672,19078544,18102779,975765
2016-11-01,Colorado,4353436,2916030,2840520,75510
2016-11-01,Connecticut,2876745,1897671,1822962,74709
2016-11-01,Delaware,757580,467523,448505,19018
2016-11-01,Florida,16746204,9879592,9416791,462801
2016-11-01,Georgia,7929986,5056493,4803284,253209
2016-11-01,Hawaii,1095019,681876,664295,17581
2016-11-01,Idaho,1286128,816741,788614,28127
2016-11-01,Illinois,10048158,6516861,6182242,334619
2016-11-01,Indiana,5160413,3317330,3188419,128911
2016-11-01,Iowa,2447065,1686072,1636627,49445
2016-11-01,Kansas,2216532,1487925,1433050,54875
2016-11-01,Kentucky,3466939,2023712,1936779,86933
2016-11-01,Louisiana,3587097,2107029,1992331,114698
2016-11-01,Maine,1096776,693118,669328,23790
2016-11-01,Maryland,4723739,3164369,3039344,125025
2016-11-01,Massachusetts,5560400,3619431,3499851,119580
2016-11-01,Michigan,7933209,4865317,4650223,215094
2016-11-01,Minnesota,4333928,3016230,2915409,100821
2016-11-01,Mississippi,2287980,1270332,1203756,66576
2016-11-01,Missouri,4764665,3045894,2930055,115839
2016-11-01,Montana,828064,519382,498931,20451
2016-11-01,Nebraska,1456682,1010080,983329,26751
2016-11-01,Nevada,2297276,1422198,1348481,73717
2016-11-01,Ohio,9173416,5752796,5484413,268383
2016-11-01,Oklahoma,2995627,1828951,1749953,78998
2016-11-01,Oregon,3302377,2054836,1973191,81645
2016-11-01,Pennsylvania,10241288,6413754,6109578,304176
2016-11-01,Tennessee,5236761,3158887,3017143,141744
2016-11-01,Texas,21046899,13436952,12832097,604855
2016-11-01,Utah,2214643,1520085,1476786,43299
2016-11-01,Vermont,515880,345912,336173,9739
2016-11-01,Virginia,6565331,4255273,4093430,161843
2016-11-01,Washington,5776410,3668939,3494754,174185
2016-11-01,Wisconsin,4575836,3106190,3003245,102945
2016-11-01,Wyoming,450398,297542,283141,14401
2016-12-01,Alabama,3825968,2158561,2041693,116868
2016-12-01,Alaska,547590,358231,333960,24271
2016-12-01,Arizona,5434795,3270856,3108272,162584
2016-12-01,Arkansas,2318409,1328132,1279747,48385
2016-12-01,California,30688153,18991010,18010827,980183
2016-12-01,Colorado,4359555,2907097,2831565,75532
2016-12-01,Connecticut,2877085,1887160,1811527,75633
2016-12-01,Delaware,758249,469132,449527,19605
2016-12-01,Florida,16773010,9889733,9441288,448445
2016-12-01,Georgia,7939421,5058917,4798903,260014
2016-12-01,Hawaii,1095214,679589,663310,16279
2016-12-01,Idaho,1288749,813907,785763,28144
2016-12-01,Illinois,10047713,6478683,6131537,347146
2016-12-01,Indiana,5162688,3288829,3164196,124633
2016-12-01,Iowa,2447876,1678282,1619567,58715
2016-12-01,Kansas,2216707,1479640,1426583,53057
2016-12-01,Kentucky,3468367,2028051,1933016,95035
2016-12-01,Louisiana,3587029,2085319,1974977,110342
2016-12-01,Maine,1097189,691511,668027,23484
2016-12-01,Maryland,4725774,3159387,3036822,122565
2016-12-01,Massachusetts,5563855,3622040,3495656,126384
2016-12-01,Michigan,7936205,4839959,4622885,217074
2016-12-01,Minnesota,4337066,3016512,2893252,123260
2016-12-01,Mississippi,2288535,1269825,1201281,68544
2016-12-01,Missouri,4766621,3041747,2920523,121224
2016-12-01,Montana,828950,516354,492908,23446
2016-12-01,Nebraska,1457487,1005333,976220,29113
2016-12-01,Nevada,2301284,1416267,1342215,74052
2016-12-01,Ohio,9176341,5732496,5442630,289866
2016-12-01,Oklahoma,2996384,1811916,1733935,77981
2016-12-01,Oregon,3306702,2037526,1957810,79716
2016-12-01,Pennsylvania,10242658,6367458,6064149,303309
2016-12-01,Tennessee,5241716,3147794,3005957,141837
2016-12-01,Texas,21076258,13420306,12805069,615237
2016-12-01,Utah,2219183,1513656,1469250,44406
2016-12-01,Vermont,515998,344120,334083,10037
2016-12-01,Virginia,6570569,4257839,4098297,159542
2016-12-01,Washington,5786076,3655977,3476793,179184
2016-12-01,Wisconsin,4577736,3085970,2984098,101872
2016-12-01,Wyoming,450188,296607,280155,16452
2017-01-01,Alabama,3827336,2154267,2023699,130568
2017-01-01,Alaska,547623,357869,331289,26580
2017-01-01,Arizona,5443325,3292927,3115852,177075
2017-01-01,Arkansas,2319332,1321143,1262706,58437
2017-01-01,California,30706378,19064042,17986609,1077433
2017-01-01,Colorado,4365315,2911440,2821595,89845
2017-01-01,Connecticut,2877354,1897987,1798443,99544
2017-01-01,Delaware,758922,470770,446452,24318
2017-01-01,Florida,16799082,9933122,9447407,485715
2017-01-01,Georgia,7948388,5069422,4791600,277822
2017-01-01,Hawaii,1095136,684902,666226,18676
2017-01-01,Idaho,1291268,817013,781254,35759
2017-01-01,Illinois,10046909,6465343,6069438,395905
2017-01-01,Indiana,5164740,3295318,3147576,147742
2017-01-01,Iowa,2448593,1672588,1600725,71863
2017-01-01,Kansas,2216729,1475230,1414499,60731
2017-01-01,Kentucky,3469500,2026968,1911859,115109
2017-01-01,Louisiana,3586792,2082265,1954774,127491
2017-01-01,Maine,1097564,689697,660320,29377
2017-01-01,Maryland,4727477,3165072,3019298,145774
2017-01-01,Massachusetts,5567147,3633458,3469578,163880
2017-01-01,Michigan,7938921,4840374,4573626,266748
2017-01-01,Minnesota,4340091,3019806,2879439,140367
2017-01-01,Mississippi,2288902,1266734,1190383,76351
2017-01-01,Missouri,4768305,3032788,2892964,139824
2017-01-01,Montana,829814,517471,489967,27504
2017-01-01,Nebraska,1458153,1003995,968282,35713
2017-01-01,Nevada,2305093,1423884,1343419,80465
2017-01-01,Ohio,9178815,5722922,5368433,354489
2017-01-01,Oklahoma,2996974,1808781,1725473,83308
2017-01-01,Oregon,3310911,2025989,1933749,92240
2017-01-01,Pennsylvania,10243590,6395359,6037797,357562
2017-01-01,Tennessee,5246270,3143775,2985373,158402
2017-01-01,Texas,21104864,13428839,12754978,673861
2017-01-01,Utah,2223546,1519297,1467391,51906
2017-01-01,Vermont,516063,345958,333177,12781
2017-01-01,Virginia,6574870,4264334,4077570,186764
2017-01-01,Washington,5795156,3673031,3470674,202357
2017-01-01,Wisconsin,4579412,3077559,2957282,120277
2017-01-01,Wyoming,449900,294526,278346,16180
2017-02-01,Alabama,3828265,2164727,2041488,123239
2017-02-01,Alaska,547523,361005,334240,26765
2017-02-01,Arizona,5451183,3304502,3136542,167960
2017-02-01,Arkansas,2319981,1340841,1282421,58420
2017-02-01,California,30720743,19158495,18110296,1048199
2017-02-01,Colorado,4370670,2936226,2851895,84331
2017-02-01,Connecticut,2877294,1898171,1801982,96189
2017-02-01,Delaware,759440,472246,448532,23714
2017-02-01,Florida,16822770,9965813,9519625,446188
2017-02-01,Georgia,7956361,5085831,4819408,266423
2017-02-01,Hawaii,1094820,684278,667122,17156
2017-02-01,Idaho,1293661,821336,787865,33471
2017-02-01,Illinois,10044983,6463956,6105222,358734
2017-02-01,Indiana,5166404,3295519,3154711,140808
2017-02-01,Iowa,2449040,1686178,1621863,64315
2017-02-01,Kansas,2216489,1485191,1424931,60260
2017-02-01,Kentucky,3470348,2036180,1921194,114986
2017-02-01,Louisiana,3586192,2091833,1979944,111889
2017-02-01,Maine,1097810,690253,661640,28613
2017-02-01,Maryland,4728764,3173077,3032748,140329
2017-02-01,Massachusetts,5569963,3647304,3487438,159866
2017-02-01,Michigan,7940951,4861870,4601122,260748
2017-02-01,Minnesota,4342753,3033002,2898288,134714
2017-02-01,Mississippi,2289079,1267886,1201381,66505
2017-02-01,Missouri,4769419,3048405,2906651,141754
2017-02-01,Montana,830555,520996,495487,25509
2017-02-01,Nebraska,1458699,1011002,977307,33695
2017-02-01,Nevada,2308708,1439206,1361992,77214
2017-02-01,Ohio,9180547,5757453,5411472,345981
2017-02-01,Oklahoma,2997232,1817157,1734779,82378
2017-02-01,Oregon,3314845,2051052,1964109,86943
2017-02-01,Pennsylvania,10243625,6411937,6052728,359209
2017-02-01,Tennessee,5250360,3163543,3017672,145871
2017-02-01,Texas,21131020,13537477,12868709,668768
2017-02-01,Utah,2227847,1532015,1476956,55059
2017-02-01,Vermont,516120,346018,333711,12307
2017-02-01,Virginia,6578630,4304955,4125356,179599
2017-02-01,Washington,5803711,3695730,3501985,193745
2017-02-01,Wisconsin,4580718,3097670,2972698,124972
2017-02-01,Wyoming,449600,294647,279830,14817
2017-03-01,Alabama,3829333,2168745,2059526,109219
2017-03-01,Alaska,547417,359717,334454,25263
2017-03-01,Arizona,5459193,3322395,3159530,162865
2017-03-01,Arkansas,2320778,1348077,1299004,49073
2017-03-01,California,30735267,19197205,18192667,1004538
2017-03-01,Colorado,4376278,2942245,2872736,69509
2017-03-01,Connecticut,2877313,1909255,1820379,88876
2017-03-01,Delaware,760014,474809,452771,22038
2017-03-01,Florida,16846758,9979214,9559073,420141
2017-03-01,Georgia,7964783,5101331,4850580,250751
2017-03-01,Hawaii,1094525,687639,672144,15495
2017-03-01,Idaho,1296159,824694,793694,31000
2017-03-01,Illinois,10043386,6476615,6149817,326798
2017-03-01,Indiana,5168285,3311925,3190547,121378
2017-03-01,Iowa,2449719,1685871,1626108,59763
2017-03-01,Kansas,2216375,1481172,1426182,54990
2017-03-01,Kentucky,3471436,2053612,1944443,109169
2017-03-01,Louisiana,3585727,2101544,1992973,108571
2017-03-01,Maine,1098136,693526,667589,25937
2017-03-01,Maryland,4730125,3191633,3062004,129629
2017-03-01,Massachusetts,5572949,3669159,3520984,148175
2017-03-01,Michigan,7943239,4862035,4627864,234171
2017-03-01,Minnesota,4345594,3045661,2917440,128221
2017-03-01,Mississippi,2289330,1274063,1208510,65553
2017-03-01,Missouri,4770874,3053000,2922248,130752
2017-03-01,Montana,831334,524517,499731,24786
2017-03-01,Nebraska,1459369,1012230,981583,30647
2017-03-01,Nevada,2312390,1440649,1367602,73047
2017-03-01,Ohio,9182728,5772002,5465905,306097
2017-03-01,Oklahoma,2997625,1825844,1751451,74393
2017-03-01,Oregon,3318897,2065308,1977933,87375
2017-03-01,Pennsylvania,10244043,6406984,6072958,334026
2017-03-01,Tennessee,5254762,3168515,3038982,129533
2017-03-01,Texas,21157545,13552874,12931121,621753
2017-03-01,Utah,2232281,1537090,1484974,52116
2017-03-01,Vermont,516208,347990,335877,12113
2017-03-01,Virginia,6582701,4332652,4162256,170396
2017-03-01,Washington,5812551,3705515,3527156,178359
2017-03-01,Wisconsin,4582253,3100741,2990212,110529
2017-03-01,Wyoming,449313,296094,281936,14158
2017-04-01,Alabama,3830510,2170041,2077420,92621
2017-04-01,Alaska,547545,358462,334797,23665
2017-04-01,Arizona,5467393,3310266,3153070,157196
2017-04-01,Arkansas,2321575,1353483,1309878,43605
2017-04-01,California,30752193,19109068,18207706,901362
2017-04-01,Colorado,4382200,2948612,2881344,67268
2017-04-01,Connecticut,2877417,1900355,1820739,79616
2017-04-01,Delaware,760618,475288,454788,20500
2017-04-01,Florida,16871541,10014328,9615671,398657
2017-04-01,Georgia,7973759,5089592,4855059,234533
2017-04-01,Hawaii,1094624,685829,670547,15282
2017-04-01,Idaho,1298673,824455,798475,25980
2017-04-01,Illinois,10042277,6448083,6146245,301838
2017-04-01,Indiana,5170204,3322602,3226252,96350
2017-04-01,Iowa,2450329,1691308,1640967,50341
2017-04-01,Kansas,2216468,1481299,1430002,51297
2017-04-01,Kentucky,3472662,2054183,1959236,94947
2017-04-01,Louisiana,3585365,2107983,2001637,106346
2017-04-01,Maine,1098491,695174,670528,24646
2017-04-01,Maryland,4731712,3187434,3069889,117545
2017-04-01,Massachusetts,5575973,3660285,3529375,130910
2017-04-01,Michigan,7945516,4836533,4648949,187584
2017-04-01,Minnesota,4348459,3045807,2941143,104664
2017-04-01,Mississippi,2289668,1275771,1214772,60999
2017-04-01,Missouri,4772470,3066125,2955280,110845
2017-04-01,Montana,832173,523553,502846,20707
2017-04-01,Nebraska,1460051,1017845,988974,28871
2017-04-01,Nevada,2316135,1442138,1369141,72997
2017-04-01,Ohio,9184900,5780363,5512513,267850
2017-04-01,Oklahoma,2998224,1820007,1752712,67295
2017-04-01,Oregon,3322961,2073209,1996318,76891
2017-04-01,Pennsylvania,10244449,6412541,6120790,291751
2017-04-01,Tennessee,5259299,3169404,3062500,106904
2017-04-01,Texas,21185490,13570284,13001741,568543
2017-04-01,Utah,2236716,1533679,1486078,47601
2017-04-01,Vermont,516283,344621,333265,11356
2017-04-01,Virginia,6587696,4337821,4186581,151240
2017-04-01,Washington,5821915,3696052,3538830,157222
2017-04-01,Wisconsin,4583785,3106680,3010337,96343
2017-04-01,Wyoming,449046,293658,281384,12274
2017-05-01,Alabama,3831738,2165650,2074781,90869
2017-05-01,Alaska,547568,361889,338905,22984
2017-05-01,Arizona,5475632,3310857,3152680,158177
2017-05-01,Arkansas,2322473,1356038,1307467,48571
2017-05-01,California,30768143,19114612,18264951,849661
2017-05-01,Colorado,4388075,2952332,2884030,68302
2017-05-01,Connecticut,2877571,1910957,1826753,84204
2017-05-01,Delaware,761229,472429,452768,19661
2017-05-01,Florida,16896488,10058066,9649748,408318
2017-05-01,Georgia,7982640,5096314,4856351,239963
2017-05-01,Hawaii,1094527,680560,665709,14851
2017-05-01,Idaho,1301254,829956,807001,22955
2017-05-01,Illinois,10041245,6455861,6166380,289481
2017-05-01,Indiana,5172316,3329906,3225595,104311
2017-05-01,Iowa,2451132,1681106,1631982,49124
2017-05-01,Kansas,2216547,1478877,1426950,51927
2017-05-01,Kentucky,3473934,2056129,1958073,98056
2017-05-01,Louisiana,3585080,2102917,1997616,105301
2017-05-01,Maine,1098886,695818,671829,23989
2017-05-01,Maryland,4733208,3189789,3067503,122286
2017-05-01,Massachusetts,5579253,3657015,3520777,136238
2017-05-01,Michigan,7948140,4868045,4681159,186886
2017-05-01,Minnesota,4351521,3043185,2949019,94166
2017-05-01,Mississippi,2290029,1282371,1212527,69844
2017-05-01,Missouri,4774274,3071518,2958421,113097
2017-05-01,Montana,833044,526450,507667,18783
2017-05-01,Nebraska,1460788,1020731,991755,28976
2017-05-01,Nevada,2319911,1446495,1376346,70149
2017-05-01,Ohio,9187468,5790141,5516809,273332
2017-05-01,Oklahoma,2998855,1827264,1752118,75146
2017-05-01,Oregon,3327202,2073197,2000251,72946
2017-05-01,Pennsylvania,10245398,6422178,6113221,308957
2017-05-01,Tennessee,5263952,3165812,3064904,100908
2017-05-01,Texas,21212877,13526955,12961869,565086
2017-05-01,Utah,2241236,1539169,1492791,46378
2017-05-01,Vermont,516395,345199,335169,10030
2017-05-01,Virginia,6592107,4341914,4181685,160229
2017-05-01,Washington,5831159,3703438,3543775,159663
2017-05-01,Wisconsin,4585572,3111341,3015884,95457
2017-05-01,Wyoming,448807,294539,282564,11975
2017-06-01,Alabama,3833212,2184734,2076127,108607
2017-06-01,Alaska,547498,368334,344303,24031
2017-06-01,Arizona,5484293,3330897,3158900,171997
2017-06-01,Arkansas,2323505,1368996,1315154,53842
2017-06-01,California,30785787,19147065,18200865,946200
2017-06-01,Colorado,4394135,2994172,2913174,80998
2017-06-01,Connecticut,2877943,1922887,1835258,87629
2017-06-01,Delaware,761894,478510,456079,22431
2017-06-01,Florida,16922604,10067599,9628575,439024
2017-06-01,Georgia,7991681,5112785,4854395,258390
2017-06-01,Hawaii,1094338,682816,663934,18882
2017-06-01,Idaho,1303917,840031,816678,23353
2017-06-01,Illinois,10040833,6553194,6215776,337418
2017-06-01,Indiana,5174848,3367993,3250605,117388
2017-06-01,Iowa,2452121,1702092,1648961,53131
2017-06-01,Kansas,2216714,1497360,1441625,55735
2017-06-01,Kentucky,3475403,2079448,1968266,111182
2017-06-01,Louisiana,3584978,2132771,2008776,123995
2017-06-01,Maine,1099367,710027,686624,23403
2017-06-01,Maryland,4735001,3232403,3092714,139689
2017-06-01,Massachusetts,5582922,3719772,3571370,148402
2017-06-01,Michigan,7951337,4919286,4704324,214962
2017-06-01,Minnesota,4354936,3078302,2970433,107869
2017-06-01,Mississippi,2290451,1289814,1209598,80216
2017-06-01,Missouri,4776343,3095293,2978717,116576
2017-06-01,Montana,833938,533168,511965,21203
2017-06-01,Nebraska,1461662,1026563,994602,31961
2017-06-01,Nevada,2323776,1451819,1376503,75316
2017-06-01,Ohio,9190673,5863758,5554972,308786
2017-06-01,Oklahoma,2999600,1846069,1766586,79483
2017-06-01,Oregon,3331658,2100907,2012811,88096
2017-06-01,Pennsylvania,10247076,6475187,6147574,327613
2017-06-01,Tennessee,5268917,3206963,3076169,130794
2017-06-01,Texas,21241618,13576606,12956787,619819
2017-06-01,Utah,2245932,1550656,1497340,53316
2017-06-01,Vermont,516530,350650,340167,10483
2017-06-01,Virginia,6596798,4376761,4211180,165581
2017-06-01,Washington,5840658,3737072,3572735,164337
2017-06-01,Wisconsin,4587663,3175416,3058197,117219
2017-06-01,Wyoming,448586,300142,287504,12638
2017-07-01,Alabama,3834828,2184043,2080543,103500
2017-07-01,Alaska,547459,370929,348549,22380
2017-07-01,Arizona,5493149,3334691,3158958,175733
2017-07-01,Arkansas,2324707,1368489,1311686,56803
2017-07-01,California,30803890,19274152,18278191,995961
2017-07-01,Colorado,4400398,3009753,2930263,79490
2017-07-01,Connecticut,2878402,1939417,1849492,89925
2017-07-01,Delaware,762579,480476,457500,22976
2017-07-01,Florida,16949383,10088593,9634224,454369
2017-07-01,Georgia,8000403,5130869,4871822,259047
2017-07-01,Hawaii,1094083,681918,667040,14878
2017-07-01,Idaho,1306643,844916,820189,24727
2017-07-01,Illinois,10040493,6556894,6225276,331618
2017-07-01,Indiana,5177619,3364535,3244011,120524
2017-07-01,Iowa,2453207,1703769,1651367,52402
2017-07-01,Kansas,2216971,1508791,1443676,65115
2017-07-01,Kentucky,3477035,2068280,1959242,109038
2017-07-01,Louisiana,3585050,2137823,2015777,122046
2017-07-01,Maine,1099895,718597,695173,23424
2017-07-01,Maryland,4737038,3257011,3116326,140685
2017-07-01,Massachusetts,5586853,3740176,3587278,152898
2017-07-01,Michigan,7954986,4953707,4686867,266840
2017-07-01,Minnesota,4358552,3084176,2982427,101749
2017-07-01,Mississippi,2291018,1291125,1212197,78928
2017-07-01,Missouri,4778332,3101697,2973715,127982
2017-07-01,Montana,834883,533570,513581,19989
2017-07-01,Nebraska,1462522,1030703,998059,32644
2017-07-01,Nevada,2327779,1460989,1385802,75187
2017-07-01,Ohio,9194409,5878260,5570986,307274
2017-07-01,Oklahoma,3000330,1842566,1767019,75547
2017-07-01,Oregon,3336293,2114862,2021844,93018
2017-07-01,Pennsylvania,10249321,6501868,6151081,350787
2017-07-01,Tennessee,5274154,3218648,3092218,126430
2017-07-01,Texas,21270568,13599091,12990326,608765
2017-07-01,Utah,2250729,1556021,1505989,50032
2017-07-01,Vermont,516703,351785,341620,10165
2017-07-01,Virginia,6601547,4392089,4225689,166400
2017-07-01,Washington,5850357,3753530,3586041,167489
2017-07-01,Wisconsin,4590052,3175750,3068100,107650
2017-07-01,Wyoming,448383,299800,287858,11942
2017-08-01,Alabama,3836284,2176978,2079575,97403
2017-08-01,Alaska,547544,366327,344693,21634
2017-08-01,Arizona,5503164,3331516,3154479,177037
2017-08-01,Arkansas,2325716,1354344,1301346,52998
2017-08-01,California,30819479,19195751,18229324,966427
2017-08-01,Colorado,4407473,3008570,2926723,81847
2017-08-01,Connecticut,2879206,1905259,1817125,88134
2017-08-01,Delaware,763394,479446,456353,23093
2017-08-01,Florida,16972737,10046698,9589994,456704
2017-08-01,Georgia,8008915,5099785,4848053,251732
2017-08-01,Hawaii,1094423,674786,660903,13883
2017-08-01,Idaho,1309260,838962,815201,23761
2017-08-01,Illinois,10039057,6494633,6158723,335910
2017-08-01,Indiana,5180760,3338104,3214586,123518
2017-08-01,Iowa,2453951,1686191,1634568,51623
2017-08-01,Kansas,2217666,1477820,1418408,59412
2017-08-01,Kentucky,3478094,2049012,1954408,94604
2017-08-01,Louisiana,3585268,2117117,1998688,118429
2017-08-01,Maine,1100450,715338,694058,21280
2017-08-01,Maryland,4738850,3219762,3082636,137126
2017-08-01,Massachusetts,5589635,3728740,3586740,142000
2017-08-01,Michigan,7957470,4933184,4690840,242344
2017-08-01,Minnesota,4361737,3060924,2960410,100514
2017-08-01,Mississippi,2290790,1270874,1203221,67653
2017-08-01,Missouri,4779763,3060290,2934755,125535
2017-08-01,Montana,835644,530538,510510,20028
2017-08-01,Nebraska,1463343,1017011,986756,30255
2017-08-01,Nevada,2332350,1457351,1383217,74134
2017-08-01,Ohio,9197134,5840223,5553535,286688
2017-08-01,Oklahoma,3001447,1833251,1757520,75731
2017-08-01,Oregon,3339709,2107840,2013152,94688
2017-08-01,Pennsylvania,10251862,6455288,6109860,345428
2017-08-01,Tennessee,5279315,3193130,3077808,115322
2017-08-01,Texas,21298416,13570151,12956403,613748
2017-08-01,Utah,2254998,1551852,1499626,52226
2017-08-01,Vermont,516820,349543,339431,10112
2017-08-01,Virginia,6605682,4343554,4176717,166837
2017-08-01,Washington,5858523,3739404,3564576,174828
2017-08-01,Wisconsin,4592196,3149253,3042914,106339
2017-08-01,Wyoming,448464,297696,286261,11435
2017-09-01,Alabama,3838035,2175857,2090440,85417
2017-09-01,Alaska,547502,361631,340391,21240
2017-09-01,Arizona,5513490,3359049,3195619,163430
2017-09-01,Arkansas,2326910,1359531,1311507,48024
2017-09-01,California,30836381,19330919,18471759,859160
2017-09-01,Colorado,4414637,3028283,2951237,77046
2017-09-01,Connecticut,2880192,1895247,1817366,77881
2017-09-01,Delaware,764246,476200,456256,19944
2017-09-01,Florida,16996993,10081018,9658163,422855
2017-09-01,Georgia,8017782,5143227,4915572,227655
2017-09-01,Hawaii,1094481,675618,661519,14099
2017-09-01,Idaho,1311939,841971,819584,22387
2017-09-01,Illinois,10038262,6481629,6183517,298112
2017-09-01,Indiana,5184267,3332257,3225106,107151
2017-09-01,Iowa,2454856,1690571,1645308,45263
2017-09-01,Kansas,2218423,1483258,1436041,47217
2017-09-01,Kentucky,3479282,2052088,1966402,85686
2017-09-01,Louisiana,3585673,2117924,2012205,105719
2017-09-01,Maine,1101052,700957,680447,20510
2017-09-01,Maryland,4740827,3218697,3096700,121997
2017-09-01,Massachusetts,5592879,3678194,3542704,135490
2017-09-01,Michigan,7960565,4920440,4695359,225081
2017-09-01,Minnesota,4365287,3062430,2976597,85833
2017-09-01,Mississippi,2290654,1275244,1213949,61295
2017-09-01,Missouri,4781508,3055353,2957641,97712
2017-09-01,Montana,836473,526646,508421,18225
2017-09-01,Nebraska,1464244,1014073,986930,27143
2017-09-01,Nevada,2337073,1469554,1398029,71525
2017-09-01,Ohio,9200536,5806524,5544977,261547
2017-09-01,Oklahoma,3002702,1847031,1777438,69593
2017-09-01,Oregon,3343356,2104590,2021632,82958
2017-09-01,Pennsylvania,10255068,6425629,6125306,300323
2017-09-01,Tennessee,5284708,3207759,3103919,103840
2017-09-01,Texas,21327298,13634311,13071825,562486
2017-09-01,Utah,2259385,1557781,1513184,44597
2017-09-01,Vermont,516929,345854,336111,9743
2017-09-01,Virginia,6609542,4349890,4199114,150776
2017-09-01,Washington,5866671,3757427,3592799,164628
2017-09-01,Wisconsin,4594649,3134791,3042617,92174
2017-09-01,Wyoming,448572,297572,286474,11098
2017-10-01,Alabama,3839599,2178077,2093500,84577
2017-10-01,Alaska,547573,357700,336605,21095
2017-10-01,Arizona,5523611,3340950,3185596,155354
2017-10-01,Arkansas,2327969,1349116,1305681,43435
2017-10-01,California,30852515,19179289,18355398,823891
2017-10-01,Colorado,4421760,3021038,2941198,79840
2017-10-01,Connecticut,2881056,1890662,1814931,75731
2017-10-01,Delaware,765073,474898,455746,19152
2017-10-01,Florida,17020550,10068664,9666558,402106
2017-10-01,Georgia,8026805,5118088,4892630,225458
2017-10-01,Hawaii,1094821,670489,658252,12237
2017-10-01,Idaho,1314549,841485,819332,22153
2017-10-01,Illinois,10037181,6482146,6187737,294409
2017-10-01,Indiana,5187398,3326371,3221110,105261
2017-10-01,Iowa,2455642,1684248,1645929,38319
2017-10-01,Kansas,2219134,1480392,1434664,45728
2017-10-01,Kentucky,3480379,2038261,1956256,82005
2017-10-01,Louisiana,3585905,2107824,2016437,91387
2017-10-01,Maine,1101594,699669,679402,20267
2017-10-01,Maryland,4742681,3210967,3084967,126000
2017-10-01,Massachusetts,5595748,3673054,3551934,121120
2017-10-01,Michigan,7963143,4891143,4691786,199357
2017-10-01,Minnesota,4368498,3046972,2970860,76112
2017-10-01,Mississippi,2290413,1262148,1206210,55938
2017-10-01,Missouri,4783136,3041940,2956676,85264
2017-10-01,Montana,837239,523608,504890,18718
2017-10-01,Nebraska,1465130,1016006,991138,24868
2017-10-01,Nevada,2341692,1466347,1398447,67900
2017-10-01,Ohio,9203275,5810448,5561945,248503
2017-10-01,Oklahoma,3003945,1838742,1770244,68498
2017-10-01,Oregon,3346759,2094396,2013215,81181
2017-10-01,Pennsylvania,10257611,6407062,6118535,288527
2017-10-01,Tennessee,5289889,3200628,3097721,102907
2017-10-01,Texas,21355857,13574440,13065652,508788
2017-10-01,Utah,2263655,1553233,1510351,42882
2017-10-01,Vermont,517040,345923,338435,7488
2017-10-01,Virginia,6613781,4332704,4191716,140988
2017-10-01,Washington,5874858,3744899,3587357,157542
2017-10-01,Wisconsin,4596797,3124778,3038633,86145
2017-10-01,Wyoming,448675,295031,283728,11303
2017-11-01,Alabama,3840846,2174598,2092926,81672
2017-11-01,Alaska,547493,356740,333926,22814
2017-11-01,Arizona,5533249,3362836,3208569,154267
2017-11-01,Arkansas,2328862,1344578,1300110,44468
2017-11-01,California,30866794,19213633,18384585,829048
2017-11-01,Colorado,4428527,3021333,2940051,81282
2017-11-01,Connecticut,2881667,1892189,1822058,70131
2017-11-01,Delaware,765819,476346,458296,18050
2017-11-01,Florida,17042366,10038847,9639862,398985
2017-11-01,Georgia,8035420,5115116,4900357,214759
2017-11-01,Hawaii,1094907,674638,661502,13136
2017-11-01,Idaho,1317091,842549,817499,25050
2017-11-01,Illinois,10035540,6493498,6204080,289418
2017-11-01,Indiana,5190316,3331053,3222567,108486
2017-11-01,Iowa,2456255,1677668,1636718,40950
2017-11-01,Kansas,2219649,1482080,1435272,46808
2017-11-01,Kentucky,3481197,2043434,1966304,77130
2017-11-01,Louisiana,3585883,2107824,2017009,90815
2017-11-01,Maine,1102055,694851,672723,22128
2017-11-01,Maryland,4744069,3201233,3075029,126204
2017-11-01,Massachusetts,5598288,3686812,3564855,121957
2017-11-01,Michigan,7965234,4890614,4695796,194818
2017-11-01,Minnesota,4371458,3047830,2963325,84505
2017-11-01,Mississippi,2289988,1267449,1209241,58208
2017-11-01,Missouri,4784494,3035955,2940815,95140
2017-11-01,Montana,837939,523877,502910,20967
2017-11-01,Nebraska,1465866,1016892,991036,25856
2017-11-01,Nevada,2346147,1471662,1403211,68451
2017-11-01,Ohio,9205445,5794431,5549760,244671
2017-11-01,Oklahoma,3005018,1840519,1773400,67119
2017-11-01,Oregon,3349993,2088320,2009851,78469
2017-11-01,Pennsylvania,10259423,6393999,6102457,291542
2017-11-01,Tennessee,5294714,3205535,3101798,103737
2017-11-01,Texas,21383059,13662458,13126947,535511
2017-11-01,Utah,2267884,1561005,1517356,43649
2017-11-01,Vermont,517098,347062,337411,9651
2017-11-01,Virginia,6617090,4315777,4176946,138831
2017-11-01,Washington,5882465,3747163,3580086,167077
2017-11-01,Wisconsin,4598712,3119966,3033997,85969
2017-11-01,Wyoming,448765,294888,282402,12486
2017-12-01,Alabama,3842023,2171738,2090721,81017
2017-12-01,Alaska,547432,354091,330584,23507
2017-12-01,Arizona,5542691,3354535,3197927,156608
2017-12-01,Arkansas,2329671,1335800,1287567,48233
2017-12-01,California,30879995,19101100,18279401,821699
2017-12-01,Colorado,4435085,3015930,2933921,82009
2017-12-01,Connecticut,2882187,1877797,1808804,68993
2017-12-01,Delaware,766575,476627,458621,18006
2017-12-01,Florida,17063554,10047107,9668512,378595
2017-12-01,Georgia,8043726,5111504,4894793,216711
2017-12-01,Hawaii,1094964,673923,661848,12075
2017-12-01,Idaho,1319571,840587,815344,25243
2017-12-01,Illinois,10033620,6453698,6160438,293260
2017-12-01,Indiana,5193094,3315794,3215624,100170
2017-12-01,Iowa,2456773,1676048,1627439,48609
2017-12-01,Kansas,2220045,1472303,1426682,45621
2017-12-01,Kentucky,3481919,2041303,1962824,78479
2017-12-01,Louisiana,3585740,2094096,2008856,85240
2017-12-01,Maine,1102473,690483,670877,19606
2017-12-01,Maryland,4745331,3185342,3063728,121614
2017-12-01,Massachusetts,5600704,3690502,3565126,125376
2017-12-01,Michigan,7967152,4870934,4658838,212096
2017-12-01,Minnesota,4374313,3041076,2939591,101485
2017-12-01,Mississippi,2289575,1264292,1207507,56785
2017-12-01,Missouri,4785721,3027151,2928410,98741
2017-12-01,Montana,838625,520342,498643,21699
2017-12-01,Nebraska,1466539,1011955,983725,28230
2017-12-01,Nevada,2350496,1467493,1398779,68714
2017-12-01,Ohio,9207338,5742607,5487383,255224
2017-12-01,Oklahoma,3005976,1829330,1762783,66547
2017-12-01,Oregon,3353105,2069939,1991629,78310
2017-12-01,Pennsylvania,10260876,6355898,6070017,285881
2017-12-01,Tennessee,5299362,3205676,3103754,101922
2017-12-01,Texas,21409531,13640393,13115554,524839
2017-12-01,Utah,2272008,1552315,1509075,43240
2017-12-01,Vermont,517141,344934,335536,9398
2017-12-01,Virginia,6620166,4310219,4178629,131590
2017-12-01,Washington,5889827,3742374,3564923,177451
2017-12-01,Wisconsin,4600474,3093762,3011150,82612
2017-12-01,Wyoming,448829,291833,279692,12141
2018-01-01,Alabama,3842844,2167556,2070611,96945
2018-01-01,Alaska,547313,352970,328067,24903
2018-01-01,Arizona,5551621,3365615,3197038,168577
2018-01-01,Arkansas,2330250,1325754,1267366,58388
2018-01-01,California,30890810,19118215,18204924,913291
2018-01-01,Colorado,4441224,3004427,2911112,93315
2018-01-01,Connecticut,2882546,1878611,1787597,91014
2018-01-01,Delaware,767213,477728,455850,21878
2018-01-01,Florida,17083177,10061235,9647727,413508
2018-01-01,Georgia,8051351,5113554,4880112,233442
2018-01-01,Hawaii,1094930,677057,662584,14473
2018-01-01,Idaho,1321923,839341,806568,32773
2018-01-01,Illinois,10030718,6412190,6076964,335226
2018-01-01,Indiana,5195245,3307782,3184196,123586
2018-01-01,Iowa,2457002,1673860,1612661,61199
2018-01-01,Kansas,2220190,1468372,1414783,53589
2018-01-01,Kentucky,3482222,2028062,1932929,95133
2018-01-01,Louisiana,3585241,2083498,1983550,99948
2018-01-01,Maine,1102745,685552,660622,24930
2018-01-01,Maryland,4746158,3182474,3040043,142431
2018-01-01,Massachusetts,5602485,3697060,3539167,157893
2018-01-01,Michigan,7968173,4852411,4605089,247322
2018-01-01,Minnesota,4376667,3031657,2914077,117580
2018-01-01,Mississippi,2288841,1253469,1192661,60808
2018-01-01,Missouri,4786436,3016999,2898965,118034
2018-01-01,Montana,839190,520785,494628,26157
2018-01-01,Nebraska,1467060,1009618,976869,32749
2018-01-01,Nevada,2354665,1471043,1396868,74175
2018-01-01,Ohio,9208200,5688368,5387677,300691
2018-01-01,Oklahoma,3006598,1828788,1756624,72164
2018-01-01,Oregon,3355813,2063616,1973545,90071
2018-01-01,Pennsylvania,10261172,6360317,6032294,328023
2018-01-01,Tennessee,5303405,3186741,3063758,122983
2018-01-01,Texas,21434170,13638230,13054267,583963
2018-01-01,Utah,2275847,1551958,1501353,50605
2018-01-01,Vermont,517147,345345,333226,12119
2018-01-01,Virginia,6622634,4307044,4153920,153124
2018-01-01,Washington,5896573,3751779,3558822,192957
2018-01-01,Wisconsin,4601689,3075634,2979765,95869
2018-01-01,Wyoming,448752,291392,276990,14402
2018-02-01,Alabama,3843324,2187128,2092162,94966
2018-02-01,Alaska,547162,355624,330584,25040
2018-02-01,Arizona,5560108,3391983,3230346,161637
2018-02-01,Arkansas,2330637,1348248,1290095,58153
2018-02-01,California,30899826,19274769,18374136,900633
2018-02-01,Colorado,4447177,3047819,2948734,99085
2018-02-01,Connecticut,2882640,1888166,1799553,88613
2018-02-01,Delaware,767793,479857,458904,20953
2018-02-01,Florida,17100836,10124717,9741447,383270
2018-02-01,Georgia,8058536,5144301,4916807,227494
2018-02-01,Hawaii,1094855,678630,664528,14102
2018-02-01,Idaho,1324143,845625,816395,29230
2018-02-01,Illinois,10027117,6472473,6148088,324385
2018-02-01,Indiana,5197039,3343616,3217920,125696
2018-02-01,Iowa,2457017,1695580,1639650,55930
2018-02-01,Kansas,2220217,1484150,1428817,55333
2018-02-01,Kentucky,3482315,2042244,1944110,98134
2018-02-01,Louisiana,3584500,2096975,2004625,92350
2018-02-01,Maine,1102935,689663,664624,25039
2018-02-01,Maryland,4746675,3200581,3062344,138237
2018-02-01,Massachusetts,5604017,3729703,3574466,155237
2018-02-01,Michigan,7968592,4899525,4655705,243820
2018-02-01,Minnesota,4378743,3057751,2941240,116511
2018-02-01,Mississippi,2287915,1269483,1203649,65834
2018-02-01,Missouri,4786746,3040498,2922301,118197
2018-02-01,Montana,839690,526608,501804,24804
2018-02-01,Nebraska,1467492,1022307,988938,33369
2018-02-01,Nevada,2358680,1492617,1421848,70769
2018-02-01,Ohio,9208371,5755287,5459051,296236
2018-02-01,Oklahoma,3007027,1843375,1773413,69962
2018-02-01,Oregon,3358353,2085283,1994610,90673
2018-02-01,Pennsylvania,10260662,6398864,6069561,329303
2018-02-01,Tennessee,5307103,3220236,3101965,118271
2018-02-01,Texas,21457851,13796142,13218730,577412
2018-02-01,Utah,2279686,1568208,1514986,53222
2018-02-01,Vermont,517110,347203,335801,11402
2018-02-01,Virginia,6624733,4355977,4210354,145623
2018-02-01,Washington,5903000,3794473,3604506,189967
2018-02-01,Wisconsin,4602577,3107951,3001257,106694
2018-02-01,Wyoming,448751,292988,279397,13591
2018-03-01,Alabama,3844151,2192152,2102772,89380
2018-03-01,Alaska,547013,354863,331329,23534
2018-03-01,Arizona,5568852,3406775,3249277,157498
2018-03-01,Arkansas,2331244,1351674,1300534,51140
2018-03-01,California,30909161,19274291,18398451,875840
2018-03-01,Colorado,4453360,3043776,2952546,91230
2018-03-01,Connecticut,2882894,1893008,1810978,82030
2018-03-01,Delaware,768427,482098,462568,19530
2018-03-01,Florida,17119346,10102584,9734325,368259
2018-03-01,Georgia,8066189,5142002,4928708,213294
2018-03-01,Hawaii,1094601,681042,667473,13569
2018-03-01,Idaho,1326556,847741,819777,27964
2018-03-01,Illinois,10024274,6473460,6181597,291863
2018-03-01,Indiana,5199477,3363964,3246862,117102
2018-03-01,Iowa,2457371,1692522,1640278,52244
2018-03-01,Kansas,2220385,1478321,1427229,51092
2018-03-01,Kentucky,3482775,2055193,1960213,94980
2018-03-01,Louisiana,3584009,2111753,2015848,95905
2018-03-01,Maine,1103257,690650,667700,22950
2018-03-01,Maryland,4747351,3205566,3077802,127764
2018-03-01,Massachusetts,5605957,3743661,3599302,144359
2018-03-01,Michigan,7969842,4903076,4674377,228699
2018-03-01,Minnesota,4381261,3050867,2936937,113930
2018-03-01,Mississippi,2287263,1267069,1208837,58232
2018-03-01,Missouri,4787572,3047072,2932595,114477
2018-03-01,Montana,840283,527987,504025,23962
2018-03-01,Nebraska,1468056,1022710,991005,31705
2018-03-01,Nevada,2362787,1492169,1423991,68178
2018-03-01,Ohio,9209589,5770210,5495843,274367
2018-03-01,Oklahoma,3007661,1844802,1780458,64344
2018-03-01,Oregon,3361174,2080470,1991151,89319
2018-03-01,Pennsylvania,10261195,6366426,6068515,297911
2018-03-01,Tennessee,5311385,3228182,3116218,111964
2018-03-01,Texas,21481979,13777441,13223076,554365
2018-03-01,Utah,2283762,1567333,1516862,50471
2018-03-01,Vermont,517126,347887,336481,11406
2018-03-01,Virginia,6627094,4368757,4228908,139849
2018-03-01,Washington,5909842,3794738,3616943,177795
2018-03-01,Wisconsin,4603990,3102092,3000099,101993
2018-03-01,Wyoming,448769,293912,280743,13169
2018-04-01,Alabama,3845163,2197543,2121190,76353
2018-04-01,Alaska,546953,351943,329972,21971
2018-04-01,Arizona,5577991,3393620,3240627,152993
2018-04-01,Arkansas,2331994,1351686,1307022,44664
2018-04-01,California,30920923,19176508,18397778,778730
2018-04-01,Colorado,4459903,3043880,2956663,87217
2018-04-01,Connecticut,2883318,1884119,1813436,70683
2018-04-01,Delaware,769129,481621,464186,17435
2018-04-01,Florida,17138968,10114670,9769147,345523
2018-04-01,Georgia,8074439,5110892,4916076,194816
2018-04-01,Hawaii,1094559,679483,665867,13616
2018-04-01,Idaho,1329009,846615,822309,24306
2018-04-01,Illinois,10022064,6432827,6181578,251249
2018-04-01,Indiana,5202122,3372807,3271086,101721
2018-04-01,Iowa,2457850,1693122,1650692,42430
2018-04-01,Kansas,2220716,1479467,1434798,44669
2018-04-01,Kentucky,3483458,2054457,1974386,80071
2018-04-01,Louisiana,3583789,2118207,2024423,93784
2018-04-01,Maine,1103646,693288,671281,22007
2018-04-01,Maryland,4748453,3192883,3080765,112118
2018-04-01,Massachusetts,5608217,3740965,3617071,123894
2018-04-01,Michigan,7971408,4876568,4687150,189418
2018-04-01,Minnesota,4384009,3047825,2953590,94235
2018-04-01,Mississippi,2286692,1270941,1213535,57406
2018-04-01,Missouri,4788659,3059223,2967525,91698
2018-04-01,Montana,840926,525285,505682,19603
2018-04-01,Nebraska,1468702,1026624,998387,28237
2018-04-01,Nevada,2367014,1490479,1424921,65558
2018-04-01,Ohio,9211216,5764668,5512541,252127
2018-04-01,Oklahoma,3008550,1833695,1776210,57485
2018-04-01,Oregon,3364161,2073305,1994207,79098
2018-04-01,Pennsylvania,10262265,6374753,6114055,260698
2018-04-01,Tennessee,5315866,3230070,3133265,96805
2018-04-01,Texas,21507743,13792904,13281294,511610
2018-04-01,Utah,2287936,1560265,1515066,45199
2018-04-01,Vermont,517166,344733,333929,10804
2018-04-01,Virginia,6630075,4361544,4243233,118311
2018-04-01,Washington,5917125,3775798,3619767,156031
2018-04-01,Wisconsin,4605623,3097731,3005398,92333
2018-04-01,Wyoming,448778,292188,280192,11996
2018-05-01,Alabama,3846214,2197805,2120559,77246
2018-05-01,Alaska,546849,357747,337393,20354
2018-05-01,Arizona,5587102,3398448,3250939,147509
2018-05-01,Arkansas,2332706,1355627,1308978,46649
2018-05-01,California,30932127,19216128,18500304,715824
2018-05-01,Colorado,4466430,3055496,2971817,83679
2018-05-01,Connecticut,2883769,1902889,1829829,73060
2018-05-01,Delaware,769793,480658,464810,15848
2018-05-01,Florida,17159029,10168918,9826134,342784
2018-05-01,Georgia,8082472,5118011,4924994,193017
2018-05-01,Hawaii,1094494,676951,663361,13590
2018-05-01,Idaho,1331478,853594,833463,20131
2018-05-01,Illinois,10019843,6443611,6200989,242622
2018-05-01,Indiana,5204828,3397130,3290714,106416
2018-05-01,Iowa,2458351,1697468,1659870,37598
2018-05-01,Kansas,2221142,1479524,1434523,45001
2018-05-01,Kentucky,3484178,2059022,1974739,84283
2018-05-01,Louisiana,3583521,2117087,2018904,98183
2018-05-01,Maine,1104078,695583,674810,20773
2018-05-01,Maryland,4749436,3202648,3087338,115310
2018-05-01,Massachusetts,5610576,3751788,3628183,123605
2018-05-01,Michigan,7973138,4915261,4737236,178025
2018-05-01,Minnesota,4386886,3055702,2979144,76558
2018-05-01,Mississippi,2286106,1276749,1215178,61571
2018-05-01,Missouri,4789836,3063680,2970542,93138
2018-05-01,Montana,841612,530197,513595,16602
2018-05-01,Nebraska,1469394,1029942,1003106,26836
2018-05-01,Nevada,2371246,1499704,1437886,61818
2018-05-01,Ohio,9212935,5785829,5540145,245684
2018-05-01,Oklahoma,3009443,1843665,1783848,59817
2018-05-01,Oregon,3367204,2076236,2005871,70365
2018-05-01,Pennsylvania,10263521,6417129,6152458,264671
2018-05-01,Tennessee,5320415,3232194,3133436,98758
2018-05-01,Texas,21533031,13773123,13272126,500997
2018-05-01,Utah,2292135,1568498,1526172,42326
2018-05-01,Vermont,517233,345808,336837,8971
2018-05-01,Virginia,6632998,4372596,4249550,123046
2018-05-01,Washington,5924416,3788194,3636914,151280
2018-05-01,Wisconsin,4607399,3103694,3015888,87806
2018-05-01,Wyoming,448836,293605,282333,11272
2018-06-01,Alabama,3847544,2226762,2124673,102089
2018-06-01,Alaska,546842,362888,340704,22184
2018-06-01,Arizona,5596687,3421083,3245066,176017
2018-06-01,Arkansas,2333693,1366258,1312343,53915
2018-06-01,California,30945958,19260860,18404660,856200
2018-06-01,Colorado,4473320,3092581,2989610,102971
2018-06-01,Connecticut,2884412,1921697,1841358,80339
2018-06-01,Delaware,770534,486040,466451,19589
2018-06-01,Florida,17180446,10193014,9797339,395675
2018-06-01,Georgia,8091122,5139216,4913258,225958
2018-06-01,Hawaii,1094527,679446,659001,20445
2018-06-01,Idaho,1334068,862759,840659,22100
2018-06-01,Illinois,10018412,6545425,6236983,308442
2018-06-01,Indiana,5207986,3433153,3308631,124522
2018-06-01,Iowa,2459105,1719423,1674873,44550
2018-06-01,Kansas,2221740,1497352,1445547,51805
2018-06-01,Kentucky,3485194,2088131,1988663,99468
2018-06-01,Louisiana,3583497,2154000,2022386,131614
2018-06-01,Maine,1104553,710768,688262,22506
2018-06-01,Maryland,4750835,3244404,3108061,136343
2018-06-01,Massachusetts,5613358,3812213,3670330,141883
2018-06-01,Michigan,7975494,4963829,4752853,210976
2018-06-01,Minnesota,4390089,3082378,2988010,94368
2018-06-01,Mississippi,2285729,1287942,1210700,77242
2018-06-01,Missouri,4791444,3093206,2987360,105846
2018-06-01,Montana,842349,537904,517512,20392
2018-06-01,Nebraska,1470220,1036687,1004668,32019
2018-06-01,Nevada,2375683,1505223,1435635,69588
2018-06-01,Ohio,9215446,5864116,5569692,294424
2018-06-01,Oklahoma,3010581,1858686,1792776,65910
2018-06-01,Oregon,3370550,2099786,2012842,86944
2018-06-01,Pennsylvania,10265616,6492600,6188398,304202
2018-06-01,Tennessee,5325367,3284299,3149366,134933
2018-06-01,Texas,21560149,13844380,13254146,590234
2018-06-01,Utah,2296468,1578588,1526794,51794
2018-06-01,Vermont,517318,351168,341144,10024
2018-06-01,Virginia,6636443,4406487,4267969,138518
2018-06-01,Washington,5932181,3818483,3655664,162819
2018-06-01,Wisconsin,4609561,3162769,3048515,114254
2018-06-01,Wyoming,448910,299543,286864,12679
2018-07-01,Alabama,3848927,2226232,2131926,94306
2018-07-01,Alaska,546800,366180,346662,19518
2018-07-01,Arizona,5606364,3439312,3263681,175631
2018-07-01,Arkansas,2334646,1369392,1315439,53953
2018-07-01,California,30959830,19369661,18497771,871890
2018-07-01,Colorado,4480233,3102073,3002125,99948
2018-07-01,Connecticut,2885151,1946750,1867402,79348
2018-07-01,Delaware,771294,486034,466777,19257
2018-07-01,Florida,17202053,10209883,9814735,395148
2018-07-01,Georgia,8099961,5142882,4924196,218686
2018-07-01,Hawaii,1094542,678615,662100,16515
2018-07-01,Idaho,1336679,867623,845073,22550
2018-07-01,Illinois,10017132,6559671,6264894,294777
2018-07-01,Indiana,5211178,3433186,3313571,119615
2018-07-01,Iowa,2459864,1721727,1678625,43102
2018-07-01,Kansas,2222318,1505729,1446703,59026
2018-07-01,Kentucky,3486211,2074630,1979012,95618
2018-07-01,Louisiana,3583576,2151125,2028821,122304
2018-07-01,Maine,1105094,718294,695723,22571
2018-07-01,Maryland,4752274,3267420,3133675,133745
2018-07-01,Massachusetts,5616196,3828142,3687949,140193
2018-07-01,Michigan,7977918,4983123,4742003,241120
2018-07-01,Minnesota,4393361,3088737,3002259,86478
2018-07-01,Mississippi,2285366,1287753,1215907,71846
2018-07-01,Missouri,4793072,3094967,2982475,112492
2018-07-01,Montana,843114,538294,520145,18149
2018-07-01,Nebraska,1471009,1041503,1009149,32354
2018-07-01,Nevada,2380077,1515127,1447810,67317
2018-07-01,Ohio,9218047,5862165,5591421,270744
2018-07-01,Oklahoma,3011765,1845502,1786186,59316
2018-07-01,Oregon,3373930,2107575,2019644,87931
2018-07-01,Pennsylvania,10267863,6533798,6215829,317969
2018-07-01,Tennessee,5330423,3288228,3158297,129931
2018-07-01,Texas,21587399,13867247,13295993,571254
2018-07-01,Utah,2300883,1583902,1537267,46635
2018-07-01,Vermont,517426,352347,343372,8975
2018-07-01,Virginia,6639962,4416704,4285019,131685
2018-07-01,Washington,5940044,3835505,3674861,160644
2018-07-01,Wisconsin,4611747,3153260,3053438,99822
2018-07-01,Wyoming,448998,299736,288207,11529
2018-08-01,Alabama,3850814,2207001,2117179,89822
2018-08-01,Alaska,546781,359678,341279,18399
2018-08-01,Arizona,5617446,3422856,3246159,176697
2018-08-01,Arkansas,2335827,1349604,1301143,48461
2018-08-01,California,30970329,19198154,18360971,837183
2018-08-01,Colorado,4486530,3077822,2980261,97561
2018-08-01,Connecticut,2885383,1911659,1835956,75703
2018-08-01,Delaware,772185,480093,461392,18701
2018-08-01,Florida,17223189,10149878,9764497,385381
2018-08-01,Georgia,8109883,5069806,4863601,206205
2018-08-01,Hawaii,1094296,670204,654110,16094
2018-08-01,Idaho,1339682,855214,834139,21075
2018-08-01,Illinois,10016480,6456103,6174416,281687
2018-08-01,Indiana,5214498,3382910,3266356,116554
2018-08-01,Iowa,2461141,1693171,1651820,41351
2018-08-01,Kansas,2223002,1472310,1421250,51060
2018-08-01,Kentucky,3487490,2041113,1961456,79657
2018-08-01,Louisiana,3584025,2110954,1999004,111950
2018-08-01,Maine,1105765,710701,690904,19797
2018-08-01,Maryland,4753977,3213899,3088876,125023
2018-08-01,Massachusetts,5618480,3798142,3672506,125636
2018-08-01,Michigan,7979891,4923404,4727171,196233
2018-08-01,Minnesota,4396490,3052379,2969026,83353
2018-08-01,Mississippi,2285791,1262011,1197686,64325
2018-08-01,Missouri,4795418,3037113,2935133,101980
2018-08-01,Montana,843928,533007,515104,17903
2018-08-01,Nebraska,1471841,1023919,995489,28430
2018-08-01,Nevada,2384929,1504181,1438705,65476
2018-08-01,Ohio,9221239,5800217,5553890,246327
2018-08-01,Oklahoma,3013749,1823079,1767437,55642
2018-08-01,Oregon,3377359,2093005,2006071,86934
2018-08-01,Pennsylvania,10269662,6457305,6156139,301166
2018-08-01,Tennessee,5335262,3245029,3126455,118574
2018-08-01,Texas,21619194,13763442,13211506,551936
2018-08-01,Utah,2305312,1571721,1523035,48686
2018-08-01,Vermont,517535,348013,339880,8133
2018-08-01,Virginia,6644538,4343872,4211836,132036
2018-08-01,Washington,5947638,3810466,3651179,159287
2018-08-01,Wisconsin,4614177,3110386,3016551,93835
2018-08-01,Wyoming,449256,295483,284670,10813
2018-09-01,Alabama,3852862,2205721,2125119,80602
2018-09-01,Alaska,546810,355653,337515,18138
2018-09-01,Arizona,5628819,3458060,3292754,165306
2018-09-01,Arkansas,2337119,1352838,1307566,45272
2018-09-01,California,30982488,19320842,18562065,758777
2018-09-01,Colorado,4493046,3093617,3004709,88908
2018-09-01,Connecticut,2885801,1902290,1835908,66382
2018-09-01,Delaware,773154,474966,459190,15776
2018-09-01,Florida,17245228,10218872,9867966,350906
2018-09-01,Georgia,8120220,5089130,4904983,184147
2018-09-01,Hawaii,1094105,669204,651591,17613
2018-09-01,Idaho,1342766,857201,837589,19612
2018-09-01,Illinois,10016318,6447218,6192821,254397
2018-09-01,Indiana,5218075,3366152,3265544,100608
2018-09-01,Iowa,2462548,1700800,1664619,36181
2018-09-01,Kansas,2223814,1478945,1436856,42089
2018-09-01,Kentucky,3488910,2045059,1963996,81063
2018-09-01,Louisiana,3584643,2104403,2003755,100648
2018-09-01,Maine,1106507,696116,676593,19523
2018-09-01,Maryland,4755987,3201312,3092413,108899
2018-09-01,Massachusetts,5621085,3750585,3631586,118999
2018-09-01,Michigan,7982196,4909025,4729237,179788
2018-09-01,Minnesota,4399843,3050598,2976555,74043
2018-09-01,Mississippi,2286353,1262733,1204603,58130
2018-09-01,Missouri,4797969,3034782,2955068,79714
2018-09-01,Montana,844790,528442,512503,15939
2018-09-01,Nebraska,1472783,1020785,995008,25777
2018-09-01,Nevada,2389933,1516677,1453597,63080
2018-09-01,Ohio,9224861,5768585,5539874,228711
2018-09-01,Oklahoma,3015886,1831516,1780367,51149
2018-09-01,Oregon,3380908,2090911,2012083,78828
2018-09-01,Pennsylvania,10271919,6439900,6175880,264020
2018-09-01,Tennessee,5340338,3247107,3137170,109937
2018-09-01,Texas,21652158,13809959,13287913,522046
2018-09-01,Utah,2309837,1576531,1536100,40431
2018-09-01,Vermont,517681,344207,336123,8084
2018-09-01,Virginia,6649427,4328456,4211625,116831
2018-09-01,Washington,5955494,3823785,3671631,152154
2018-09-01,Wisconsin,4616745,3092737,3010620,82117
2018-09-01,Wyoming,449533,295744,285367,10377
2018-10-01,Alabama,3854756,2228907,2146859,82048
2018-10-01,Alaska,546788,354516,335632,18884
2018-10-01,Arizona,5639899,3466070,3301342,164728
2018-10-01,Arkansas,2338313,1355928,1313511,42417
2018-10-01,California,30992869,19318686,18548434,770252
2018-10-01,Colorado,4499357,3103274,3012587,90687
2018-10-01,Connecticut,2886031,1910630,1844256,66374
2018-10-01,Delaware,774073,480234,464899,15335
2018-10-01,Florida,17266363,10247159,9897121,350038
2018-10-01,Georgia,8130168,5113145,4918307,194838
2018-10-01,Hawaii,1093829,668037,650847,17190
2018-10-01,Idaho,1345769,862636,841868,20768
2018-10-01,Illinois,10015684,6489400,6221990,267410
2018-10-01,Indiana,5221428,3388372,3276793,111579
2018-10-01,Iowa,2463857,1712601,1679070,33531
2018-10-01,Kansas,2224508,1486713,1443251,43462
2018-10-01,Kentucky,3490193,2045970,1967905,78065
2018-10-01,Louisiana,3585062,2118790,2021302,97488
2018-10-01,Maine,1107211,701985,682120,19865
2018-10-01,Maryland,4757696,3225656,3113162,112494
2018-10-01,Massachusetts,5623415,3766748,3658634,108114
2018-10-01,Michigan,7984164,4935211,4756279,178932
2018-10-01,Minnesota,4402999,3065389,2991676,73713
2018-10-01,Mississippi,2286775,1262742,1206199,56543
2018-10-01,Missouri,4800342,3046719,2974562,72157
2018-10-01,Montana,845583,529757,512662,17095
2018-10-01,Nebraska,1473613,1030510,1003964,26546
2018-10-01,Nevada,2394798,1524068,1462536,61532
2018-10-01,Ohio,9228042,5821252,5586286,234966
2018-10-01,Oklahoma,3017853,1840535,1785493,55042
2018-10-01,Oregon,3384353,2098993,2015659,83334
2018-10-01,Pennsylvania,10273714,6465663,6206363,259300
2018-10-01,Tennessee,5345197,3277351,3168226,109125
2018-10-01,Texas,21683967,13857939,13367242,490697
2018-10-01,Utah,2314283,1582405,1542170,40235
2018-10-01,Vermont,517774,345132,339951,5181
2018-10-01,Virginia,6654002,4360979,4245017,115962
2018-10-01,Washington,5963059,3848841,3694363,154478
2018-10-01,Wisconsin,4619204,3100253,3016907,83346
2018-10-01,Wyoming,449778,295776,285036,10740
2018-11-01,Alabama,3856154,2225029,2150676,74353
2018-11-01,Alaska,546733,352282,332406,19876
2018-11-01,Arizona,5650376,3487856,3327567,160289
2018-11-01,Arkansas,2339226,1354722,1312775,41947
2018-11-01,California,31000966,19351926,18583173,768753
2018-11-01,Colorado,4505271,3098770,3008655,90115
2018-11-01,Connecticut,2885954,1918999,1860721,58278
2018-11-01,Delaware,774895,480970,467259,13711
2018-11-01,Florida,17285441,10189275,9850446,338829
2018-11-01,Georgia,8139345,5111971,4931367,180604
2018-11-01,Hawaii,1093583,672852,655513,17339
2018-11-01,Idaho,1348642,861971,839159,22812
2018-11-01,Illinois,10013950,6484079,6224779,259300
2018-11-01,Indiana,5224176,3384105,3271204,112901
2018-11-01,Iowa,2464858,1709117,1674288,34829
2018-11-01,Kansas,2224934,1487332,1444379,42953
2018-11-01,Kentucky,3491101,2050632,1980695,69937
2018-11-01,Louisiana,3585137,2112931,2022854,90077
2018-11-01,Maine,1107768,694743,674545,20198
2018-11-01,Maryland,4758978,3221453,3114072,107381
2018-11-01,Massachusetts,5625242,3767015,3662895,104120
2018-11-01,Michigan,7985290,4928807,4757672,171135
2018-11-01,Minnesota,4405705,3061960,2986637,75323
2018-11-01,Mississippi,2286954,1268474,1211014,57460
2018-11-01,Missouri,4802145,3038016,2958918,79098
2018-11-01,Montana,846300,530321,512105,18216
2018-11-01,Nebraska,1474305,1030132,1005458,24674
2018-11-01,Nevada,2399462,1528239,1467838,60401
2018-11-01,Ohio,9230154,5806572,5577159,229413
2018-11-01,Oklahoma,3019516,1838494,1785400,53094
2018-11-01,Oregon,3387402,2094875,2016688,78187
2018-11-01,Pennsylvania,10274249,6449346,6200935,248411
2018-11-01,Tennessee,5349521,3288408,3185847,102561
2018-11-01,Texas,21713757,13917238,13423914,493324
2018-11-01,Utah,2318480,1590134,1549937,40197
2018-11-01,Vermont,517846,345281,338310,6971
2018-11-01,Virginia,6657983,4356018,4244244,111774
2018-11-01,Washington,5970124,3849796,3687340,162456
2018-11-01,Wisconsin,4621113,3093202,3011445,81757
2018-11-01,Wyoming,449941,295406,284264,11142
2018-12-01,Alabama,3857442,2222383,2144717,77666
2018-12-01,Alaska,546663,350042,328847,21195
2018-12-01,Arizona,5660505,3485093,3312834,172259
2018-12-01,Arkansas,2340021,1350310,1302662,47648
2018-12-01,California,31007415,19286704,18476193,810511
2018-12-01,Colorado,4510886,3093214,2999503,93711
2018-12-01,Connecticut,2885775,1905765,1844941,60824
2018-12-01,Delaware,775662,483845,468708,15137
2018-12-01,Florida,17303538,10214560,9870741,343819
2018-12-01,Georgia,8148150,5124163,4927437,196726
2018-12-01,Hawaii,1093269,670720,654020,16700
2018-12-01,Idaho,1351412,862834,837613,25221
2018-12-01,Illinois,10011743,6449863,6165642,284221
2018-12-01,Indiana,5226671,3364805,3256860,107945
2018-12-01,Iowa,2465707,1710558,1663081,47477
2018-12-01,Kansas,2225238,1485380,1440090,45290
2018-12-01,Kentucky,3491863,2050001,1971173,78828
2018-12-01,Louisiana,3585010,2096375,2007486,88889
2018-12-01,Maine,1108245,691852,671600,20252
2018-12-01,Maryland,4760033,3222979,3112404,110575
2018-12-01,Massachusetts,5626729,3771932,3659167,112765
2018-12-01,Michigan,7986018,4922247,4729653,192594
2018-12-01,Minnesota,4408141,3067584,2964555,103029
2018-12-01,Mississippi,2287035,1272318,1206858,65460
2018-12-01,Missouri,4803671,3042049,2950732,91317
2018-12-01,Montana,846955,529151,508516,20635
2018-12-01,Nebraska,1474901,1029403,1000804,28599
2018-12-01,Nevada,2403986,1527714,1463552,64162
2018-12-01,Ohio,9231796,5799948,5542903,257045
2018-12-01,Oklahoma,3020959,1828805,1773123,55682
2018-12-01,Oregon,3390287,2083094,2000507,82587
2018-12-01,Pennsylvania,10274249,6429756,6171073,258683
2018-12-01,Tennessee,5353537,3280284,3177927,102357
2018-12-01,Texas,21742357,13915434,13407635,507799
2018-12-01,Utah,2322551,1583870,1542625,41245
2018-12-01,Vermont,517887,343523,336236,7287
2018-12-01,Virginia,6661589,4358102,4243989,114113
2018-12-01,Washington,5976850,3850486,3671124,179362
2018-12-01,Wisconsin,4622766,3078676,2993725,84951
2018-12-01,Wyoming,450154,292936,281413,11523
2019-01-01,Alabama,3858512,2218016,2123222,94794
2019-01-01,Alaska,546579,349386,325783,23603
2019-01-01,Arizona,5670393,3505228,3317215,188013
2019-01-01,Arkansas,2340710,1345590,1286293,59297
2019-01-01,California,31012788,19323914,18385594,938320
2019-01-01,Colorado,4516317,3084590,2981207,103383
2019-01-01,Connecticut,2885407,1905935,1820221,85714
2019-01-01,Delaware,776420,483932,464115,19817
2019-01-01,Florida,17320950,10226748,9836915,389833
2019-01-01,Georgia,8156579,5126670,4906091,220579
2019-01-01,Hawaii,1092891,670618,650976,19642
2019-01-01,Idaho,1354143,862962,829137,33825
2019-01-01,Illinois,10009039,6443805,6096526,347279
2019-01-01,Indiana,5228912,3375695,3239676,136019
2019-01-01,Iowa,2466434,1713131,1652105,61026
2019-01-01,Kansas,2225406,1481498,1427245,54253
2019-01-01,Kentucky,3492386,2043169,1946420,96749
2019-01-01,Louisiana,3584760,2092144,1983084,109060
2019-01-01,Maine,1108679,687449,661953,25496
2019-01-01,Maryland,4760866,3229481,3092101,137380
2019-01-01,Massachusetts,5627960,3773801,3624071,149730
2019-01-01,Michigan,7986297,4911291,4673897,237394
2019-01-01,Minnesota,4410297,3063373,2933785,129588
2019-01-01,Mississippi,2287007,1260555,1188890,71665
2019-01-01,Missouri,4804992,3035462,2922843,112619
2019-01-01,Montana,847596,529049,503570,25479
2019-01-01,Nebraska,1475406,1028124,991618,36506
2019-01-01,Nevada,2408437,1535019,1463161,71858
2019-01-01,Ohio,9232906,5782079,5475684,306395
2019-01-01,Oklahoma,3022283,1829020,1761928,67092
2019-01-01,Oregon,3392962,2093571,1997852,95719
2019-01-01,Pennsylvania,10273786,6449394,6140353,309041
2019-01-01,Tennessee,5357263,3289418,3160965,128453
2019-01-01,Texas,21770174,13906519,13326606,579913
2019-01-01,Utah,2326530,1586679,1537119,49560
2019-01-01,Vermont,517878,344711,334884,9827
2019-01-01,Virginia,6664897,4367012,4219185,147827
2019-01-01,Washington,5983264,3860889,3660423,200466
2019-01-01,Wisconsin,4624157,3059863,2957112,102751
2019-01-01,Wyoming,450258,292448,279379,13069
2019-02-01,Alabama,3859089,2227059,2143463,83596
2019-02-01,Alaska,546404,352084,329835,22249
2019-02-01,Arizona,5679559,3506682,3337810,168872
2019-02-01,Arkansas,2341109,1361438,1306020,55418
2019-02-01,California,31014817,19382307,18520137,862170
2019-02-01,Colorado,4521344,3113358,3016419,96939
2019-02-01,Connecticut,2884720,1904764,1826480,78284
2019-02-01,Delaware,777040,485074,466889,18185
2019-02-01,Florida,17335625,10253650,9915345,338305
2019-02-01,Georgia,8164162,5133364,4935389,197975
2019-02-01,Hawaii,1092373,669985,652700,17285
2019-02-01,Idaho,1356695,867414,837399,30015
2019-02-01,Illinois,10005294,6468598,6152603,315995
2019-02-01,Indiana,5230605,3376806,3247930,128876
2019-02-01,Iowa,2466914,1724820,1671198,53622
2019-02-01,Kansas,2225385,1491592,1439347,52245
2019-02-01,Kentucky,3492597,2047687,1953295,94392
2019-02-01,Louisiana,3584066,2093428,2005186,88242
2019-02-01,Maine,1108981,688321,664572,23749
2019-02-01,Maryland,4761146,3236090,3110857,125233
2019-02-01,Massachusetts,5628669,3776739,3640109,136630
2019-02-01,Michigan,7985730,4931877,4706305,225572
2019-02-01,Minnesota,4412091,3069818,2951243,118575
2019-02-01,Mississippi,2286684,1267425,1198326,69099
2019-02-01,Missouri,4805762,3058665,2945631,113034
2019-02-01,Montana,848103,531829,508791,23038
2019-02-01,Nebraska,1475799,1035676,1001585,34091
2019-02-01,Nevada,2412610,1550251,1485586,64665
2019-02-01,Ohio,9233071,5792466,5517068,275398
2019-02-01,Oklahoma,3023300,1838168,1776927,61241
2019-02-01,Oregon,3395298,2100228,2008872,91356
2019-02-01,Pennsylvania,10272066,6464276,6159479,304797
2019-02-01,Tennessee,5360432,3308636,3193723,114913
2019-02-01,Texas,21795969,13995856,13469179,526677
2019-02-01,Utah,2330395,1597643,1549048,48595
2019-02-01,Vermont,517850,344379,335983,8396
2019-02-01,Virginia,6667480,4404713,4268520,136193
2019-02-01,Washington,5989125,3888160,3685660,202500
2019-02-01,Wisconsin,4625075,3078299,2970663,107636
2019-02-01,Wyoming,450382,292922,281577,11345
2019-03-01,Alabama,3860039,2230941,2153104,77837
2019-03-01,Alaska,546284,351885,330081,21804
2019-03-01,Arizona,5689006,3521527,3349905,171622
2019-03-01,Arkansas,2341740,1363242,1315938,47304
2019-03-01,California,31017497,19372871,18496094,876777
2019-03-01,Colorado,4526747,3101721,3013176,88545
2019-03-01,Connecticut,2884267,1909067,1834655,74412
2019-03-01,Delaware,777740,487530,469815,17715
2019-03-01,Florida,17351326,10222191,9890322,331869
2019-03-01,Georgia,8172347,5136259,4946615,189644
2019-03-01,Hawaii,1091842,670888,654194,16694
2019-03-01,Idaho,1359388,869214,840262,28952
2019-03-01,Illinois,10002260,6468438,6171894,296544
2019-03-01,Indiana,5232865,3384705,3262025,122680
2019-03-01,Iowa,2467642,1726741,1670192,56549
2019-03-01,Kansas,2225581,1484320,1434283,50037
2019-03-01,Kentucky,3493161,2064027,1967320,96707
2019-03-01,Louisiana,3583666,2096088,2013023,83065
2019-03-01,Maine,1109377,687381,665675,21706
2019-03-01,Maryland,4761718,3245381,3127989,117392
2019-03-01,Massachusetts,5629802,3778620,3649278,129342
2019-03-01,Michigan,7985849,4939902,4704107,235795
2019-03-01,Minnesota,4414293,3068406,2947960,120446
2019-03-01,Mississippi,2286551,1271339,1204825,66514
2019-03-01,Missouri,4807015,3062370,2950668,111702
2019-03-01,Montana,848735,532686,509350,23336
2019-03-01,Nebraska,1476308,1037360,1003007,34353
2019-03-01,Nevada,2416855,1549318,1486267,63051
2019-03-01,Ohio,9234157,5796989,5547506,249483
2019-03-01,Oklahoma,3024561,1840770,1783952,56818
2019-03-01,Oregon,3397908,2099611,2007976,91635
2019-03-01,Pennsylvania,10271309,6438082,6146987,291095
2019-03-01,Tennessee,5364123,3320477,3206636,113841
2019-03-01,Texas,21822493,13954188,13465204,488984
2019-03-01,Utah,2334391,1597123,1550636,46487
2019-03-01,Vermont,517867,344675,335892,8783
2019-03-01,Virginia,6670614,4415408,4286034,129374
2019-03-01,Washington,5995444,3891208,3704733,186475
2019-03-01,Wisconsin,4626472,3078835,2969372,109463
2019-03-01,Wyoming,450554,294195,282495,11700
2019-04-01,Alabama,3861170,2226937,2167623,59314
2019-04-01,Alaska,546243,347289,328549,18740
2019-04-01,Arizona,5698836,3502998,3342966,160032
2019-04-01,Arkansas,2342453,1360914,1320964,39950
2019-04-01,California,31022564,19183667,18445071,738596
2019-04-01,Colorado,4532350,3085981,3007009,78972
2019-04-01,Connecticut,2883945,1894175,1833841,60334
2019-04-01,Delaware,778516,486312,470800,15512
2019-04-01,Florida,17368100,10219267,9919708,299559
2019-04-01,Georgia,8180996,5099408,4934972,164436
2019-04-01,Hawaii,1091436,666784,651019,15765
2019-04-01,Idaho,1362162,868925,844838,24087
2019-04-01,Illinois,9999793,6434125,6182130,251995
2019-04-01,Indiana,5235328,3365528,3271400,94128
2019-04-01,Iowa,2468454,1724951,1682268,42683
2019-04-01,Kansas,2225860,1480300,1438678,41622
2019-04-01,Kentucky,3493890,2053985,1976909,77076
2019-04-01,Louisiana,3583469,2097332,2020208,77124
2019-04-01,Maine,1109866,686306,666925,19381
2019-04-01,Maryland,4762584,3229260,3130358,98902
2019-04-01,Massachusetts,5631202,3759202,3655107,104095
2019-04-01,Michigan,7986340,4896287,4709206,187081
2019-04-01,Minnesota,4416696,3067272,2972699,94573
2019-04-01,Mississippi,2286578,1270714,1208473,62241
2019-04-01,Missouri,4808486,3059818,2975357,84461
2019-04-01,Montana,849362,530881,512560,18321
2019-04-01,Nebraska,1476899,1036777,1008074,28703
2019-04-01,Nevada,2421273,1545794,1486568,59226
2019-04-01,Ohio,9235661,5781445,5575384,206061
2019-04-01,Oklahoma,3025979,1829385,1781764,47621
2019-04-01,Oregon,3400710,2093999,2017095,76904
2019-04-01,Pennsylvania,10271002,6410151,6168509,241642
2019-04-01,Tennessee,5368049,3310287,3215871,94416
2019-04-01,Texas,21850614,13917908,13493157,424751
2019-04-01,Utah,2338541,1589402,1549529,39873
2019-04-01,Vermont,517854,340411,332403,8008
2019-04-01,Virginia,6674083,4402765,4299038,103727
2019-04-01,Washington,6002058,3867713,3715517,152196
2019-04-01,Wisconsin,4628057,3068483,2973060,95423
2019-04-01,Wyoming,450675,291775,281768,10007
2019-05-01,Alabama,3862424,2227958,2170185,57773
2019-05-01,Alaska,546150,353255,334407,18848
2019-05-01,Arizona,5708829,3512234,3346120,166114
2019-05-01,Arkansas,2343292,1366045,1320830,45215
2019-05-01,California,31027526,19242672,18538523,704149
2019-05-01,Colorado,4538098,3093990,3019296,74694
2019-05-01,Connecticut,2883745,1909510,1842292,67218
2019-05-01,Delaware,779251,484088,468895,15193
2019-05-01,Florida,17385414,10290713,9974039,316674
2019-05-01,Georgia,8189728,5123957,4948009,175948
2019-05-01,Hawaii,1091012,663541,648002,15539
2019-05-01,Idaho,1364985,873875,853100,20775
2019-05-01,Illinois,9997605,6414144,6189170,224974
2019-05-01,Indiana,5238060,3359351,3261970,97381
2019-05-01,Iowa,2469440,1723565,1681377,42188
2019-05-01,Kansas,2226234,1483165,1438328,44837
2019-05-01,Kentucky,3494766,2067573,1984252,83321
2019-05-01,Louisiana,3583350,2105693,2016632,89061
2019-05-01,Maine,1110412,689233,671194,18039
2019-05-01,Maryland,4763531,3247439,3140439,107000
2019-05-01,Massachusetts,5632822,3762488,3653105,109383
2019-05-01,Michigan,7987208,4938662,4750413,188249
2019-05-01,Minnesota,4419361,3079146,2996033,83113
2019-05-01,Mississippi,2286635,1279735,1213443,66292
2019-05-01,Missouri,4810200,3072523,2980363,92160
2019-05-01,Montana,850047,535371,519298,16073
2019-05-01,Nebraska,1477544,1041423,1011310,30113
2019-05-01,Nevada,2425739,1555851,1496849,59002
2019-05-01,Ohio,9237539,5805448,5584895,220553
2019-05-01,Oklahoma,3027519,1841911,1786502,55409
2019-05-01,Oregon,3403640,2091571,2023155,68416
2019-05-01,Pennsylvania,10271186,6463215,6193658,269557
2019-05-01,Tennessee,5372175,3320140,3218743,101397
2019-05-01,Texas,21878787,13916039,13479948,436091
2019-05-01,Utah,2342806,1598262,1558989,39273
2019-05-01,Vermont,517915,341872,334844,7028
2019-05-01,Virginia,6677682,4421832,4305067,116765
2019-05-01,Washington,6008920,3877424,3725820,151604
2019-05-01,Wisconsin,4629921,3073566,2976865,96701
2019-05-01,Wyoming,450891,293385,283724,9661
2019-06-01,Alabama,3863995,2244448,2169418,75030
2019-06-01,Alaska,546141,360399,340339,20060
2019-06-01,Arizona,5719237,3537618,3353176,184442
2019-06-01,Arkansas,2344321,1375705,1324519,51186
2019-06-01,California,31035051,19259046,18447538,811508
2019-06-01,Colorado,4544250,3135387,3047925,87462
2019-06-01,Connecticut,2883772,1926517,1855177,71340
2019-06-01,Delaware,780094,489084,470505,18579
2019-06-01,Florida,17404169,10318242,9960651,357591
2019-06-01,Georgia,8199141,5143861,4945940,197921
2019-06-01,Hawaii,1090709,668030,647061,20969
2019-06-01,Idaho,1367964,885105,862561,22544
2019-06-01,Illinois,9996220,6516752,6248712,268040
2019-06-01,Indiana,5241157,3405385,3291736,113649
2019-06-01,Iowa,2470620,1741065,1692999,48066
2019-06-01,Kansas,2226826,1501595,1453332,48263
2019-06-01,Kentucky,3495916,2090502,1993630,96872
2019-06-01,Louisiana,3583530,2139842,2024091,115751
2019-06-01,Maine,1111030,703557,685618,17939
2019-06-01,Maryland,4764863,3292423,3168502,123921
2019-06-01,Massachusetts,5634880,3818274,3697873,120401
2019-06-01,Michigan,7988642,4989230,4775626,213604
2019-06-01,Minnesota,4422372,3112293,3011760,100533
2019-06-01,Mississippi,2286865,1294799,1208956,85843
2019-06-01,Missouri,4812270,3110449,3005631,104818
2019-06-01,Montana,850830,541835,522896,18939
2019-06-01,Nebraska,1478351,1048012,1014050,33962
2019-06-01,Nevada,2430418,1562016,1497771,64245
2019-06-01,Ohio,9240152,5889980,5631288,258692
2019-06-01,Oklahoma,3029295,1857703,1795496,62207
2019-06-01,Oregon,3406868,2113322,2030057,83265
2019-06-01,Pennsylvania,10272181,6531530,6236787,294743
2019-06-01,Tennessee,5376724,3352446,3225154,127292
2019-06-01,Texas,21908726,14018408,13488078,530330
2019-06-01,Utah,2347248,1609774,1564386,45388
2019-06-01,Vermont,518005,347462,339465,7997
2019-06-01,Virginia,6681878,4457635,4333696,123939
2019-06-01,Washington,6016231,3911203,3753312,157891
2019-06-01,Wisconsin,4632110,3144370,3025230,119140
2019-06-01,Wyoming,451126,299965,288990,10975
2019-07-01,Alabama,3865605,2246949,2175145,71804
2019-07-01,Alaska,546124,364136,345694,18442
2019-07-01,Arizona,5729725,3545131,3356066,189065
2019-07-01,Arkansas,2345384,1378562,1322697,55865
2019-07-01,California,31042729,19404513,18537784,866729
2019-07-01,Colorado,4550388,3144596,3062633,81963
2019-07-01,Connecticut,2883814,1949409,1875388,74021
2019-07-01,Delaware,780911,492981,473247,19734
2019-07-01,Florida,17423120,10359370,9983275,376095
2019-07-01,Georgia,8208646,5162875,4963038,199837
2019-07-01,Hawaii,1090419,668857,651786,17071
2019-07-01,Idaho,1370929,890928,866587,24341
2019-07-01,Illinois,9994924,6524076,6251669,272407
2019-07-01,Indiana,5244373,3407512,3292597,114915
2019-07-01,Iowa,2471822,1752768,1702989,49779
2019-07-01,Kansas,2227416,1514111,1455431,58680
2019-07-01,Kentucky,3497135,2088693,1991289,97404
2019-07-01,Louisiana,3583771,2140471,2026005,114466
2019-07-01,Maine,1111651,712126,693797,18329
2019-07-01,Maryland,4766235,3321375,3193787,127588
2019-07-01,Massachusetts,5637007,3831608,3707099,124509
2019-07-01,Michigan,7990228,5021163,4768495,252668
2019-07-01,Minnesota,4425397,3125014,3027221,97793
2019-07-01,Mississippi,2287134,1301631,1214908,86723
2019-07-01,Missouri,4814438,3118609,3003004,115605
2019-07-01,Montana,851600,544682,526874,17808
2019-07-01,Nebraska,1479137,1053319,1018808,34511
2019-07-01,Nevada,2435079,1573535,1508665,64870
2019-07-01,Ohio,9242913,5930216,5662690,267526
2019-07-01,Oklahoma,3031109,1853867,1793324,60543
2019-07-01,Oregon,3410117,2128702,2041153,87549
2019-07-01,Pennsylvania,10273325,6574817,6246636,328181
2019-07-01,Tennessee,5381375,3364845,3236804,128041
2019-07-01,Texas,21938858,14076785,13535063,541722
2019-07-01,Utah,2351704,1616699,1574557,42142
2019-07-01,Vermont,518111,348028,340113,7915
2019-07-01,Virginia,6686119,4478699,4352317,126382
2019-07-01,Washington,6023628,3940088,3777929,162159
2019-07-01,Wisconsin,4634420,3143920,3032689,111231
2019-07-01,Wyoming,451343,301247,289824,11423
2019-08-01,Alabama,3867674,2239890,2171651,68239
2019-08-01,Alaska,546150,358901,341827,17074
2019-08-01,Arizona,5742211,3542099,3356509,185590
2019-08-01,Arkansas,2346922,1362894,1313356,49538
2019-08-01,California,31051769,19326852,18501160,825692
2019-08-01,Colorado,4556290,3142466,3060164,82302
2019-08-01,Connecticut,2884364,1927024,1854910,72114
2019-08-01,Delaware,781909,490615,470461,20154
2019-08-01,Florida,17446500,10364167,9990840,373327
2019-08-01,Georgia,8217762,5132814,4941670,191144
2019-08-01,Hawaii,1090268,665912,649738,16174
2019-08-01,Idaho,1374226,884866,862294,22572
2019-08-01,Illinois,9993687,6458277,6208012,250265
2019-08-01,Indiana,5247759,3386500,3278898,107602
2019-08-01,Iowa,2472948,1735862,1687479,48383
2019-08-01,Kansas,2228430,1488103,1437293,50810
2019-08-01,Kentucky,3498575,2073543,1990809,82734
2019-08-01,Louisiana,3584102,2123797,2015370,108427
2019-08-01,Maine,1112377,711502,694919,16583
2019-08-01,Maryland,4767772,3287640,3166109,121531
2019-08-01,Massachusetts,5639040,3821873,3709962,111911
2019-08-01,Michigan,7992084,4984684,4776688,207996
2019-08-01,Minnesota,4428165,3105396,3013040,92356
2019-08-01,Mississippi,2287500,1281728,1205447,76281
2019-08-01,Missouri,4817071,3079871,2971967,107904
2019-08-01,Montana,852602,543333,525385,17948
2019-08-01,Nebraska,1480038,1040399,1009487,30912
2019-08-01,Nevada,2439491,1570544,1508657,61887
2019-08-01,Ohio,9245841,5885784,5643160,242624
2019-08-01,Oklahoma,3033521,1840906,1783536,57370
2019-08-01,Oregon,3413384,2126122,2041803,84319
2019-08-01,Pennsylvania,10275707,6546917,6230836,316081
2019-08-01,Tennessee,5387165,3331538,3219876,111662
2019-08-01,Texas,21973020,14044334,13521720,522614
2019-08-01,Utah,2356169,1613004,1570939,42065
2019-08-01,Vermont,518273,346019,338249,7770
2019-08-01,Virginia,6690638,4429147,4306726,122421
2019-08-01,Washington,6031259,3930855,3771972,158883
2019-08-01,Wisconsin,4636987,3115152,3008426,106726
2019-08-01,Wyoming,451683,298666,288374,10292
2019-09-01,Alabama,3869937,2237747,2179741,58006
2019-09-01,Alaska,546193,355800,339376,16424
2019-09-01,Arizona,5754979,3561836,3397291,164545
2019-09-01,Arkansas,2348558,1367085,1322676,44409
2019-09-01,California,31062463,19450768,18721599,729169
2019-09-01,Colorado,4562413,3156091,3082388,73703
2019-09-01,Connecticut,2885043,1914970,1852238,62732
2019-09-01,Delaware,782978,484900,467796,17104
2019-09-01,Florida,17470770,10427813,10093584,334229
2019-09-01,Georgia,8227288,5163647,4999672,163975
2019-09-01,Hawaii,1090192,667801,651400,16401
2019-09-01,Idaho,1377619,885358,865716,19642
2019-09-01,Illinois,9992956,6414776,6192774,222002
2019-09-01,Indiana,5251359,3369608,3274907,94701
2019-09-01,Iowa,2474160,1738692,1697727,40965
2019-09-01,Kansas,2229568,1494416,1454413,40003
2019-09-01,Kentucky,3500176,2071606,1996438,75168
2019-09-01,Louisiana,3584700,2128249,2028529,99720
2019-09-01,Maine,1113156,697841,681788,16053
2019-09-01,Maryland,4769535,3277201,3174892,102309
2019-09-01,Massachusetts,5641308,3754926,3650652,104274
2019-09-01,Michigan,7994298,4948041,4772185,175856
2019-09-01,Minnesota,4431178,3099628,3020908,78720
2019-09-01,Mississippi,2287965,1285950,1215996,69954
2019-09-01,Missouri,4819891,3080089,2994970,85119
2019-09-01,Montana,853702,538664,522875,15789
2019-09-01,Nebraska,1481039,1036684,1010041,26643
2019-09-01,Nevada,2443975,1582554,1524852,57702
2019-09-01,Ohio,9249209,5834060,5609652,224408
2019-09-01,Oklahoma,3036112,1853607,1800451,53156
2019-09-01,Oregon,3416813,2110435,2041493,68942
2019-09-01,Pennsylvania,10278544,6513250,6236755,276495
2019-09-01,Tennessee,5393158,3328485,3224838,103647
2019-09-01,Texas,22008347,14100536,13616912,483624
2019-09-01,Utah,2360793,1619229,1585889,33340
2019-09-01,Vermont,518428,342076,334131,7945
2019-09-01,Virginia,6695531,4420674,4312233,108441
2019-09-01,Washington,6039196,3929591,3789178,140413
2019-09-01,Wisconsin,4639751,3095701,3002046,93655
2019-09-01,Wyoming,452040,298705,288996,9709
2019-10-01,Alabama,3872005,2259369,2200920,58449
2019-10-01,Alaska,546253,352720,336203,16517
2019-10-01,Arizona,5767426,3570587,3404912,165675
2019-10-01,Arkansas,2350098,1370951,1329469,41482
2019-10-01,California,31071318,19437880,18681963,755917
2019-10-01,Colorado,4568307,3156287,3080184,76103
2019-10-01,Connecticut,2885631,1926599,1862812,63787
2019-10-01,Delaware,783996,489514,471705,17809
2019-10-01,Florida,17494169,10463027,10133537,329490
2019-10-01,Georgia,8236438,5180963,5013611,167352
2019-10-01,Hawaii,1090017,670809,655642,15167
2019-10-01,Idaho,1380905,890108,869929,20179
2019-10-01,Illinois,9991696,6432935,6212732,220203
2019-10-01,Indiana,5254766,3394038,3292550,101488
2019-10-01,Iowa,2475313,1749533,1709369,40164
2019-10-01,Kansas,2230598,1501891,1459703,42188
2019-10-01,Kentucky,3501637,2079295,2002289,77006
2019-10-01,Louisiana,3585062,2143096,2040859,102237
2019-10-01,Maine,1113920,702489,685981,16508
2019-10-01,Maryland,4771088,3298784,3192484,106300
2019-10-01,Massachusetts,5643397,3773151,3678897,94254
2019-10-01,Michigan,7996150,4951173,4785112,166061
2019-10-01,Minnesota,4434016,3113286,3035510,77776
2019-10-01,Mississippi,2288305,1284176,1218853,65323
2019-10-01,Missouri,4822582,3094481,3008296,86185
2019-10-01,Montana,854715,540107,523042,17065
2019-10-01,Nebraska,1481955,1044698,1016068,28630
2019-10-01,Nevada,2448374,1590110,1532842,57268
2019-10-01,Ohio,9252182,5880316,5662906,217410
2019-10-01,Oklahoma,3038533,1858527,1800339,58188
2019-10-01,Oregon,3420102,2117648,2051292,66356
2019-10-01,Pennsylvania,10280988,6548025,6263459,284566
2019-10-01,Tennessee,5398996,3335648,3226746,108902
2019-10-01,Texas,22042462,14149839,13678707,471132
2019-10-01,Utah,2365287,1625024,1591317,33707
2019-10-01,Vermont,518595,344306,338477,5829
2019-10-01,Virginia,6700112,4455040,4348893,106147
2019-10-01,Washington,6046858,3943549,3804770,138779
2019-10-01,Wisconsin,4642347,3104792,3014268,90524
2019-10-01,Wyoming,452379,298470,288036,10434
2019-11-01,Alabama,3873710,2247057,2192024,55033
2019-11-01,Alaska,546204,351233,333227,18006
2019-11-01,Arizona,5779302,3584365,3423479,160886
2019-11-01,Arkansas,2351416,1368371,1326423,41948
2019-11-01,California,31078032,19476349,18712359,763990
2019-11-01,Colorado,4573834,3152813,3076949,75864
2019-11-01,Connecticut,2885855,1927347,1869344,58003
2019-11-01,Delaware,784946,490770,474118,16652
2019-11-01,Florida,17515663,10396640,10079828,316812
2019-11-01,Georgia,8244931,5180664,5026339,154325
2019-11-01,Hawaii,1089866,673310,659523,13787
2019-11-01,Idaho,1384052,887976,865525,22451
2019-11-01,Illinois,9989539,6406913,6201074,205839
2019-11-01,Indiana,5257617,3390237,3286006,104231
2019-11-01,Iowa,2476140,1739468,1697437,42031
2019-11-01,Kansas,2231343,1505125,1462780,42345
2019-11-01,Kentucky,3502739,2081821,2008151,73670
2019-11-01,Louisiana,3585109,2146959,2047205,99754
2019-11-01,Maine,1114519,695313,677685,17628
2019-11-01,Maryland,4772202,3287858,3185930,101928
2019-11-01,Massachusetts,5644916,3768067,3675402,92665
2019-11-01,Michigan,7997211,4948325,4790408,157917
2019-11-01,Minnesota,4436354,3106045,3024772,81273
2019-11-01,Mississippi,2288427,1285129,1217902,67227
2019-11-01,Missouri,4824710,3088016,2993483,94533
2019-11-01,Montana,855635,539683,521306,18377
2019-11-01,Nebraska,1482720,1045272,1017752,27520
2019-11-01,Nevada,2452584,1592509,1537788,54721
2019-11-01,Ohio,9254101,5874291,5654998,219293
2019-11-01,Oklahoma,3040628,1856846,1801365,55481
2019-11-01,Oregon,3423008,2111104,2051364,59740
2019-11-01,Pennsylvania,10282189,6515548,6237313,278235
2019-11-01,Tennessee,5404250,3345923,3239380,106543
2019-11-01,Texas,22074778,14200410,13723153,477257
2019-11-01,Utah,2369514,1632908,1598428,34480
2019-11-01,Vermont,518664,345178,337013,8165
2019-11-01,Virginia,6704073,4440150,4336853,103297
2019-11-01,Washington,6053960,3934936,3792659,142277
2019-11-01,Wisconsin,4644458,3093264,3002529,90735
2019-11-01,Wyoming,452666,298013,286547,11466
2019-12-01,Alabama,3875217,2240957,2186239,54718
2019-12-01,Alaska,546167,349567,331726,17841
2019-12-01,Arizona,5790821,3574368,3414468,159900
2019-12-01,Arkansas,2352592,1362346,1316715,45631
2019-12-01,California,31082947,19384074,18618487,765587
2019-12-01,Colorado,4579096,3146158,3069940,76218
2019-12-01,Connecticut,2885994,1912280,1854354,57926
2019-12-01,Delaware,785852,491675,474286,17389
2019-12-01,Florida,17536150,10423772,10119194,304578
2019-12-01,Georgia,8252983,5195256,5032533,162723
2019-12-01,Hawaii,1089657,673732,661148,12584
2019-12-01,Idaho,1387150,886637,864194,22443
2019-12-01,Illinois,9986797,6369025,6156932,212093
2019-12-01,Indiana,5260181,3374517,3277141,97376
2019-12-01,Iowa,2476859,1735817,1685140,50677
2019-12-01,Kansas,2232017,1497874,1456538,41336
2019-12-01,Kentucky,3503649,2082085,2005141,76944
2019-12-01,Louisiana,3584977,2130487,2034524,95963
2019-12-01,Maine,1115080,692823,676351,16472
2019-12-01,Maryland,4773117,3283554,3185422,98132
2019-12-01,Massachusetts,5646173,3766273,3671261,95012
2019-12-01,Michigan,7997875,4933081,4763655,169426
2019-12-01,Minnesota,4438470,3105118,3005534,99584
2019-12-01,Mississippi,2288447,1282497,1217398,65099
2019-12-01,Missouri,4826623,3086813,2984335,102478
2019-12-01,Montana,856541,537622,517567,20055
2019-12-01,Nebraska,1483375,1038731,1011405,27326
2019-12-01,Nevada,2456633,1589050,1533724,55326
2019-12-01,Ohio,9255603,5853909,5622959,230950
2019-12-01,Oklahoma,3042581,1847173,1794920,52253
2019-12-01,Oregon,3425727,2097067,2036505,60562
2019-12-01,Pennsylvania,10282920,6506211,6219714,286497
2019-12-01,Tennessee,5409243,3343512,3234258,109254
2019-12-01,Texas,22105815,14169618,13705505,464113
2019-12-01,Utah,2373687,1626689,1591233,35456
2019-12-01,Vermont,518756,343495,335379,8116
2019-12-01,Virginia,6707692,4434983,4334902,100081
2019-12-01,Washington,6060751,3936216,3783975,152241
2019-12-01,Wisconsin,4646321,3075658,2984041,91617
2019-12-01,Wyoming,452928,295794,283792,12002
2020-01-01,Alabama,3876526,2225417,2155478,69939
2020-01-01,Alaska,546109,348829,329844,18985
2020-01-01,Arizona,5802213,3587269,3413357,173912
2020-01-01,Arkansas,2353674,1356254,1299739,56515
2020-01-01,California,31086836,19438620,18565165,873455
2020-01-01,Colorado,4584112,3144882,3054241,90641
2020-01-01,Connecticut,2885953,1916553,1835094,81459
2020-01-01,Delaware,786721,492355,469517,22838
2020-01-01,Florida,17555962,10455017,10100071,354946
2020-01-01,Georgia,8260627,5212231,5025807,186424
2020-01-01,Hawaii,1089395,677385,663459,13926
2020-01-01,Idaho,1390161,885293,856237,29056
2020-01-01,Illinois,9983613,6333145,6078660,254485
2020-01-01,Indiana,5262529,3364647,3245291,119356
2020-01-01,Iowa,2477479,1729632,1667798,61834
2020-01-01,Kansas,2232550,1493578,1444907,48671
2020-01-01,Kentucky,3504469,2067955,1974116,93839
2020-01-01,Louisiana,3584646,2133698,2022909,110789
2020-01-01,Maine,1115592,689271,666422,22849
2020-01-01,Maryland,4773748,3284785,3165565,119220
2020-01-01,Massachusetts,5647161,3755504,3627513,127991
2020-01-01,Michigan,7998157,4909663,4702872,206791
2020-01-01,Minnesota,4440365,3102006,2984227,117779
2020-01-01,Mississippi,2288349,1269573,1199518,70055
2020-01-01,Missouri,4828271,3077693,2955956,121737
2020-01-01,Montana,857398,538957,514084,24873
2020-01-01,Nebraska,1484013,1037068,1003429,33639
2020-01-01,Nevada,2460603,1595413,1533330,62083
2020-01-01,Ohio,9256594,5846906,5542189,304717
2020-01-01,Oklahoma,3044378,1847668,1787563,60105
2020-01-01,Oregon,3428283,2090607,2012636,77971
2020-01-01,Pennsylvania,10283103,6505710,6180006,325704
2020-01-01,Tennessee,5413972,3332953,3200454,132499
2020-01-01,Texas,22136086,14161146,13634710,526436
2020-01-01,Utah,2377669,1629243,1586011,43232
2020-01-01,Vermont,518807,343783,333456,10327
2020-01-01,Virginia,6711014,4437563,4314462,123101
2020-01-01,Washington,6067267,3954032,3773768,180264
2020-01-01,Wisconsin,4647953,3057272,2949978,107294
2020-01-01,Wyoming,453129,296026,281630,14396
2020-02-01,Alabama,3877055,2236698,2174486,62212
2020-02-01,Alaska,545922,350406,332179,18227
2020-02-01,Arizona,5812433,3597043,3434158,162885
2020-02-01,Arkansas,2354279,1371586,1316079,55507
2020-02-01,California,31086594,19514077,18669865,844212
2020-02-01,Colorado,4588565,3163054,3072024,91030
2020-02-01,Connecticut,2885386,1912972,1836116,76856
2020-02-01,Delaware,787402,495454,473206,22248
2020-02-01,Florida,17571923,10501385,10180320,321065
2020-02-01,Georgia,8266924,5236253,5058893,177360
2020-02-01,Hawaii,1088920,675724,664079,11645
2020-02-01,Idaho,1392964,889882,863468,26414
2020-02-01,Illinois,9978724,6359497,6122067,237430
2020-02-01,Indiana,5263980,3360761,3246209,114552
2020-02-01,Iowa,2477569,1736013,1680597,55416
2020-02-01,Kansas,2232676,1505032,1455483,49549
2020-02-01,Kentucky,3504588,2073203,1982825,90378
2020-02-01,Louisiana,3583665,2138252,2047842,90410
2020-02-01,Maine,1115854,692530,668671,23859
2020-02-01,Maryland,4773523,3296282,3182470,113812
2020-02-01,Massachusetts,5647178,3758153,3640941,117212
2020-02-01,Michigan,7996913,4919562,4733981,185581
2020-02-01,Minnesota,4441480,3118067,3005660,112407
2020-02-01,Mississippi,2287820,1277395,1209347,68048
2020-02-01,Missouri,4828978,3092673,2973704,118969
2020-02-01,Montana,858070,542851,520057,22794
2020-02-01,Nebraska,1484359,1044596,1012677,31919
2020-02-01,Nevada,2464244,1611382,1553906,57476
2020-02-01,Ohio,9255817,5882748,5590092,292656
2020-02-01,Oklahoma,3045622,1851114,1793165,57949
2020-02-01,Oregon,3430274,2106874,2031373,75501
2020-02-01,Pennsylvania,10281185,6528280,6199918,328362
2020-02-01,Tennessee,5417729,3341965,3213875,128090
2020-02-01,Texas,22163701,14262779,13761203,501576
2020-02-01,Utah,2381430,1640139,1596506,43633
2020-02-01,Vermont,518755,343087,334226,8861
2020-02-01,Virginia,6713131,4461764,4350389,111375
2020-02-01,Washington,6072840,3988229,3810664,177565
2020-02-01,Wisconsin,4648731,3070731,2963046,107685
2020-02-01,Wyoming,453321,297365,282925,14440
2020-03-01,Alabama,3878006,2227126,2165460,61666
2020-03-01,Alaska,545866,349989,328157,21832
2020-03-01,Arizona,5823018,3585541,3399392,186149
2020-03-01,Arkansas,2355118,1367760,1310660,57100
2020-03-01,California,31087184,19167207,18193046,974161
2020-03-01,Colorado,4593310,3079676,2926365,153311
2020-03-01,Connecticut,2885051,1903646,1822690,80956
2020-03-01,Delaware,788163,482043,456750,25293
2020-03-01,Florida,17589075,10566114,10035053,531061
2020-03-01,Georgia,8273938,5201099,5008225,192874
2020-03-01,Hawaii,1088470,670957,656761,14196
2020-03-01,Idaho,1395898,884713,855425,29288
2020-03-01,Illinois,9974673,6307742,6054069,253673
2020-03-01,Indiana,5265950,3313299,3189696,123603
2020-03-01,Iowa,2477947,1709220,1648763,60457
2020-03-01,Kansas,2233058,1487454,1435116,52338
2020-03-01,Kentucky,3505113,2071046,1970336,100710
2020-03-01,Louisiana,3583040,2146472,2032539,113933
2020-03-01,Maine,1116239,692623,663142,29481
2020-03-01,Maryland,4773662,3287072,3160027,127045
2020-03-01,Massachusetts,5647723,3712130,3595223,116907
2020-03-01,Michigan,7996478,4894999,4677014,217985
2020-03-01,Minnesota,4443088,3111045,2971207,139838
2020-03-01,Mississippi,2287475,1281468,1202105,79363
2020-03-01,Missouri,4830226,3084107,2949146,134961
2020-03-01,Montana,858828,539456,513905,25551
2020-03-01,Nebraska,1484852,1039301,1002614,36687
2020-03-01,Nevada,2467941,1586360,1480827,105533
2020-03-01,Ohio,9256097,5821848,5484264,337584
2020-03-01,Oklahoma,3047166,1834662,1772700,61962
2020-03-01,Oregon,3432553,2098879,2009490,89389
2020-03-01,Pennsylvania,10280347,6471607,6110043,361564
2020-03-01,Tennessee,5422052,3306102,3163283,142819
2020-03-01,Texas,22192219,13953661,13248772,704889
2020-03-01,Utah,2385460,1626054,1578898,47156
2020-03-01,Vermont,518754,340422,330643,9779
2020-03-01,Virginia,6715837,4436793,4313570,123223
2020-03-01,Washington,6078919,3930706,3701113,229593
2020-03-01,Wisconsin,4649987,3041275,2925396,115879
2020-03-01,Wyoming,453558,297605,280016,17589
2020-04-01,Alabama,3879108,2175494,1899457,276037
2020-04-01,Alaska,545788,341223,299048,42175
2020-04-01,Arizona,5834004,3523144,3023400,499744
2020-04-01,Arkansas,2356097,1367099,1234808,132291
2020-04-01,California,31090131,18451970,15507446,2944524
2020-04-01,Colorado,4598343,2959510,2599087,360423
2020-04-01,Connecticut,2884884,1805067,1653983,151084
2020-04-01,Delaware,788966,473726,410618,63108
2020-04-01,Florida,17607252,9717870,8369009,1348861
2020-04-01,Georgia,8281411,4950530,4347797,602733
2020-04-01,Hawaii,1088090,636024,496974,139050
2020-04-01,Idaho,1398886,868898,767936,100962
2020-04-01,Illinois,9971141,5964800,4994319,970481
2020-04-01,Indiana,5268170,3198078,2669270,528808
2020-04-01,Iowa,2478425,1704471,1516330,188141
2020-04-01,Kansas,2233522,1476015,1291632,184383
2020-04-01,Kentucky,3505783,2078415,1730477,347938
2020-04-01,Louisiana,3582557,2033649,1774424,259225
2020-04-01,Maine,1116663,648822,585493,63329
2020-04-01,Maryland,4774055,3104331,2831208,273123
2020-04-01,Massachusetts,5648468,3382826,2832742,550084
2020-04-01,Michigan,7996378,4530016,3459355,1070661
2020-04-01,Minnesota,4444837,2999206,2725712,273494
2020-04-01,Mississippi,2287269,1213416,1026655,186761
2020-04-01,Missouri,4831693,2971380,2605587,365793
2020-04-01,Montana,859622,538926,474310,64616
2020-04-01,Nebraska,1485441,1048382,971165,77217
2020-04-01,Nevada,2471833,1491235,1048756,442479
2020-04-01,Ohio,9256776,5521458,4600167,921291
2020-04-01,Oklahoma,3048864,1805213,1575119,230094
2020-04-01,Oregon,3434992,2035126,1767698,267428
2020-04-01,Pennsylvania,10279924,6247158,5251171,995987
2020-04-01,Tennessee,5426617,3161316,2668368,492948
2020-04-01,Texas,22222320,13326311,11627585,1698726
2020-04-01,Utah,2389585,1611373,1447664,163709
2020-04-01,Vermont,518778,348360,296119,52241
2020-04-01,Virginia,6718918,4369898,3888768,481130
2020-04-01,Washington,6085331,3964302,3317550,646752
2020-04-01,Wisconsin,4651479,3033527,2580861,452666
2020-04-01,Wyoming,453794,288142,271391,16751
2020-05-01,Alabama,3879383,2211140,2042836,168304
2020-05-01,Alaska,545650,345972,304611,41361
2020-05-01,Arizona,5843415,3613337,3226078,387259
2020-05-01,Arkansas,2356584,1359019,1240444,118575
2020-05-01,California,31081351,18348132,15513264,2834868
2020-05-01,Colorado,4602402,3084205,2723604,360601
2020-05-01,Connecticut,2883940,1882909,1663779,219130
2020-05-01,Delaware,789583,476031,411461,64570
2020-05-01,Florida,17620672,9972760,8544679,1428081
2020-05-01,Georgia,8286668,5024074,4548605,475469
2020-05-01,Hawaii,1087260,635899,496327,139572
2020-05-01,Idaho,1401631,883908,808896,75012
2020-05-01,Illinois,9965041,6130554,5194471,936083
2020-05-01,Indiana,5269325,3267075,2878173,388902
2020-05-01,Iowa,2478455,1655737,1518186,137551
2020-05-01,Kansas,2233534,1484126,1346318,137808
2020-05-01,Kentucky,3505869,2078339,1846955,231384
2020-05-01,Louisiana,3581304,2041909,1766669,275240
2020-05-01,Maine,1116950,677547,618919,58628
2020-05-01,Maryland,4773107,3130185,2839783,290402
2020-05-01,Massachusetts,5647805,3585611,3033094,552517
2020-05-01,Michigan,7994582,4711928,3717287,994641
2020-05-01,Minnesota,4445755,3085306,2741321,343985
2020-05-01,Mississippi,2286517,1232242,1090941,141301
2020-05-01,Missouri,4832218,2899861,2617173,282688
2020-05-01,Montana,860294,528665,481745,46920
2020-05-01,Nebraska,1485719,1033445,977281,56164
2020-05-01,Nevada,2474993,1434996,1081786,353210
2020-05-01,Ohio,9255576,5805415,4958764,846651
2020-05-01,Oklahoma,3049957,1833616,1652841,180775
2020-05-01,Oregon,3436725,2111005,1865451,245554
2020-05-01,Pennsylvania,10277311,6414340,5533246,881094
2020-05-01,Tennessee,5430156,3149838,2842613,307225
2020-05-01,Texas,22245728,13549965,11957125,1592840
2020-05-01,Utah,2393257,1579138,1458452,120686
2020-05-01,Vermont,518699,330491,299304,31187
2020-05-01,Virginia,6720219,4263233,3895973,367260
2020-05-01,Washington,6090159,3899857,3403183,496674
2020-05-01,Wisconsin,4652037,3045283,2718752,326531
2020-05-01,Wyoming,453942,298976,272955,26021
2020-06-01,Alabama,3879980,2236762,2057711,179051
2020-06-01,Alaska,545489,350478,311318,39160
2020-06-01,Arizona,5853318,3559525,3173552,385973
2020-06-01,Arkansas,2357230,1360293,1253145,107148
2020-06-01,California,31075328,18743309,16103517,2639792
2020-06-01,Colorado,4606805,3166070,2804567,361503
2020-06-01,Connecticut,2883299,1903809,1686883,216926
2020-06-01,Delaware,790266,480773,416893,63880
2020-06-01,Florida,17635636,9916934,8756973,1159961
2020-06-01,Georgia,8292650,5001224,4568313,432911
2020-06-01,Hawaii,1086459,638944,546664,92280
2020-06-01,Idaho,1404514,893401,832238,61163
2020-06-01,Illinois,9959743,6428397,5503605,924792
2020-06-01,Indiana,5270927,3320310,2979405,340905
2020-06-01,Iowa,2478689,1659741,1538974,120767
2020-06-01,Kansas,2233723,1488976,1387575,101401
2020-06-01,Kentucky,3506224,1988719,1871932,116787
2020-06-01,Louisiana,3580287,1976761,1773461,203300
2020-06-01,Maine,1117286,670398,636150,34248
2020-06-01,Maryland,4772600,3255232,2974611,280621
2020-06-01,Massachusetts,5647618,3718781,3169377,549404
2020-06-01,Michigan,7993462,4953891,4250653,703238
2020-06-01,Minnesota,4446981,3191110,2909852,281258
2020-06-01,Mississippi,2285922,1247891,1119601,128290
2020-06-01,Missouri,4833125,3034301,2788629,245672
2020-06-01,Montana,861056,556096,515632,40464
2020-06-01,Nebraska,1486137,1056456,986838,69618
2020-06-01,Nevada,2478346,1501397,1268916,232481
2020-06-01,Ohio,9255121,5738491,5147835,590656
2020-06-01,Oklahoma,3051282,1852569,1697284,155285
2020-06-01,Oregon,3438732,2142246,1920407,221839
2020-06-01,Pennsylvania,10275510,6455636,5601104,854532
2020-06-01,Tennessee,5434065,3185318,2870163,315155
2020-06-01,Texas,22271053,14074215,12620076,1454139
2020-06-01,Utah,2397123,1653637,1547312,106325
2020-06-01,Vermont,518679,332543,306236,26307
2020-06-01,Virginia,6722117,4358146,3970839,387307
2020-06-01,Washington,6095478,3888501,3469700,418801
2020-06-01,Wisconsin,4653004,3085264,2818609,266655
2020-06-01,Wyoming,454118,301308,279459,21849
2020-07-01,Alabama,3880648,2236392,2059083,177309
2020-07-01,Alaska,545364,353072,317208,35864
2020-07-01,Arizona,5863335,3609819,3215332,394487
2020-07-01,Arkansas,2357952,1356900,1254668,102232
2020-07-01,California,31069557,18789689,16240775,2548914
2020-07-01,Colorado,4611317,3083369,2852932,230437
2020-07-01,Connecticut,2882679,1928598,1705853,222745
2020-07-01,Delaware,790928,492039,449693,42346
2020-07-01,Florida,17650810,10113079,8907772,1205307
2020-07-01,Georgia,8298770,4982393,4579390,403003
2020-07-01,Hawaii,1085710,643980,552624,91356
2020-07-01,Idaho,1407405,895098,844370,50728
2020-07-01,Illinois,9954618,6232556,5460638,771918
2020-07-01,Indiana,5272639,3336724,3038650,298074
2020-07-01,Iowa,2478961,1643799,1546379,97420
2020-07-01,Kansas,2233951,1518534,1407326,111208
2020-07-01,Kentucky,3506659,1981728,1861719,120009
2020-07-01,Louisiana,3579383,1983701,1785516,198185
2020-07-01,Maine,1117659,703421,644234,59187
2020-07-01,Maryland,4772159,3192506,2912281,280225
2020-07-01,Massachusetts,5647519,3610552,3245622,364930
2020-07-01,Michigan,7992512,4863144,4399099,464045
2020-07-01,Minnesota,4448291,3163899,2924632,239267
2020-07-01,Mississippi,2285425,1262877,1141793,121084
2020-07-01,Missouri,4834175,3140441,2911640,228801
2020-07-01,Montana,861803,552688,518212,34476
2020-07-01,Nebraska,1486531,1042865,993465,49400
2020-07-01,Nevada,2481749,1514424,1259461,254963
2020-07-01,Ohio,9254910,5803597,5251666,551931
2020-07-01,Oklahoma,3052681,1851561,1716523,135038
2020-07-01,Oregon,3440819,2054752,1850232,204520
2020-07-01,Pennsylvania,10273917,6516443,5636892,879551
2020-07-01,Tennessee,5438126,3184398,2885677,298721
2020-07-01,Texas,22296608,14010729,12661727,1349002
2020-07-01,Utah,2401050,1648720,1557671,91049
2020-07-01,Vermont,518664,330100,308166,21934
2020-07-01,Virginia,6724104,4363071,4008977,354094
2020-07-01,Washington,6100875,3931051,3511590,419461
2020-07-01,Wisconsin,4654069,3090324,2865901,224423
2020-07-01,Wyoming,454334,301260,280920,20340
2020-08-01,Alabama,3882472,2234629,2071310,163319
2020-08-01,Alaska,545315,339540,318567,20973
2020-08-01,Arizona,5875190,3518126,3268167,249959
2020-08-01,Arkansas,2359375,1347895,1263284,84611
2020-08-01,California,31074765,18690463,16390576,2299887
2020-08-01,Colorado,4616798,3125930,2906414,219516
2020-08-01,Connecticut,2882475,1854836,1699996,154840
2020-08-01,Delaware,791842,490448,452673,37775
2020-08-01,Florida,17669527,10003284,9199472,803812
2020-08-01,Georgia,8306713,4930238,4586724,343514
2020-08-01,Hawaii,1085305,645049,553894,91155
2020-08-01,Idaho,1410666,891663,852897,38766
2020-08-01,Illinois,9951889,6275238,5585136,690102
2020-08-01,Indiana,5275194,3339458,3100568,238890
2020-08-01,Iowa,2479628,1631247,1551737,79510
2020-08-01,Kansas,2234666,1508539,1412266,96273
2020-08-01,Kentucky,3507887,1976599,1873709,102890
2020-08-01,Louisiana,3579331,2101254,1927224,174030
2020-08-01,Maine,1118255,684574,655020,29554
2020-08-01,Maryland,4772659,3176646,2907797,268849
2020-08-01,Massachusetts,5647588,3664525,3329529,334996
2020-08-01,Michigan,7993400,4883260,4478590,404670
2020-08-01,Minnesota,4450313,3126078,2930139,195939
2020-08-01,Mississippi,2285698,1255536,1158662,96874
2020-08-01,Missouri,4836296,3093781,2906319,187462
2020-08-01,Montana,862714,547995,519460,28535
2020-08-01,Nebraska,1487267,1031473,991691,39782
2020-08-01,Nevada,2485827,1523321,1304022,219299
2020-08-01,Ohio,9256696,5850096,5344548,505548
2020-08-01,Oklahoma,3054823,1851733,1738748,112985
2020-08-01,Oregon,3443733,2110616,1934457,176159
2020-08-01,Pennsylvania,10274843,6307843,5661445,646398
2020-08-01,Tennessee,5443591,3371004,3108976,262028
2020-08-01,Texas,22327142,14090773,13117102,973671
2020-08-01,Utah,2405329,1646330,1567692,78638
2020-08-01,Vermont,518754,325514,309087,16427
2020-08-01,Virginia,6727072,4401474,4089333,312141
2020-08-01,Washington,6107080,3886399,3551328,335071
2020-08-01,Wisconsin,4656094,3079474,2900177,179297
2020-08-01,Wyoming,454672,299955,282294,17661
2020-09-01,Alabama,3884533,2213645,2062355,151290
2020-09-01,Alaska,545254,335688,313747,21941
2020-09-01,Arizona,5887367,3557313,3307908,249405
2020-09-01,Arkansas,2360906,1340180,1262240,77940
2020-09-01,California,31081669,18494445,16561306,1933139
2020-09-01,Colorado,4622504,3152249,2938420,213829
2020-09-01,Connecticut,2882419,1843886,1693409,150477
2020-09-01,Delaware,792821,485471,449883,35588
2020-09-01,Florida,17689159,10109604,9369011,740593
2020-09-01,Georgia,8315078,4933424,4617907,315517
2020-09-01,Hawaii,1084946,608565,515497,93068
2020-09-01,Idaho,1414009,907941,857557,50384
2020-09-01,Illinois,9949614,6358334,5718145,640189
2020-09-01,Indiana,5277977,3321153,3120818,200335
2020-09-01,Iowa,2480410,1635725,1566661,69064
2020-09-01,Kansas,2235531,1471196,1385010,86186
2020-09-01,Kentucky,3509267,1970842,1868711,102131
2020-09-01,Louisiana,3579467,2090267,1919425,170842
2020-09-01,Maine,1118905,664210,637528,26682
2020-09-01,Maryland,4773360,3004854,2798849,206005
2020-09-01,Massachusetts,5647956,3641540,3316505,325035
2020-09-01,Michigan,7994613,4851512,4473033,378479
2020-09-01,Minnesota,4452562,3084862,2915086,169776
2020-09-01,Mississippi,2286039,1262195,1173420,88775
2020-09-01,Missouri,4838656,3067041,2919068,147973
2020-09-01,Montana,863704,540272,515783,24489
2020-09-01,Nebraska,1488070,1023637,985771,37866
2020-09-01,Nevada,2489990,1539088,1338377,200711
2020-09-01,Ohio,9258910,5669149,5255488,413661
2020-09-01,Oklahoma,3057131,1864238,1760992,103246
2020-09-01,Oregon,3446867,2116300,1960926,155374
2020-09-01,Pennsylvania,10276251,6331317,5887095,444222
2020-09-01,Tennessee,5449301,3379104,3122941,256163
2020-09-01,Texas,22358893,13993842,12877405,1116437
2020-09-01,Utah,2409740,1641771,1575555,66216
2020-09-01,Vermont,518848,318926,304664,14262
2020-09-01,Virginia,6730369,4289848,4013155,276693
2020-09-01,Washington,6113541,3869556,3576232,293324
2020-09-01,Wisconsin,4658297,3129027,2975309,153718
2020-09-01,Wyoming,454998,298662,282342,16320
2020-10-01,Alabama,3886383,2262819,2164672,98147
2020-10-01,Alaska,545223,352525,331732,20793
2020-10-01,Arizona,5899190,3549866,3323443,226423
2020-10-01,Arkansas,2362323,1330274,1266366,63908
2020-10-01,California,31086721,18887681,17129910,1757771
2020-10-01,Colorado,4627942,3161607,2954121,207486
2020-10-01,Connecticut,2882202,1841877,1700050,141827
2020-10-01,Delaware,793770,480007,455401,24606
2020-10-01,Florida,17707888,10047839,9482796,565043
2020-10-01,Georgia,8323051,5115883,4837381,278502
2020-10-01,Hawaii,1084522,638773,549121,89652
2020-10-01,Idaho,1417281,903354,865131,38223
2020-10-01,Illinois,9946882,6324429,5849963,474466
2020-10-01,Indiana,5280606,3342611,3171011,171600
2020-10-01,Iowa,2481099,1635569,1579888,55681
2020-10-01,Kansas,2236251,1506390,1444313,62077
2020-10-01,Kentucky,3510534,1974175,1877876,96299
2020-10-01,Louisiana,3579445,2092397,1936242,156155
2020-10-01,Maine,1119531,669384,641264,28120
2020-10-01,Maryland,4773863,3115204,2913853,201351
2020-10-01,Massachusetts,5648070,3675919,3379524,296395
2020-10-01,Michigan,7995545,4853635,4503003,350632
2020-10-01,Minnesota,4454624,3064787,2925123,139664
2020-10-01,Mississippi,2286309,1257756,1180146,77610
2020-10-01,Missouri,4840816,3059501,2936805,122696
2020-10-01,Montana,864626,535846,513849,21997
2020-10-01,Nebraska,1488824,1026253,993688,32565
2020-10-01,Nevada,2494084,1545346,1366046,179300
2020-10-01,Ohio,9260740,5707208,5425162,282046
2020-10-01,Oklahoma,3059281,1863676,1772282,91394
2020-10-01,Oregon,3449790,2128309,1990326,137983
2020-10-01,Pennsylvania,10277210,6316802,5913407,403395
2020-10-01,Tennessee,5454779,3405856,3152327,253529
2020-10-01,Texas,22389388,14186427,13210371,976056
2020-10-01,Utah,2414062,1637265,1581811,55454
2020-10-01,Vermont,518954,317381,308301,9080
2020-10-01,Virginia,6733361,4279784,4036177,243607
2020-10-01,Washington,6119759,3978552,3728326,250226
2020-10-01,Wisconsin,4660353,3055281,2924417,130864
2020-10-01,Wyoming,455331,294677,281723,12954
2020-11-01,Alabama,3887946,2260941,2174298,86643
2020-11-01,Alaska,545133,351025,329027,21998
2020-11-01,Arizona,5910601,3575128,3346025,229103
2020-11-01,Arkansas,2363579,1327638,1264353,63285
2020-11-01,California,31090632,18667576,17123477,1544099
2020-11-01,Colorado,4633108,3173505,2960915,212590
2020-11-01,Connecticut,2881741,1846074,1707231,138843
2020-11-01,Delaware,794630,481657,456901,24756
2020-11-01,Florida,17725160,9999225,9499655,499570
2020-11-01,Georgia,8330547,5138700,4865300,273400
2020-11-01,Hawaii,1084113,658233,589870,68363
2020-11-01,Idaho,1420432,902015,864644,37371
2020-11-01,Illinois,9943419,6169598,5703670,465928
2020-11-01,Indiana,5282747,3342762,3181688,161074
2020-11-01,Iowa,2481531,1633755,1574014,59741
2020-11-01,Kansas,2236775,1515460,1452175,63285
2020-11-01,Kentucky,3511462,1993966,1893138,100828
2020-11-01,Louisiana,3579170,2098192,1944617,153575
2020-11-01,Maine,1120025,663691,632734,30957
2020-11-01,Maryland,4774038,3120857,2914268,206589
2020-11-01,Massachusetts,5647713,3699806,3416319,283487
2020-11-01,Michigan,7995779,4862903,4503176,359727
2020-11-01,Minnesota,4456287,3053209,2921482,131727
2020-11-01,Mississippi,2286424,1272847,1193100,79747
2020-11-01,Missouri,4842526,3055824,2928058,127766
2020-11-01,Montana,865491,532562,509738,22824
2020-11-01,Nebraska,1489408,1023234,993381,29853
2020-11-01,Nevada,2498025,1513547,1387099,126448
2020-11-01,Ohio,9261688,5719557,5440729,278828
2020-11-01,Oklahoma,3061177,1872237,1784026,88211
2020-11-01,Oregon,3452417,2133389,2003430,129959
2020-11-01,Pennsylvania,10277120,6303477,5895259,408218
2020-11-01,Tennessee,5459887,3330759,3159432,171327
2020-11-01,Texas,22418959,14050100,13076638,973462
2020-11-01,Utah,2418202,1643253,1591263,51990
2020-11-01,Vermont,518950,316915,306647,10268
2020-11-01,Virginia,6735886,4258549,4025109,233440
2020-11-01,Washington,6125522,3857075,3607396,249679
2020-11-01,Wisconsin,4661965,3059093,2933495,125598
2020-11-01,Wyoming,455610,294827,280589,14238
2020-12-01,Alabama,3889304,2240352,2161600,78752
2020-12-01,Alaska,545002,350219,327187,23032
2020-12-01,Arizona,5921658,3566534,3326990,239544
2020-12-01,Arkansas,2364696,1366653,1302339,64314
2020-12-01,California,31092761,18660835,16958587,1702248
2020-12-01,Colorado,4638089,3172790,2952986,219804
2020-12-01,Connecticut,2881139,1831338,1690364,140974
2020-12-01,Delaware,795439,482293,454496,27797
2020-12-01,Florida,17741498,9968835,9549248,419587
2020-12-01,Georgia,8337625,5139816,4849950,289866
2020-12-01,Hawaii,1083643,648758,588280,60478
2020-12-01,Idaho,1423536,899652,863582,36070
2020-12-01,Illinois,9939435,6105476,5625639,479837
2020-12-01,Indiana,5284652,3321235,3175002,146233
2020-12-01,Iowa,2481817,1622138,1555858,66280
2020-12-01,Kansas,2237175,1508734,1445823,62911
2020-12-01,Kentucky,3512248,1983657,1875948,107709
2020-12-01,Louisiana,3578682,2083161,1931983,151178
2020-12-01,Maine,1120437,662097,627533,34564
2020-12-01,Maryland,4773973,3105593,2898733,206860
2020-12-01,Massachusetts,5647094,3694508,3423128,271380
2020-12-01,Michigan,7995651,4855603,4454669,400934
2020-12-01,Minnesota,4457728,3036842,2888299,148543
2020-12-01,Mississippi,2286392,1278959,1195258,83701
2020-12-01,Missouri,4844027,3055793,2913854,141939
2020-12-01,Montana,866314,524275,500363,23912
2020-12-01,Nebraska,1489954,1015391,984653,30738
2020-12-01,Nevada,2501811,1513944,1390460,123484
2020-12-01,Ohio,9262241,5684962,5384909,300053
2020-12-01,Oklahoma,3062909,1853534,1767845,85689
2020-12-01,Oregon,3454895,2127775,1996117,131658
2020-12-01,Pennsylvania,10276507,6255815,5825715,430100
2020-12-01,Tennessee,5464698,3324493,3138615,185878
2020-12-01,Texas,22447253,14139874,13191324,948550
2020-12-01,Utah,2422249,1629656,1580547,49109
2020-12-01,Vermont,518976,313167,302889,10278
2020-12-01,Virginia,6738044,4239603,3996096,243507
2020-12-01,Washington,6131010,3830175,3578538,251637
2020-12-01,Wisconsin,4663376,3038277,2915366,122911
2020-12-01,Wyoming,455877,292809,277297,15512
2021-01-01,Alabama,3890500,2228910,2138693,90217
2021-01-01,Alaska,544894,349096,324999,24097
2021-01-01,Arizona,5932506,3572898,3325993,246905
2021-01-01,Arkansas,2365706,1349496,1280577,68919
2021-01-01,California,31093847,18621937,16901741,1720196
2021-01-01,Colorado,4642794,3171425,2951964,219461
2021-01-01,Connecticut,2880415,1822982,1668819,154163
2021-01-01,Delaware,796235,487574,456283,31291
2021-01-01,Florida,17757100,10103656,9566819,536837
2021-01-01,Georgia,8344325,5111532,4855595,255937
2021-01-01,Hawaii,1083148,655563,590734,64829
2021-01-01,Idaho,1426574,898423,858532,39891
2021-01-01,Illinois,9935021,6091031,5576468,514563
2021-01-01,Indiana,5286270,3336057,3179450,156607
2021-01-01,Iowa,2482022,1627688,1549243,78445
2021-01-01,Kansas,2237486,1515813,1435055,80758
2021-01-01,Kentucky,3512884,1967353,1862821,104532
2021-01-01,Louisiana,3578075,2049594,1894136,155458
2021-01-01,Maine,1120850,664349,622075,42274
2021-01-01,Maryland,4773686,3078925,2883104,195821
2021-01-01,Massachusetts,5646187,3693899,3417222,276677
2021-01-01,Michigan,7995094,4712994,4424281,288713
2021-01-01,Minnesota,4458943,2983514,2833684,149830
2021-01-01,Mississippi,2286271,1260796,1182428,78368
2021-01-01,Missouri,4845259,3042652,2888662,153990
2021-01-01,Montana,867082,525782,499290,26492
2021-01-01,Nebraska,1490395,1012653,980465,32188
2021-01-01,Nevada,2505533,1529355,1400675,128680
2021-01-01,Ohio,9262261,5690274,5346811,343463
2021-01-01,Oklahoma,3064511,1864127,1769330,94797
2021-01-01,Oregon,3457167,2125111,1974964,150147
2021-01-01,Pennsylvania,10275393,6242716,5743316,499400
2021-01-01,Tennessee,5469230,3306225,3129163,177062
2021-01-01,Texas,22474687,14026650,13000673,1025977
2021-01-01,Utah,2426150,1641309,1584569,56740
2021-01-01,Vermont,518952,311722,300251,11471
2021-01-01,Virginia,6739873,4218059,3978432,239627
2021-01-01,Washington,6136163,3845838,3585589,260249
2021-01-01,Wisconsin,4664495,3032623,2895969,136654
2021-01-01,Wyoming,456106,294201,275907,18294
2021-02-01,Alabama,3891139,2228507,2145036,83471
2021-02-01,Alaska,544693,346580,322054,24526
2021-02-01,Arizona,5942577,3587824,3336465,251359
2021-02-01,Arkansas,2366377,1352184,1280321,71863
2021-02-01,California,31091641,19022842,17423332,1599510
2021-02-01,Colorado,4647075,3184146,2966783,217363
2021-02-01,Connecticut,2879316,1688949,1545830,143119
2021-02-01,Delaware,796901,489655,456977,32678
2021-02-01,Florida,17769891,10218694,9702840,515854
2021-02-01,Georgia,8350072,5152527,4924970,227557
2021-02-01,Hawaii,1082480,658036,601876,56160
2021-02-01,Idaho,1429397,896134,856720,39414
2021-02-01,Illinois,9929473,6097663,5622026,475637
2021-02-01,Indiana,5287355,3300855,3144768,156087
2021-02-01,Iowa,2481881,1644709,1569070,75639
2021-02-01,Kansas,2237550,1512427,1442668,69759
2021-02-01,Kentucky,3513075,1973763,1874296,99467
2021-02-01,Louisiana,3576989,2042105,1897761,144344
2021-02-01,Maine,1121094,666927,629497,37430
2021-02-01,Maryland,4772844,3082330,2895250,187080
2021-02-01,Massachusetts,5644665,3705760,3437578,268182
2021-02-01,Michigan,7993560,4644159,4405499,238660
2021-02-01,Minnesota,4459692,2996045,2857021,139024
2021-02-01,Mississippi,2285852,1268337,1190797,77540
2021-02-01,Missouri,4845885,3051484,2899732,151752
2021-02-01,Montana,867716,528872,503059,25813
2021-02-01,Nebraska,1490687,1017570,982236,35334
2021-02-01,Nevada,2508958,1553244,1427735,125509
2021-02-01,Ohio,9261248,5706385,5388084,318301
2021-02-01,Oklahoma,3065768,1863135,1767394,95741
2021-02-01,Oregon,3459073,2135655,1993309,142346
2021-02-01,Pennsylvania,10273015,6333338,5821090,512248
2021-02-01,Tennessee,5473138,3299505,3138192,161313
2021-02-01,Texas,22500029,14049170,12989548,1059622
2021-02-01,Utah,2429915,1640927,1582377,58550
2021-02-01,Vermont,518856,310194,300103,10091
2021-02-01,Virginia,6740927,4228227,4000520,227707
2021-02-01,Washington,6140754,3874686,3627370,247316
2021-02-01,Wisconsin,4665137,3056098,2908003,148095
2021-02-01,Wyoming,456315,295046,276009,19037
