ds,name,civ,labor,emp,unemp
1976-01-01,Alabama,2605000,1484555,1386023,98532
1976-01-01,Alaska,232000,160183,148820,11363
1976-01-01,Arizona,1621000,964120,865871,98249
1976-01-01,Arkansas,1536000,889044,824395,64649
1976-01-01,California,15621000,9774280,8875685,898595
1976-01-01,Colorado,1832000,1230966,1160104,70862
1976-01-01,Connecticut,2248000,1442847,1301974,140873
1976-01-01,Delaware,417000,261418,240543,20875
1976-01-01,Florida,6421000,3584876,3238460,346416
1976-01-01,Georgia,3522000,2244770,2056467,188303
1976-01-01,Hawaii,583000,407457,367586,39871
1976-01-01,Idaho,580000,365606,345182,20424
1976-01-01,Illinois,8127000,5123609,4786415,337194
1976-01-01,Indiana,3789000,2425346,2265849,159497
1976-01-01,Iowa,2066000,1329798,1272281,57517
1976-01-01,Kansas,1635000,1065059,1020396,44663
1976-01-01,Kentucky,2459000,1486550,1402625,83925
1976-01-01,Louisiana,2672000,1517348,1421440,95908
1976-01-01,Maine,764000,474371,433260,41111
1976-01-01,Maryland,2954000,1899337,1777055,122282
1976-01-01,Massachusetts,4194000,2717096,2432377,284719
1976-01-01,Michigan,6417000,3952851,3562759,390092
1976-01-01,Minnesota,2788000,1829382,1719817,109565
1976-01-01,Mississippi,1640000,963611,899280,64331
1976-01-01,Missouri,3464000,2094063,1969511,124552
1976-01-01,Montana,531000,332790,313402,19388
1976-01-01,Nebraska,1095000,711096,687431,23665
1976-01-01,Nevada,451000,321579,291933,29646
1976-01-01,Ohio,7701000,4754858,4368782,386076
1976-01-01,Oklahoma,1999000,1186198,1116824,69374
1976-01-01,Oregon,1716000,1078645,976450,102195
1976-01-01,Pennsylvania,8774000,5122733,4710510,412223
1976-01-01,Tennessee,3078000,1834194,1723616,110578
1976-01-01,Texas,8818000,5623303,5294695,328608
1976-01-01,Utah,824000,517325,487063,30262
1976-01-01,Vermont,339000,215575,196968,18607
1976-01-01,Virginia,3534000,2330159,2187531,142628
1976-01-01,Washington,2598000,1583070,1448543,134527
1976-01-01,Wisconsin,3245000,2128893,2005997,122896
1976-01-01,Wyoming,270000,176214,169014,7200
1976-02-01,Alabama,2610000,1483950,1385675,98275
1976-02-01,Alaska,234000,160022,148718,11304
1976-02-01,Arizona,1626000,963394,865215,98179
1976-02-01,Arkansas,1538000,888771,824008,64763
1976-02-01,California,15657000,9768885,8871553,897332
1976-02-01,Colorado,1837000,1230680,1160001,70679
1976-02-01,Connecticut,2251000,1442118,1301107,141011
1976-02-01,Delaware,418000,261325,240545,20780
1976-02-01,Florida,6437000,3583970,3237372,346598
1976-02-01,Georgia,3528000,2243779,2055366,188413
1976-02-01,Hawaii,585000,407385,367403,39982
1976-02-01,Idaho,582000,365295,344916,20379
1976-02-01,Illinois,8136000,5122237,4785460,336777
1976-02-01,Indiana,3793000,2424387,2264552,159835
1976-02-01,Iowa,2069000,1329511,1271866,57645
1976-02-01,Kansas,1637000,1064471,1019842,44629
1976-02-01,Kentucky,2465000,1486110,1402206,83904
1976-02-01,Louisiana,2678000,1516595,1421064,95531
1976-02-01,Maine,766000,474272,433173,41099
1976-02-01,Maryland,2958000,1898511,1776509,122002
1976-02-01,Massachusetts,4198000,2716261,2431016,285245
1976-02-01,Michigan,6424000,3951549,3560591,390958
1976-02-01,Minnesota,2793000,1828517,1719004,109513
1976-02-01,Mississippi,1644000,963333,899114,64219
1976-02-01,Missouri,3469000,2092849,1968522,124327
1976-02-01,Montana,532000,332686,313365,19321
1976-02-01,Nebraska,1096000,710770,687121,23649
1976-02-01,Nevada,454000,321323,291651,29672
1976-02-01,Ohio,7706000,4754964,4368157,386807
1976-02-01,Oklahoma,2003000,1185846,1116531,69315
1976-02-01,Oregon,1720000,1077762,975742,102020
1976-02-01,Pennsylvania,8780000,5122163,4709350,412813
1976-02-01,Tennessee,3084000,1832969,1722558,110411
1976-02-01,Texas,8844000,5619825,5291252,328573
1976-02-01,Utah,826000,516978,486695,30283
1976-02-01,Vermont,340000,215467,196846,18621
1976-02-01,Virginia,3543000,2329603,2187080,142523
1976-02-01,Washington,2604000,1581641,1447552,134089
1976-02-01,Wisconsin,3248000,2128026,2005096,122930
1976-02-01,Wyoming,271000,176014,168813,7201
1976-03-01,Alabama,2615000,1484241,1386793,97448
1976-03-01,Alaska,236000,160124,148935,11189
1976-03-01,Arizona,1631000,963556,865905,97651
1976-03-01,Arkansas,1539000,888557,823855,64702
1976-03-01,California,15694000,9768531,8875700,892831
1976-03-01,Colorado,1841000,1229907,1159916,69991
1976-03-01,Connecticut,2253000,1442585,1301919,140666
1976-03-01,Delaware,418000,261306,240523,20783
1976-03-01,Florida,6452000,3583894,3238803,345091
1976-03-01,Georgia,3534000,2244320,2056476,187844
1976-03-01,Hawaii,586000,407576,367608,39968
1976-03-01,Idaho,583000,365320,344962,20358
1976-03-01,Illinois,8146000,5123914,4787596,336318
1976-03-01,Indiana,3797000,2424005,2265615,158390
1976-03-01,Iowa,2072000,1329559,1272124,57435
1976-03-01,Kansas,1640000,1064641,1020044,44597
1976-03-01,Kentucky,2470000,1486259,1402586,83673
1976-03-01,Louisiana,2685000,1516489,1420882,95607
1976-03-01,Maine,767000,474440,433462,40978
1976-03-01,Maryland,2962000,1898022,1776482,121540
1976-03-01,Massachusetts,4201000,2715115,2430783,284332
1976-03-01,Michigan,6430000,3953694,3562811,390883
1976-03-01,Minnesota,2797000,1828605,1720108,108497
1976-03-01,Mississippi,1647000,963510,900093,63417
1976-03-01,Missouri,3473000,2093314,1969025,124289
1976-03-01,Montana,533000,332560,313352,19208
1976-03-01,Nebraska,1097000,710627,687236,23391
1976-03-01,Nevada,456000,321400,291820,29580
1976-03-01,Ohio,7711000,4755734,4369756,385978
1976-03-01,Oklahoma,2007000,1185640,1116631,69009
1976-03-01,Oregon,1724000,1076843,975675,101168
1976-03-01,Pennsylvania,8786000,5123224,4708719,414505
1976-03-01,Tennessee,3091000,1832485,1722558,109927
1976-03-01,Texas,8870000,5623418,5293477,329941
1976-03-01,Utah,828000,517186,486955,30231
1976-03-01,Vermont,341000,215624,196979,18645
1976-03-01,Virginia,3551000,2329408,2187833,141575
1976-03-01,Washington,2611000,1581050,1447484,133566
1976-03-01,Wisconsin,3252000,2127839,2005801,122038
1976-03-01,Wyoming,272000,176105,168932,7173
1976-04-01,Alabama,2620000,1487233,1390787,96446
1976-04-01,Alaska,237000,161033,149867,11166
1976-04-01,Arizona,1636000,966567,870141,96426
1976-04-01,Arkansas,1541000,888945,825015,63930
1976-04-01,California,15731000,9789023,8902662,886361
1976-04-01,Colorado,1846000,1229301,1160052,69249
1976-04-01,Connecticut,2255000,1446319,1307272,139047
1976-04-01,Delaware,419000,261570,240379,21191
1976-04-01,Florida,6468000,3586526,3246473,340053
1976-04-01,Georgia,3540000,2249492,2063590,185902
1976-04-01,Hawaii,588000,408192,368776,39416
1976-04-01,Idaho,585000,366582,346124,20458
1976-04-01,Illinois,8155000,5131695,4795335,336360
1976-04-01,Indiana,3801000,2426376,2273481,152895
1976-04-01,Iowa,2075000,1330950,1274556,56394
1976-04-01,Kansas,1642000,1067139,1022562,44577
1976-04-01,Kentucky,2475000,1488051,1404930,83121
1976-04-01,Louisiana,2692000,1519054,1422019,97035
1976-04-01,Maine,769000,475164,434471,40693
1976-04-01,Maryland,2966000,1900112,1778204,121908
1976-04-01,Massachusetts,4204000,2715481,2436049,279432
1976-04-01,Michigan,6436000,3963423,3576236,387187
1976-04-01,Minnesota,2802000,1832231,1726077,106154
1976-04-01,Mississippi,1650000,964902,903082,61820
1976-04-01,Missouri,3477000,2099444,1973947,125497
1976-04-01,Montana,534000,332503,313343,19160
1976-04-01,Nebraska,1098000,711432,688636,22796
1976-04-01,Nevada,458000,322625,293430,29195
1976-04-01,Ohio,7716000,4755492,4375662,379830
1976-04-01,Oklahoma,2011000,1186430,1118154,68276
1976-04-01,Oregon,1728000,1078204,978506,99698
1976-04-01,Pennsylvania,8792000,5126833,4710603,416230
1976-04-01,Tennessee,3097000,1835764,1726382,109382
1976-04-01,Texas,8896000,5646313,5312877,333436
1976-04-01,Utah,830000,519054,489107,29947
1976-04-01,Vermont,341000,216413,197785,18628
1976-04-01,Virginia,3559000,2330733,2191295,139438
1976-04-01,Washington,2617000,1585515,1451387,134128
1976-04-01,Wisconsin,3256000,2130436,2011006,119430
1976-04-01,Wyoming,273000,177119,170037,7082
1976-05-01,Alabama,2626000,1491392,1395320,96072
1976-05-01,Alaska,239000,162338,151056,11282
1976-05-01,Arizona,1642000,971080,875687,95393
1976-05-01,Arkansas,1542000,889913,827062,62851
1976-05-01,California,15768000,9821255,8938559,882696
1976-05-01,Colorado,1850000,1229470,1160471,68999
1976-05-01,Connecticut,2257000,1451616,1314537,137079
1976-05-01,Delaware,420000,262016,240214,21802
1976-05-01,Florida,6483000,3591097,3256638,334459
1976-05-01,Georgia,3547000,2256660,2073036,183624
1976-05-01,Hawaii,590000,408933,370291,38642
1976-05-01,Idaho,587000,368506,347899,20607
1976-05-01,Illinois,8164000,5141790,4804374,337416
1976-05-01,Indiana,3806000,2431160,2284630,146530
1976-05-01,Iowa,2078000,1332994,1277930,55064
1976-05-01,Kansas,1644000,1070872,1026320,44552
1976-05-01,Kentucky,2480000,1490599,1408137,82462
1976-05-01,Louisiana,2699000,1523344,1424086,99258
1976-05-01,Maine,771000,476012,435612,40400
1976-05-01,Maryland,2971000,1904080,1781196,122884
1976-05-01,Massachusetts,4207000,2718111,2444886,273225
1976-05-01,Michigan,6442000,3975642,3594264,381378
1976-05-01,Minnesota,2806000,1837908,1733886,104022
1976-05-01,Mississippi,1653000,966754,906282,60472
1976-05-01,Missouri,3481000,2108332,1981037,127295
1976-05-01,Montana,535000,332602,313383,19219
1976-05-01,Nebraska,1100000,712943,690704,22239
1976-05-01,Nevada,460000,324425,295681,28744
1976-05-01,Ohio,7721000,4754562,4382938,371624
1976-05-01,Oklahoma,2015000,1187895,1120284,67611
1976-05-01,Oregon,1732000,1081658,983065,98593
1976-05-01,Pennsylvania,8798000,5130966,4715133,415833
1976-05-01,Tennessee,3103000,1841933,1732735,109198
1976-05-01,Texas,8922000,5676963,5339976,336987
1976-05-01,Utah,833000,521698,492102,29596
1976-05-01,Vermont,342000,217411,198845,18566
1976-05-01,Virginia,3567000,2333352,2195739,137613
1976-05-01,Washington,2623000,1593274,1457626,135648
1976-05-01,Wisconsin,3260000,2134954,2018302,116652
1976-05-01,Wyoming,274000,178560,171583,6977
1976-06-01,Alabama,2631000,1496160,1399430,96730
1976-06-01,Alaska,240000,163908,152324,11584
1976-06-01,Arizona,1647000,976461,881602,94859
1976-06-01,Arkansas,1544000,891434,829833,61601
1976-06-01,California,15804000,9861887,8977255,884632
1976-06-01,Colorado,1855000,1231223,1161704,69519
1976-06-01,Connecticut,2259000,1457006,1322011,134995
1976-06-01,Delaware,420000,262640,240155,22485
1976-06-01,Florida,6499000,3597210,3267451,329759
1976-06-01,Georgia,3553000,2265027,2083290,181737
1976-06-01,Hawaii,591000,409662,371836,37826
1976-06-01,Idaho,588000,370833,350070,20763
1976-06-01,Illinois,8174000,5151113,4812220,338893
1976-06-01,Indiana,3810000,2438240,2296745,141495
1976-06-01,Iowa,2081000,1335252,1281456,53796
1976-06-01,Kansas,1647000,1075261,1030858,44403
1976-06-01,Kentucky,2485000,1493134,1411443,81691
1976-06-01,Louisiana,2705000,1528892,1427096,101796
1976-06-01,Maine,772000,476725,436500,40225
1976-06-01,Maryland,2975000,1909635,1785402,124233
1976-06-01,Massachusetts,4210000,2723768,2456971,266797
1976-06-01,Michigan,6448000,3987683,3613034,374649
1976-06-01,Minnesota,2811000,1845509,1742473,103036
1976-06-01,Mississippi,1656000,968797,908939,59858
1976-06-01,Missouri,3485000,2118778,1989320,129458
1976-06-01,Montana,536000,333040,313675,19365
1976-06-01,Nebraska,1101000,715081,693197,21884
1976-06-01,Nevada,462000,326591,298204,28387
1976-06-01,Ohio,7726000,4753211,4389731,363480
1976-06-01,Oklahoma,2019000,1189831,1122849,66982
1976-06-01,Oregon,1736000,1087580,989181,98399
1976-06-01,Pennsylvania,8804000,5135162,4722519,412643
1976-06-01,Tennessee,3110000,1850737,1740968,109769
1976-06-01,Texas,8948000,5708574,5369891,338683
1976-06-01,Utah,835000,524656,495414,29242
1976-06-01,Vermont,342000,218340,199914,18426
1976-06-01,Virginia,3575000,2337293,2200717,136576
1976-06-01,Washington,2630000,1604380,1466236,138144
1976-06-01,Wisconsin,3263000,2141170,2026605,114565
1976-06-01,Wyoming,275000,180143,173267,6876
1976-07-01,Alabama,2636000,1500730,1402364,98366
1976-07-01,Alaska,242000,165368,153282,12086
1976-07-01,Arizona,1652000,981975,887162,94813
1976-07-01,Arkansas,1545000,893053,832622,60431
1976-07-01,California,15841000,9903604,9010377,893227
1976-07-01,Colorado,1859000,1234684,1163541,71143
1976-07-01,Connecticut,2261000,1460635,1327624,133011
1976-07-01,Delaware,421000,263315,240211,23104
1976-07-01,Florida,6514000,3602782,3275577,327205
1976-07-01,Georgia,3559000,2273239,2092242,180997
1976-07-01,Hawaii,593000,410102,373058,37044
1976-07-01,Idaho,590000,373107,352181,20926
1976-07-01,Illinois,8183000,5156594,4816599,339995
1976-07-01,Indiana,3814000,2445243,2306108,139135
1976-07-01,Iowa,2084000,1337276,1284353,52923
1976-07-01,Kansas,1649000,1079247,1035054,44193
1976-07-01,Kentucky,2490000,1494780,1413722,81058
1976-07-01,Louisiana,2712000,1534267,1430273,103994
1976-07-01,Maine,774000,477095,436790,40305
1976-07-01,Maryland,2979000,1915202,1789408,125794
1976-07-01,Massachusetts,4213000,2730674,2469470,261204
1976-07-01,Michigan,6454000,3996327,3627749,368578
1976-07-01,Minnesota,2815000,1853413,1749799,103614
1976-07-01,Mississippi,1659000,970764,910473,60291
1976-07-01,Missouri,3489000,2128622,1996806,131816
1976-07-01,Montana,537000,333822,314232,19590
1976-07-01,Nebraska,1102000,717323,695483,21840
1976-07-01,Nevada,464000,328735,300492,28243
1976-07-01,Ohio,7731000,4750580,4392879,357701
1976-07-01,Oklahoma,2023000,1191650,1125315,66335
1976-07-01,Oregon,1740000,1094956,995571,99385
1976-07-01,Pennsylvania,8810000,5138310,4729977,408333
1976-07-01,Tennessee,3116000,1860137,1748920,111217
1976-07-01,Texas,8974000,5732915,5395557,337358
1976-07-01,Utah,837000,527210,498273,28937
1976-07-01,Vermont,343000,218925,200721,18204
1976-07-01,Virginia,3583000,2341316,2205025,136291
1976-07-01,Washington,2636000,1617348,1475933,141415
1976-07-01,Wisconsin,3267000,2147574,2033622,113952
1976-07-01,Wyoming,276000,181523,174732,6791
1976-08-01,Alabama,2641000,1505121,1404636,100485
1976-08-01,Alaska,243000,166416,153715,12701
1976-08-01,Arizona,1658000,987541,892485,95056
1976-08-01,Arkansas,1548000,894755,835190,59565
1976-08-01,California,15879000,9943383,9037097,906286
1976-08-01,Colorado,1865000,1239866,1166313,73553
1976-08-01,Connecticut,2263000,1461961,1330847,131114
1976-08-01,Delaware,422000,263947,240436,23511
1976-08-01,Florida,6532000,3607644,3280710,326934
1976-08-01,Georgia,3567000,2280846,2099313,181533
1976-08-01,Hawaii,594000,410357,373926,36431
1976-08-01,Idaho,592000,375109,354023,21086
1976-08-01,Illinois,8192000,5158806,4818730,340076
1976-08-01,Indiana,3819000,2450242,2311280,138962
1976-08-01,Iowa,2086000,1339651,1287034,52617
1976-08-01,Kansas,1651000,1082510,1038432,44078
1976-08-01,Kentucky,2494000,1495671,1415395,80276
1976-08-01,Louisiana,2718000,1538687,1433303,105384
1976-08-01,Maine,775000,477210,436562,40648
1976-08-01,Maryland,2984000,1919926,1792801,127125
1976-08-01,Massachusetts,4217000,2736966,2480126,256840
1976-08-01,Michigan,6462000,4001428,3637189,364239
1976-08-01,Minnesota,2819000,1860447,1755105,105342
1976-08-01,Mississippi,1662000,972756,911266,61490
1976-08-01,Missouri,3493000,2137004,2002746,134258
1976-08-01,Montana,538000,334898,315090,19808
1976-08-01,Nebraska,1103000,719393,697327,22066
1976-08-01,Nevada,466000,330696,302339,28357
1976-08-01,Ohio,7738000,4748526,4393870,354656
1976-08-01,Oklahoma,2027000,1193335,1127599,65736
1976-08-01,Oregon,1745000,1102501,1001472,101029
1976-08-01,Pennsylvania,8816000,5141829,4736852,404977
1976-08-01,Tennessee,3122000,1869160,1755915,113245
1976-08-01,Texas,8997000,5748413,5414486,333927
1976-08-01,Utah,840000,529123,500375,28748
1976-08-01,Vermont,344000,219150,201245,17905
1976-08-01,Virginia,3590000,2345276,2208979,136297
1976-08-01,Washington,2643000,1630362,1485599,144763
1976-08-01,Wisconsin,3272000,2153381,2038648,114733
1976-08-01,Wyoming,277000,182561,175824,6737
1976-09-01,Alabama,2645000,1509649,1407083,102566
1976-09-01,Alaska,243000,167180,153851,13329
1976-09-01,Arizona,1665000,993413,898289,95124
1976-09-01,Arkansas,1552000,896624,837593,59031
1976-09-01,California,15916000,9982133,9062648,919485
1976-09-01,Colorado,1870000,1246348,1170214,76134
1976-09-01,Connecticut,2265000,1461610,1332667,128943
1976-09-01,Delaware,422000,264516,240732,23784
1976-09-01,Florida,6549000,3611679,3284182,327497
1976-09-01,Georgia,3574000,2288373,2105436,182937
1976-09-01,Hawaii,596000,410704,374686,36018
1976-09-01,Idaho,594000,376968,355686,21282
1976-09-01,Illinois,8200000,5159507,4821126,338381
1976-09-01,Indiana,3823000,2452705,2312824,139881
1976-09-01,Iowa,2089000,1342976,1290218,52758
1976-09-01,Kansas,1653000,1085274,1041128,44146
1976-09-01,Kentucky,2499000,1496361,1417188,79173
1976-09-01,Louisiana,2723000,1542014,1436017,105997
1976-09-01,Maine,777000,477240,436065,41175
1976-09-01,Maryland,2988000,1923870,1795726,128144
1976-09-01,Massachusetts,4220000,2740809,2487985,252824
1976-09-01,Michigan,6470000,4005290,3643758,361532
1976-09-01,Minnesota,2823000,1866528,1759271,107257
1976-09-01,Mississippi,1665000,974831,912030,62801
1976-09-01,Missouri,3497000,2144329,2007558,136771
1976-09-01,Montana,539000,336167,316209,19958
1976-09-01,Nebraska,1104000,721181,698890,22291
1976-09-01,Nevada,469000,332594,303985,28609
1976-09-01,Ohio,7745000,4748258,4394507,353751
1976-09-01,Oklahoma,2030000,1195031,1129978,65053
1976-09-01,Oregon,1751000,1109625,1007029,102596
1976-09-01,Pennsylvania,8822000,5145831,4741596,404235
1976-09-01,Tennessee,3129000,1877764,1762321,115443
1976-09-01,Texas,9021000,5760462,5429512,330950
1976-09-01,Utah,842000,530674,501982,28692
1976-09-01,Vermont,345000,219230,201667,17563
1976-09-01,Virginia,3598000,2349043,2213245,135798
1976-09-01,Washington,2650000,1642767,1494839,147928
1976-09-01,Wisconsin,3276000,2157929,2042335,115594
1976-09-01,Wyoming,278000,183449,176702,6747
1976-10-01,Alabama,2650000,1514447,1409795,104652
1976-10-01,Alaska,244000,167790,153868,13922
1976-10-01,Arizona,1671000,999463,904453,95010
1976-10-01,Arkansas,1555000,898793,839863,58930
1976-10-01,California,15954000,10020044,9089492,930552
1976-10-01,Colorado,1876000,1253820,1175284,78536
1976-10-01,Connecticut,2267000,1460490,1333848,126642
1976-10-01,Delaware,423000,265109,241053,24056
1976-10-01,Florida,6567000,3615025,3286676,328349
1976-10-01,Georgia,3582000,2295743,2110772,184971
1976-10-01,Hawaii,597000,411303,375500,35803
1976-10-01,Idaho,595000,378803,357186,21617
1976-10-01,Illinois,8209000,5161172,4826180,334992
1976-10-01,Indiana,3828000,2452800,2311115,141685
1976-10-01,Iowa,2091000,1347410,1294102,53308
1976-10-01,Kansas,1655000,1087745,1043241,44504
1976-10-01,Kentucky,2503000,1497599,1419389,78210
1976-10-01,Louisiana,2729000,1544486,1438250,106236
1976-10-01,Maine,778000,477449,435542,41907
1976-10-01,Maryland,2993000,1927709,1798458,129251
1976-10-01,Massachusetts,4224000,2741315,2492084,249231
1976-10-01,Michigan,6477000,4010071,3649206,360865
1976-10-01,Minnesota,2827000,1871691,1762742,108949
1976-10-01,Mississippi,1667000,976863,912806,64057
1976-10-01,Missouri,3501000,2150638,2011493,139145
1976-10-01,Montana,540000,337644,317497,20147
1976-10-01,Nebraska,1105000,722709,700287,22422
1976-10-01,Nevada,471000,334508,305580,28928
1976-10-01,Ohio,7752000,4750895,4395543,355352
1976-10-01,Oklahoma,2034000,1197318,1132849,64469
1976-10-01,Oregon,1756000,1116143,1012091,104052
1976-10-01,Pennsylvania,8828000,5150807,4743684,407123
1976-10-01,Tennessee,3135000,1885881,1768008,117873
1976-10-01,Texas,9044000,5772866,5442664,330202
1976-10-01,Utah,845000,532107,503267,28840
1976-10-01,Vermont,345000,219366,202110,17256
1976-10-01,Virginia,3605000,2352889,2217915,134974
1976-10-01,Washington,2657000,1653777,1502690,151087
1976-10-01,Wisconsin,3281000,2161240,2044855,116385
1976-10-01,Wyoming,279000,184315,177487,6828
1976-11-01,Alabama,2654000,1519811,1412921,106890
1976-11-01,Alaska,244000,168258,153794,14464
1976-11-01,Arizona,1678000,1005364,910597,94767
1976-11-01,Arkansas,1558000,901341,842135,59206
1976-11-01,California,15991000,10057937,9120389,937548
1976-11-01,Colorado,1881000,1261349,1180591,80758
1976-11-01,Connecticut,2270000,1459621,1335330,124291
1976-11-01,Delaware,424000,265836,241509,24327
1976-11-01,Florida,6584000,3618451,3289366,329085
1976-11-01,Georgia,3590000,2302597,2115728,186869
1976-11-01,Hawaii,599000,412145,376474,35671
1976-11-01,Idaho,597000,380682,358606,22076
1976-11-01,Illinois,8218000,5166453,4835787,330666
1976-11-01,Indiana,3833000,2451136,2307957,143179
1976-11-01,Iowa,2093000,1352912,1298854,54058
1976-11-01,Kansas,1658000,1090148,1045111,45037
1976-11-01,Kentucky,2507000,1500135,1422507,77628
1976-11-01,Louisiana,2734000,1546793,1440358,106435
1976-11-01,Maine,780000,477981,435208,42773
1976-11-01,Maryland,2997000,1931829,1801646,130183
1976-11-01,Massachusetts,4227000,2738644,2492649,245995
1976-11-01,Michigan,6485000,4017008,3655726,361282
1976-11-01,Minnesota,2831000,1876237,1766050,110187
1976-11-01,Mississippi,1670000,978822,913557,65265
1976-11-01,Missouri,3505000,2155782,2015230,140552
1976-11-01,Montana,542000,339163,318803,20360
1976-11-01,Nebraska,1106000,724199,701693,22506
1976-11-01,Nevada,474000,336491,307303,29188
1976-11-01,Ohio,7759000,4756815,4399284,357531
1976-11-01,Oklahoma,2038000,1200617,1136665,63952
1976-11-01,Oregon,1761000,1121842,1016783,105059
1976-11-01,Pennsylvania,8835000,5157677,4744837,412840
1976-11-01,Tennessee,3142000,1894081,1773459,120622
1976-11-01,Texas,9067000,5788621,5456390,332231
1976-11-01,Utah,847000,533597,504477,29120
1976-11-01,Vermont,346000,219725,202700,17025
1976-11-01,Virginia,3612000,2357368,2223244,134124
1976-11-01,Washington,2664000,1662926,1508919,154007
1976-11-01,Wisconsin,3286000,2164150,2046725,117425
1976-11-01,Wyoming,280000,185232,178305,6927
1976-12-01,Alabama,2659000,1525827,1416558,109269
1976-12-01,Alaska,245000,168729,153764,14965
1976-12-01,Arizona,1684000,1010968,916504,94464
1976-12-01,Arkansas,1561000,904128,844483,59645
1976-12-01,California,16029000,10096320,9157978,938342
1976-12-01,Colorado,1887000,1267965,1185243,82722
1976-12-01,Connecticut,2272000,1460013,1338214,121799
1976-12-01,Delaware,424000,266789,242278,24511
1976-12-01,Florida,6602000,3623116,3294008,329108
1976-12-01,Georgia,3597000,2308443,2120947,187496
1976-12-01,Hawaii,600000,413102,377652,35450
1976-12-01,Idaho,599000,382595,360070,22525
1976-12-01,Illinois,8226000,5176898,4851125,325773
1976-12-01,Indiana,3837000,2449493,2305881,143612
1976-12-01,Iowa,2095000,1359146,1304426,54720
1976-12-01,Kansas,1660000,1092638,1047167,45471
1976-12-01,Kentucky,2511000,1504306,1427009,77297
1976-12-01,Louisiana,2740000,1549828,1443275,106553
1976-12-01,Maine,781000,478753,435270,43483
1976-12-01,Maryland,3002000,1936427,1806057,130370
1976-12-01,Massachusetts,4231000,2734512,2491762,242750
1976-12-01,Michigan,6493000,4025914,3665132,360782
1976-12-01,Minnesota,2835000,1880772,1769888,110884
1976-12-01,Mississippi,1673000,980708,914229,66479
1976-12-01,Missouri,3509000,2159928,2019695,140233
1976-12-01,Montana,543000,340542,320032,20510
1976-12-01,Nebraska,1107000,725854,703293,22561
1976-12-01,Nevada,476000,338492,309309,29183
1976-12-01,Ohio,7766000,4765878,4408359,357519
1976-12-01,Oklahoma,2041000,1205019,1141451,63568
1976-12-01,Oregon,1766000,1126674,1021476,105198
1976-12-01,Pennsylvania,8841000,5165781,4747630,418151
1976-12-01,Tennessee,3148000,1902750,1779576,123174
1976-12-01,Texas,9091000,5808871,5473400,335471
1976-12-01,Utah,850000,535252,505850,29402
1976-12-01,Vermont,347000,220391,203518,16873
1976-12-01,Virginia,3620000,2362512,2229219,133293
1976-12-01,Washington,2671000,1670136,1513953,156183
1976-12-01,Wisconsin,3290000,2167060,2048919,118141
1976-12-01,Wyoming,281000,186275,179265,7010
1977-01-01,Alabama,2663000,1532500,1420756,111744
1977-01-01,Alaska,245000,169309,153861,15448
1977-01-01,Arizona,1690000,1016746,922388,94358
1977-01-01,Arkansas,1565000,907157,847017,60140
1977-01-01,California,16066000,10137699,9204162,933537
1977-01-01,Colorado,1892000,1273628,1189423,84205
1977-01-01,Connecticut,2274000,1462469,1343245,119224
1977-01-01,Delaware,425000,268020,243447,24573
1977-01-01,Florida,6619000,3630976,3302385,328591
1977-01-01,Georgia,3605000,2313375,2127069,186306
1977-01-01,Hawaii,601000,414171,379072,35099
1977-01-01,Idaho,601000,384586,361733,22853
1977-01-01,Illinois,8235000,5193912,4872374,321538
1977-01-01,Indiana,3842000,2450491,2307252,143239
1977-01-01,Iowa,2098000,1365628,1310500,55128
1977-01-01,Kansas,1662000,1095411,1049736,45675
1977-01-01,Kentucky,2516000,1510207,1433142,77065
1977-01-01,Louisiana,2745000,1554869,1448136,106733
1977-01-01,Maine,782000,479593,435759,43834
1977-01-01,Maryland,3006000,1942032,1812177,129855
1977-01-01,Massachusetts,4234000,2732019,2492531,239488
1977-01-01,Michigan,6501000,4037088,3678582,358506
1977-01-01,Minnesota,2839000,1886443,1775327,111116
1977-01-01,Mississippi,1676000,982678,914855,67823
1977-01-01,Missouri,3513000,2164323,2025636,138687
1977-01-01,Montana,544000,341955,321329,20626
1977-01-01,Nebraska,1108000,727894,705244,22650
1977-01-01,Nevada,478000,340562,311692,28870
1977-01-01,Ohio,7773000,4777884,4423399,354485
1977-01-01,Oklahoma,2045000,1210578,1146952,63626
1977-01-01,Oregon,1772000,1131002,1026636,104366
1977-01-01,Pennsylvania,8847000,5175278,4754499,420779
1977-01-01,Tennessee,3154000,1911947,1786806,125141
1977-01-01,Texas,9114000,5833413,5495729,337684
1977-01-01,Utah,852000,537210,507568,29642
1977-01-01,Vermont,348000,221382,204595,16787
1977-01-01,Virginia,3627000,2368354,2235660,132694
1977-01-01,Washington,2678000,1676060,1518686,157374
1977-01-01,Wisconsin,3295000,2170776,2052500,118276
1977-01-01,Wyoming,282000,187519,180462,7057
1977-02-01,Alabama,2668000,1539540,1425519,114021
1977-02-01,Alaska,246000,170059,154151,15908
1977-02-01,Arizona,1697000,1022718,928545,94173
1977-02-01,Arkansas,1568000,910425,849927,60498
1977-02-01,California,16104000,10181250,9257576,923674
1977-02-01,Colorado,1898000,1278608,1193757,84851
1977-02-01,Connecticut,2276000,1466408,1350005,116403
1977-02-01,Delaware,426000,269382,244907,24475
1977-02-01,Florida,6637000,3642388,3315211,327177
1977-02-01,Georgia,3613000,2317034,2134005,183029
1977-02-01,Hawaii,603000,415302,380690,34612
1977-02-01,Idaho,603000,386665,363639,23026
1977-02-01,Illinois,8244000,5215337,4896698,318639
1977-02-01,Indiana,3847000,2455009,2312464,142545
1977-02-01,Iowa,2100000,1371494,1316273,55221
1977-02-01,Kansas,1664000,1098464,1052872,45592
1977-02-01,Kentucky,2520000,1516976,1440433,76543
1977-02-01,Louisiana,2751000,1562347,1455407,106940
1977-02-01,Maine,784000,480268,436515,43753
1977-02-01,Maryland,3011000,1948097,1819543,128554
1977-02-01,Massachusetts,4238000,2732682,2496933,235749
1977-02-01,Michigan,6508000,4049764,3695690,354074
1977-02-01,Minnesota,2844000,1893882,1783150,110732
1977-02-01,Mississippi,1678000,984737,915568,69169
1977-02-01,Missouri,3517000,2169804,2033162,136642
1977-02-01,Montana,545000,343335,322604,20731
1977-02-01,Nebraska,1110000,730301,707462,22839
1977-02-01,Nevada,481000,342693,314431,28262
1977-02-01,Ohio,7781000,4791267,4442618,348649
1977-02-01,Oklahoma,2049000,1216872,1152915,63957
1977-02-01,Oregon,1777000,1135050,1032866,102184
1977-02-01,Pennsylvania,8853000,5185328,4765769,419559
1977-02-01,Tennessee,3161000,1920544,1794397,126147
1977-02-01,Texas,9137000,5859779,5522799,336980
1977-02-01,Utah,855000,539394,509639,29755
1977-02-01,Vermont,348000,222546,205845,16701
1977-02-01,Virginia,3634000,2374567,2242210,132357
1977-02-01,Washington,2685000,1681207,1523951,157256
1977-02-01,Wisconsin,3300000,2174998,2057551,117447
1977-02-01,Wyoming,284000,188943,181908,7035
1977-03-01,Alabama,2673000,1546469,1430705,115764
1977-03-01,Alaska,246000,170890,154549,16341
1977-03-01,Arizona,1703000,1028518,934873,93645
1977-03-01,Arkansas,1571000,913766,853232,60534
1977-03-01,California,16142000,10224344,9314250,910094
1977-03-01,Colorado,1904000,1282540,1198006,84534
1977-03-01,Connecticut,2278000,1470575,1357309,113266
1977-03-01,Delaware,426000,270672,246509,24163
1977-03-01,Florida,6655000,3656369,3331918,324451
1977-03-01,Georgia,3620000,2319081,2141153,177928
1977-03-01,Hawaii,604000,416181,382290,33891
1977-03-01,Idaho,605000,388697,365573,23124
1977-03-01,Illinois,8252000,5236698,4919338,317360
1977-03-01,Indiana,3851000,2461767,2319985,141782
1977-03-01,Iowa,2102000,1375874,1320614,55260
1977-03-01,Kansas,1666000,1101440,1056231,45209
1977-03-01,Kentucky,2524000,1523209,1447618,75591
1977-03-01,Louisiana,2757000,1571507,1464623,106884
1977-03-01,Maine,785000,480628,437337,43291
1977-03-01,Maryland,3015000,1953439,1826939,126500
1977-03-01,Massachusetts,4242000,2736364,2505037,231327
1977-03-01,Michigan,6516000,4062586,3714184,348402
1977-03-01,Minnesota,2848000,1902622,1792903,109719
1977-03-01,Mississippi,1681000,986812,916432,70380
1977-03-01,Missouri,3521000,2176482,2041608,134874
1977-03-01,Montana,546000,344493,323681,20812
1977-03-01,Nebraska,1111000,732724,709613,23111
1977-03-01,Nevada,483000,344696,317304,27392
1977-03-01,Ohio,7788000,4803584,4463552,340032
1977-03-01,Oklahoma,2052000,1223069,1158992,64077
1977-03-01,Oregon,1782000,1138751,1040124,98627
1977-03-01,Pennsylvania,8859000,5194346,4779019,415327
1977-03-01,Tennessee,3167000,1926764,1800677,126087
1977-03-01,Texas,9161000,5883658,5551092,332566
1977-03-01,Utah,857000,541441,511738,29703
1977-03-01,Vermont,349000,223676,207118,16558
1977-03-01,Virginia,3642000,2380226,2248350,131876
1977-03-01,Washington,2692000,1685774,1529930,155844
1977-03-01,Wisconsin,3304000,2178663,2063288,115375
1977-03-01,Wyoming,285000,190383,183468,6915
1977-04-01,Alabama,2677000,1553113,1436379,116734
1977-04-01,Alaska,247000,171666,154963,16703
1977-04-01,Arizona,1710000,1034436,941652,92784
1977-04-01,Arkansas,1574000,917194,856933,60261
1977-04-01,California,16179000,10266363,9370903,895460
1977-04-01,Colorado,1909000,1285532,1202099,83433
1977-04-01,Connecticut,2280000,1474428,1364425,110003
1977-04-01,Delaware,427000,271739,248093,23646
1977-04-01,Florida,6672000,3672409,3351772,320637
1977-04-01,Georgia,3628000,2319954,2148119,171835
1977-04-01,Hawaii,606000,416555,383686,32869
1977-04-01,Idaho,606000,390737,367507,23230
1977-04-01,Illinois,8261000,5255900,4937963,317937
1977-04-01,Indiana,3856000,2469207,2327939,141268
1977-04-01,Iowa,2104000,1378683,1323236,55447
1977-04-01,Kansas,1668000,1104151,1059538,44613
1977-04-01,Kentucky,2528000,1528373,1453931,74442
1977-04-01,Louisiana,2762000,1581436,1474786,106650
1977-04-01,Maine,787000,480700,438142,42558
1977-04-01,Maryland,3020000,1957357,1833610,123747
1977-04-01,Massachusetts,4245000,2742178,2515558,226620
1977-04-01,Michigan,6524000,4075317,3732059,343258
1977-04-01,Minnesota,2852000,1911524,1803405,108119
1977-04-01,Mississippi,1684000,989123,917666,71457
1977-04-01,Missouri,3525000,2184265,2050468,133797
1977-04-01,Montana,547000,345729,324823,20906
1977-04-01,Nebraska,1112000,735037,711593,23444
1977-04-01,Nevada,486000,346504,320144,26360
1977-04-01,Ohio,7795000,4813786,4484384,329402
1977-04-01,Oklahoma,2056000,1228874,1165110,63764
1977-04-01,Oregon,1787000,1142148,1047965,94183
1977-04-01,Pennsylvania,8865000,5201972,4791748,410224
1977-04-01,Tennessee,3174000,1930531,1805495,125036
1977-04-01,Texas,9184000,5903231,5578003,325228
1977-04-01,Utah,860000,543176,513643,29533
1977-04-01,Vermont,350000,224714,208360,16354
1977-04-01,Virginia,3649000,2385076,2254172,130904
1977-04-01,Washington,2699000,1690618,1537243,153375
1977-04-01,Wisconsin,3309000,2181642,2068988,112654
1977-04-01,Wyoming,286000,191769,185068,6701
1977-05-01,Alabama,2682000,1559061,1442398,116663
1977-05-01,Alaska,247000,172323,155348,16975
1977-05-01,Arizona,1716000,1040390,948785,91605
1977-05-01,Arkansas,1578000,920623,860767,59856
1977-05-01,California,16217000,10307069,9425458,881611
1977-05-01,Colorado,1915000,1287908,1205911,81997
1977-05-01,Connecticut,2283000,1477942,1371085,106857
1977-05-01,Delaware,428000,272407,249412,22995
1977-05-01,Florida,6690000,3690082,3373835,316247
1977-05-01,Georgia,3636000,2320345,2154717,165628
1977-05-01,Hawaii,607000,416495,384774,31721
1977-05-01,Idaho,608000,392872,369495,23377
1977-05-01,Illinois,8270000,5272548,4952150,320398
1977-05-01,Indiana,3861000,2475611,2334498,141113
1977-05-01,Iowa,2107000,1380961,1325161,55800
1977-05-01,Kansas,1671000,1106593,1062605,43988
1977-05-01,Kentucky,2533000,1532490,1459179,73311
1977-05-01,Louisiana,2768000,1591139,1484511,106628
1977-05-01,Maine,788000,480593,438931,41662
1977-05-01,Maryland,3024000,1960090,1839333,120757
1977-05-01,Massachusetts,4249000,2748364,2526345,222019
1977-05-01,Michigan,6532000,4088157,3748837,339320
1977-05-01,Minnesota,2856000,1919054,1812949,106105
1977-05-01,Mississippi,1687000,991558,919212,72346
1977-05-01,Missouri,3529000,2192597,2059251,133346
1977-05-01,Montana,549000,347120,326055,21065
1977-05-01,Nebraska,1113000,737203,713338,23865
1977-05-01,Nevada,488000,348097,322831,25266
1977-05-01,Ohio,7802000,4822173,4503693,318480
1977-05-01,Oklahoma,2060000,1234100,1171064,63036
1977-05-01,Oregon,1793000,1145299,1055777,89522
1977-05-01,Pennsylvania,8872000,5208228,4802426,405802
1977-05-01,Tennessee,3180000,1932920,1809761,123159
1977-05-01,Texas,9207000,5920374,5602796,317578
1977-05-01,Utah,862000,544493,515225,29268
1977-05-01,Vermont,351000,225736,209609,16127
1977-05-01,Virginia,3656000,2389632,2259989,129643
1977-05-01,Washington,2706000,1696005,1545973,150032
1977-05-01,Wisconsin,3314000,2183858,2073669,110189
1977-05-01,Wyoming,287000,193094,186652,6442
1977-06-01,Alabama,2686000,1564005,1448414,115591
1977-06-01,Alaska,248000,172866,155694,17172
1977-06-01,Arizona,1723000,1045877,955723,90154
1977-06-01,Arkansas,1581000,924098,864595,59503
1977-06-01,California,16254000,10347934,9478129,869805
1977-06-01,Colorado,1920000,1290471,1209567,80904
1977-06-01,Connecticut,2285000,1481616,1377539,104077
1977-06-01,Delaware,428000,272689,250353,22336
1977-06-01,Florida,6707000,3709261,3397435,311826
1977-06-01,Georgia,3643000,2321264,2160930,160334
1977-06-01,Hawaii,609000,416242,385472,30770
1977-06-01,Idaho,610000,395170,371613,23557
1977-06-01,Illinois,8278000,5286840,4962047,324793
1977-06-01,Indiana,3865000,2480736,2339464,141272
1977-06-01,Iowa,2109000,1383988,1327693,56295
1977-06-01,Kansas,1673000,1108792,1065321,43471
1977-06-01,Kentucky,2537000,1536153,1463773,72380
1977-06-01,Louisiana,2773000,1599923,1492891,107032
1977-06-01,Maine,790000,480498,439748,40750
1977-06-01,Maryland,3029000,1962771,1844443,118328
1977-06-01,Massachusetts,4252000,2753602,2535716,217886
1977-06-01,Michigan,6539000,4101573,3764233,337340
1977-06-01,Minnesota,2860000,1924225,1820361,103864
1977-06-01,Mississippi,1689000,993860,920837,73023
1977-06-01,Missouri,3533000,2201004,2067621,133383
1977-06-01,Montana,550000,348478,327195,21283
1977-06-01,Nebraska,1114000,739247,714793,24454
1977-06-01,Nevada,491000,349554,325371,24183
1977-06-01,Ohio,7809000,4830025,4521087,308938
1977-06-01,Oklahoma,2063000,1238796,1176898,61898
1977-06-01,Oregon,1798000,1148487,1063351,85136
1977-06-01,Pennsylvania,8878000,5213385,4810786,402599
1977-06-01,Tennessee,3187000,1935169,1814204,120965
1977-06-01,Texas,9231000,5938639,5625881,312758
1977-06-01,Utah,865000,545495,516537,28958
1977-06-01,Vermont,351000,226863,210937,15926
1977-06-01,Virginia,3664000,2395066,2266334,128732
1977-06-01,Washington,2713000,1701658,1555195,146463
1977-06-01,Wisconsin,3318000,2185243,2076817,108426
1977-06-01,Wyoming,288000,194364,188159,6205
1977-07-01,Alabama,2691000,1568040,1454342,113698
1977-07-01,Alaska,248000,173415,156153,17262
1977-07-01,Arizona,1729000,1050508,961989,88519
1977-07-01,Arkansas,1584000,927649,868342,59307
1977-07-01,California,16292000,10390933,9531197,859736
1977-07-01,Colorado,1926000,1293655,1213549,80106
1977-07-01,Connecticut,2287000,1486025,1384345,101680
1977-07-01,Delaware,429000,272803,251028,21775
1977-07-01,Florida,6725000,3729918,3422425,307493
1977-07-01,Georgia,3651000,2323878,2167460,156418
1977-07-01,Hawaii,610000,416163,385900,30263
1977-07-01,Idaho,612000,397793,374058,23735
1977-07-01,Illinois,8287000,5299007,4969329,329678
1977-07-01,Indiana,3870000,2485585,2343587,141998
1977-07-01,Iowa,2111000,1387630,1330982,56648
1977-07-01,Kansas,1675000,1111025,1068008,43017
1977-07-01,Kentucky,2541000,1539883,1468088,71795
1977-07-01,Louisiana,2779000,1607658,1499479,108179
1977-07-01,Maine,791000,480513,440598,39915
1977-07-01,Maryland,3033000,1966792,1850084,116708
1977-07-01,Massachusetts,4256000,2757404,2543243,214161
1977-07-01,Michigan,6547000,4115746,3778785,336961
1977-07-01,Minnesota,2864000,1927382,1825937,101445
1977-07-01,Mississippi,1692000,995889,922545,73344
1977-07-01,Missouri,3537000,2209179,2075998,133181
1977-07-01,Montana,551000,349793,328229,21564
1977-07-01,Nebraska,1115000,741323,716212,25111
1977-07-01,Nevada,493000,351062,327915,23147
1977-07-01,Ohio,7816000,4838588,4536628,301960
1977-07-01,Oklahoma,2067000,1243222,1182950,60272
1977-07-01,Oregon,1803000,1152320,1070796,81524
1977-07-01,Pennsylvania,8884000,5218043,4817772,400271
1977-07-01,Tennessee,3193000,1938850,1819567,119283
1977-07-01,Texas,9254000,5961078,5649079,311999
1977-07-01,Utah,867000,546531,517873,28658
1977-07-01,Vermont,352000,228192,212406,15786
1977-07-01,Virginia,3671000,2402257,2273625,128632
1977-07-01,Washington,2720000,1707122,1564389,142733
1977-07-01,Wisconsin,3323000,2186348,2079045,107303
1977-07-01,Wyoming,289000,195666,189613,6053
1977-08-01,Alabama,2696000,1571784,1460345,111439
1977-08-01,Alaska,249000,174145,156805,17340
1977-08-01,Arizona,1736000,1053908,967428,86480
1977-08-01,Arkansas,1587000,931105,871730,59375
1977-08-01,California,16333000,10437515,9586963,850552
1977-08-01,Colorado,1932000,1297942,1217890,80052
1977-08-01,Connecticut,2289000,1491184,1391618,99566
1977-08-01,Delaware,430000,272954,251623,21331
1977-08-01,Florida,6746000,3751640,3448538,303102
1977-08-01,Georgia,3658000,2328901,2175258,153643
1977-08-01,Hawaii,611000,416424,386240,30184
1977-08-01,Idaho,614000,400617,376819,23798
1977-08-01,Illinois,8294000,5310874,4977120,333754
1977-08-01,Indiana,3875000,2491619,2348162,143457
1977-08-01,Iowa,2113000,1391639,1335019,56620
1977-08-01,Kansas,1677000,1113387,1070976,42411
1977-08-01,Kentucky,2545000,1543990,1472004,71986
1977-08-01,Louisiana,2784000,1615027,1504683,110344
1977-08-01,Maine,792000,480626,441458,39168
1977-08-01,Maryland,3037000,1973027,1857159,115868
1977-08-01,Massachusetts,4260000,2760933,2550296,210637
1977-08-01,Michigan,6555000,4130542,3793723,336819
1977-08-01,Minnesota,2868000,1929732,1830733,98999
1977-08-01,Mississippi,1695000,997747,924346,73401
1977-08-01,Missouri,3541000,2216927,2084787,132140
1977-08-01,Montana,552000,351098,329241,21857
1977-08-01,Nebraska,1116000,743540,717818,25722
1977-08-01,Nevada,496000,352740,330606,22134
1977-08-01,Ohio,7823000,4847616,4550019,297597
1977-08-01,Oklahoma,2071000,1247472,1189503,57969
1977-08-01,Oregon,1808000,1157045,1078203,78842
1977-08-01,Pennsylvania,8889000,5222797,4824494,398303
1977-08-01,Tennessee,3198000,1944229,1825667,118562
1977-08-01,Texas,9278000,5988974,5674441,314533
1977-08-01,Utah,870000,547783,519495,28288
1977-08-01,Vermont,353000,229695,213977,15718
1977-08-01,Virginia,3679000,2410982,2281680,129302
1977-08-01,Washington,2729000,1712699,1573857,138842
1977-08-01,Wisconsin,3327000,2188409,2081321,107088
1977-08-01,Wyoming,290000,197016,191051,5965
1977-09-01,Alabama,2701000,1576145,1467013,109132
1977-09-01,Alaska,249000,175120,157589,17531
1977-09-01,Arizona,1743000,1056149,972116,84033
1977-09-01,Arkansas,1590000,933994,874376,59618
1977-09-01,California,16375000,10486367,9645317,841050
1977-09-01,Colorado,1938000,1303046,1222319,80727
1977-09-01,Connecticut,2292000,1496356,1398935,97421
1977-09-01,Delaware,430000,273216,252281,20935
1977-09-01,Florida,6767000,3774005,3475764,298241
1977-09-01,Georgia,3665000,2335763,2184698,151065
1977-09-01,Hawaii,612000,416900,386614,30286
1977-09-01,Idaho,616000,403297,379667,23630
1977-09-01,Illinois,8301000,5324424,4987757,336667
1977-09-01,Indiana,3881000,2499543,2354777,144766
1977-09-01,Iowa,2114000,1395638,1339473,56165
1977-09-01,Kansas,1679000,1115774,1074193,41581
1977-09-01,Kentucky,2548000,1548742,1475727,73015
1977-09-01,Louisiana,2789000,1622764,1509317,113447
1977-09-01,Maine,794000,480787,442397,38390
1977-09-01,Maryland,3041000,1980942,1865563,115379
1977-09-01,Massachusetts,4263000,2765044,2558216,206828
1977-09-01,Michigan,6562000,4144508,3809417,335091
1977-09-01,Minnesota,2872000,1932129,1835735,96394
1977-09-01,Mississippi,1697000,999702,926468,73234
1977-09-01,Missouri,3545000,2224195,2093817,130378
1977-09-01,Montana,554000,352340,330260,22080
1977-09-01,Nebraska,1117000,745768,719509,26259
1977-09-01,Nevada,499000,354609,333479,21130
1977-09-01,Ohio,7830000,4855454,4561572,293882
1977-09-01,Oklahoma,2075000,1251478,1196086,55392
1977-09-01,Oregon,1813000,1162221,1085607,76614
1977-09-01,Pennsylvania,8893000,5228259,4832146,396113
1977-09-01,Tennessee,3203000,1949574,1831288,118286
1977-09-01,Texas,9302000,6020049,5701720,318329
1977-09-01,Utah,872000,549286,521507,27779
1977-09-01,Vermont,353000,231200,215539,15661
1977-09-01,Virginia,3686000,2420280,2289959,130321
1977-09-01,Washington,2738000,1718677,1584096,134581
1977-09-01,Wisconsin,3330000,2192177,2084487,107690
1977-09-01,Wyoming,292000,198391,192487,5904
1977-10-01,Alabama,2705000,1581419,1474464,106955
1977-10-01,Alaska,250000,176221,158336,17885
1977-10-01,Arizona,1749000,1056975,975843,81132
1977-10-01,Arkansas,1592000,935888,876021,59867
1977-10-01,California,16416000,10534456,9703565,830891
1977-10-01,Colorado,1944000,1308068,1226587,81481
1977-10-01,Connecticut,2294000,1500513,1405569,94944
1977-10-01,Delaware,431000,273476,252930,20546
1977-10-01,Florida,6787000,3796283,3503644,292639
1977-10-01,Georgia,3672000,2342992,2195220,147772
1977-10-01,Hawaii,613000,417401,387011,30390
1977-10-01,Idaho,617000,405489,382255,23234
1977-10-01,Illinois,8308000,5339074,5000783,338291
1977-10-01,Indiana,3886000,2508606,2363304,145302
1977-10-01,Iowa,2116000,1398887,1343411,55476
1977-10-01,Kansas,1681000,1117972,1077286,40686
1977-10-01,Kentucky,2552000,1554032,1479553,74479
1977-10-01,Louisiana,2794000,1631159,1514052,117107
1977-10-01,Maine,795000,480822,443403,37419
1977-10-01,Maryland,3045000,1989485,1874329,115156
1977-10-01,Massachusetts,4267000,2769818,2567545,202273
1977-10-01,Michigan,6570000,4155230,3824989,330241
1977-10-01,Minnesota,2875000,1934783,1841485,93298
1977-10-01,Mississippi,1700000,1001705,928995,72710
1977-10-01,Missouri,3549000,2230818,2102362,128456
1977-10-01,Montana,555000,353485,331261,22224
1977-10-01,Nebraska,1118000,747789,721021,26768
1977-10-01,Nevada,502000,356553,336441,20112
1977-10-01,Ohio,7836000,4859809,4570806,289003
1977-10-01,Oklahoma,2079000,1255007,1201790,53217
1977-10-01,Oregon,1818000,1167335,1093045,74290
1977-10-01,Pennsylvania,8898000,5234321,4840769,393552
1977-10-01,Tennessee,3208000,1952908,1835060,117848
1977-10-01,Texas,9326000,6050362,5728897,321465
1977-10-01,Utah,875000,550972,523813,27159
1977-10-01,Vermont,354000,232510,216962,15548
1977-10-01,Virginia,3694000,2428517,2297252,131265
1977-10-01,Washington,2747000,1725263,1595302,129961
1977-10-01,Wisconsin,3334000,2197460,2089121,108339
1977-10-01,Wyoming,293000,199790,193906,5884
1977-11-01,Alabama,2710000,1587306,1482145,105161
1977-11-01,Alaska,251000,177332,158943,18389
1977-11-01,Arizona,1756000,1056804,978885,77919
1977-11-01,Arkansas,1595000,936923,876942,59981
1977-11-01,California,16458000,10581258,9759799,821459
1977-11-01,Colorado,1950000,1313067,1231098,81969
1977-11-01,Connecticut,2296000,1502919,1410727,92192
1977-11-01,Delaware,431000,273690,253473,20217
1977-11-01,Florida,6808000,3817877,3531189,286688
1977-11-01,Georgia,3679000,2349801,2206064,143737
1977-11-01,Hawaii,615000,417787,387400,30387
1977-11-01,Idaho,619000,407144,384429,22715
1977-11-01,Illinois,8316000,5353609,5014697,338912
1977-11-01,Indiana,3891000,2518474,2372642,145832
1977-11-01,Iowa,2118000,1400861,1345838,55023
1977-11-01,Kansas,1683000,1119892,1080023,39869
1977-11-01,Kentucky,2555000,1559259,1483273,75986
1977-11-01,Louisiana,2799000,1640001,1519251,120750
1977-11-01,Maine,796000,480614,444382,36232
1977-11-01,Maryland,3049000,1997911,1882607,115304
1977-11-01,Massachusetts,4270000,2775507,2578383,197124
1977-11-01,Michigan,6578000,4162300,3839810,322490
1977-11-01,Minnesota,2879000,1937923,1848243,89680
1977-11-01,Mississippi,1703000,1003627,931592,72035
1977-11-01,Missouri,3553000,2237042,2109927,127115
1977-11-01,Montana,556000,354633,332320,22313
1977-11-01,Nebraska,1119000,749481,722182,27299
1977-11-01,Nevada,505000,358473,339372,19101
1977-11-01,Ohio,7843000,4860487,4576604,283883
1977-11-01,Oklahoma,2083000,1257863,1206136,51727
1977-11-01,Oregon,1824000,1172334,1100479,71855
1977-11-01,Pennsylvania,8903000,5240358,4849324,391034
1977-11-01,Tennessee,3214000,1953442,1836283,117159
1977-11-01,Texas,9350000,6077074,5754302,322772
1977-11-01,Utah,877000,552802,526278,26524
1977-11-01,Vermont,355000,233493,218143,15350
1977-11-01,Virginia,3701000,2435033,2303075,131958
1977-11-01,Washington,2756000,1732731,1607216,125515
1977-11-01,Wisconsin,3338000,2203714,2095181,108533
1977-11-01,Wyoming,294000,201196,195319,5877
1977-12-01,Alabama,2715000,1593178,1489366,103812
1977-12-01,Alaska,251000,178335,159372,18963
1977-12-01,Arizona,1763000,1056575,981858,74717
1977-12-01,Arkansas,1598000,937455,877620,59835
1977-12-01,California,16499000,10627337,9812886,814451
1977-12-01,Colorado,1956000,1318028,1236006,82022
1977-12-01,Connecticut,2298000,1503090,1413652,89438
1977-12-01,Delaware,432000,273850,253892,19958
1977-12-01,Florida,6829000,3838156,3557099,281057
1977-12-01,Georgia,3686000,2355973,2216406,139567
1977-12-01,Hawaii,616000,417968,387725,30243
1977-12-01,Idaho,621000,408347,386130,22217
1977-12-01,Illinois,8323000,5367032,5027450,339582
1977-12-01,Indiana,3896000,2528228,2381677,146551
1977-12-01,Iowa,2119000,1401483,1346396,55087
1977-12-01,Kansas,1685000,1121666,1082489,39177
1977-12-01,Kentucky,2559000,1563514,1486288,77226
1977-12-01,Louisiana,2804000,1648535,1524704,123831
1977-12-01,Maine,797000,480174,445196,34978
1977-12-01,Maryland,3053000,2005674,1889956,115718
1977-12-01,Massachusetts,4274000,2781537,2589633,191904
1977-12-01,Michigan,6585000,4166986,3853518,313468
1977-12-01,Minnesota,2883000,1941683,1855715,85968
1977-12-01,Mississippi,1705000,1005225,933739,71486
1977-12-01,Missouri,3557000,2242850,2116444,126406
1977-12-01,Montana,557000,355847,333523,22324
1977-12-01,Nebraska,1120000,750719,723036,27683
1977-12-01,Nevada,508000,360338,342151,18187
1977-12-01,Ohio,7850000,4859590,4579781,279809
1977-12-01,Oklahoma,2087000,1259989,1209139,50850
1977-12-01,Oregon,1829000,1177161,1107507,69654
1977-12-01,Pennsylvania,8907000,5245827,4856853,388974
1977-12-01,Tennessee,3219000,1951796,1835421,116375
1977-12-01,Texas,9374000,6098267,5776455,321812
1977-12-01,Utah,880000,554702,528754,25948
1977-12-01,Vermont,355000,234132,219062,15070
1977-12-01,Virginia,3709000,2440406,2307939,132467
1977-12-01,Washington,2765000,1741347,1619321,122026
1977-12-01,Wisconsin,3341000,2210293,2101771,108522
1977-12-01,Wyoming,296000,202538,196708,5830
1978-01-01,Alabama,2720000,1598628,1495923,102705
1978-01-01,Alaska,252000,179245,159746,19499
1978-01-01,Arizona,1770000,1056990,985414,71576
1978-01-01,Arkansas,1601000,937964,878647,59317
1978-01-01,California,16540000,10673813,9864666,809147
1978-01-01,Colorado,1961000,1323160,1241466,81694
1978-01-01,Connecticut,2301000,1501705,1414927,86778
1978-01-01,Delaware,432000,273982,254265,19717
1978-01-01,Florida,6850000,3857700,3581959,275741
1978-01-01,Georgia,3692000,2361935,2226250,135685
1978-01-01,Hawaii,617000,417915,388005,29910
1978-01-01,Idaho,623000,409286,387496,21790
1978-01-01,Illinois,8330000,5378828,5038963,339865
1978-01-01,Indiana,3902000,2536828,2389946,146882
1978-01-01,Iowa,2121000,1401720,1346260,55460
1978-01-01,Kansas,1687000,1123568,1085131,38437
1978-01-01,Kentucky,2562000,1566520,1488643,77877
1978-01-01,Louisiana,2808000,1655767,1530108,125659
1978-01-01,Maine,799000,479688,445987,33701
1978-01-01,Maryland,3056000,2012589,1896862,115727
1978-01-01,Massachusetts,4277000,2787287,2600479,186808
1978-01-01,Michigan,6593000,4170914,3866733,304181
1978-01-01,Minnesota,2887000,1946032,1863538,82494
1978-01-01,Mississippi,1708000,1006366,935360,71006
1978-01-01,Missouri,3561000,2247827,2122559,125268
1978-01-01,Montana,559000,357075,334914,22161
1978-01-01,Nebraska,1121000,751478,723859,27619
1978-01-01,Nevada,511000,362135,344783,17352
1978-01-01,Ohio,7857000,4861374,4584851,276523
1978-01-01,Oklahoma,2090000,1261708,1211724,49984
1978-01-01,Oregon,1834000,1181956,1114069,67887
1978-01-01,Pennsylvania,8912000,5251023,4864770,386253
1978-01-01,Tennessee,3224000,1950231,1834880,115351
1978-01-01,Texas,9398000,6115243,5796759,318484
1978-01-01,Utah,882000,556616,531279,25337
1978-01-01,Vermont,356000,234551,219841,14710
1978-01-01,Virginia,3716000,2446221,2313616,132605
1978-01-01,Washington,2773000,1751416,1631692,119724
1978-01-01,Wisconsin,3345000,2216473,2108384,108089
1978-01-01,Wyoming,297000,203809,198061,5748
1978-02-01,Alabama,2725000,1603342,1501651,101691
1978-02-01,Alaska,253000,180057,160171,19886
1978-02-01,Arizona,1776000,1058641,989740,68901
1978-02-01,Arkansas,1604000,938787,880204,58583
1978-02-01,California,16582000,10722565,9916934,805631
1978-02-01,Colorado,1967000,1328600,1247521,81079
1978-02-01,Connecticut,2303000,1500367,1415964,84403
1978-02-01,Delaware,433000,274220,254704,19516
1978-02-01,Florida,6870000,3878267,3606773,271494
1978-02-01,Georgia,3699000,2368666,2235798,132868
1978-02-01,Hawaii,618000,417797,388302,29495
1978-02-01,Idaho,624000,410157,388687,21470
1978-02-01,Illinois,8337000,5389045,5049961,339084
1978-02-01,Indiana,3907000,2544422,2397765,146657
1978-02-01,Iowa,2123000,1402808,1346932,55876
1978-02-01,Kansas,1689000,1125697,1088184,37513
1978-02-01,Kentucky,2566000,1568631,1490603,78028
1978-02-01,Louisiana,2813000,1661051,1535121,125930
1978-02-01,Maine,800000,479514,447081,32433
1978-02-01,Maryland,3060000,2019169,1903925,115244
1978-02-01,Massachusetts,4281000,2792964,2610674,182290
1978-02-01,Michigan,6601000,4175740,3879701,296039
1978-02-01,Minnesota,2890000,1950724,1871091,79633
1978-02-01,Mississippi,1711000,1007101,936438,70663
1978-02-01,Missouri,3565000,2251933,2128735,123198
1978-02-01,Montana,560000,358433,336613,21820
1978-02-01,Nebraska,1123000,751843,724839,27004
1978-02-01,Nevada,515000,363893,347265,16628
1978-02-01,Ohio,7863000,4869671,4595746,273925
1978-02-01,Oklahoma,2094000,1263307,1214527,48780
1978-02-01,Oregon,1839000,1186991,1120038,66953
1978-02-01,Pennsylvania,8917000,5257244,4874749,382495
1978-02-01,Tennessee,3229000,1951302,1837108,114194
1978-02-01,Texas,9422000,6131558,5817873,313685
1978-02-01,Utah,885000,558472,533863,24609
1978-02-01,Vermont,357000,234976,220645,14331
1978-02-01,Virginia,3724000,2453725,2321340,132385
1978-02-01,Washington,2782000,1762917,1644406,118511
1978-02-01,Wisconsin,3349000,2222152,2114828,107324
1978-02-01,Wyoming,298000,205022,199341,5681
1978-03-01,Alabama,2730000,1607107,1506400,100707
1978-03-01,Alaska,253000,180709,160654,20055
1978-03-01,Arizona,1783000,1061837,995104,66733
1978-03-01,Arkansas,1607000,940085,882240,57845
1978-03-01,California,16623000,10773803,9969880,803923
1978-03-01,Colorado,1973000,1334471,1254233,80238
1978-03-01,Connecticut,2305000,1500230,1417714,82516
1978-03-01,Delaware,433000,274710,255275,19435
1978-03-01,Florida,6891000,3900271,3631188,269083
1978-03-01,Georgia,3706000,2377142,2245222,131920
1978-03-01,Hawaii,619000,417964,388731,29233
1978-03-01,Idaho,626000,411281,389964,21317
1978-03-01,Illinois,8344000,5398095,5060566,337529
1978-03-01,Indiana,3912000,2552406,2406614,145792
1978-03-01,Iowa,2124000,1405578,1349695,55883
1978-03-01,Kansas,1691000,1128019,1091567,36452
1978-03-01,Kentucky,2570000,1570484,1492542,77942
1978-03-01,Louisiana,2818000,1664387,1539828,124559
1978-03-01,Maine,801000,479938,448590,31348
1978-03-01,Maryland,3064000,2026131,1911487,114644
1978-03-01,Massachusetts,4285000,2798679,2619923,178756
1978-03-01,Michigan,6608000,4182308,3891561,290747
1978-03-01,Minnesota,2894000,1955574,1877904,77670
1978-03-01,Mississippi,1713000,1007621,937045,70576
1978-03-01,Missouri,3569000,2255306,2134971,120335
1978-03-01,Montana,561000,360035,338639,21396
1978-03-01,Nebraska,1124000,751970,726016,25954
1978-03-01,Nevada,518000,365735,349657,16078
1978-03-01,Ohio,7870000,4885448,4613039,272409
1978-03-01,Oklahoma,2098000,1264771,1217678,47093
1978-03-01,Oregon,1844000,1192356,1125393,66963
1978-03-01,Pennsylvania,8921000,5265346,4887426,377920
1978-03-01,Tennessee,3234000,1956274,1843002,113272
1978-03-01,Texas,9446000,6150322,5841570,308752
1978-03-01,Utah,888000,560293,536568,23725
1978-03-01,Vermont,357000,235573,221563,14010
1978-03-01,Virginia,3732000,2463260,2331195,132065
1978-03-01,Washington,2791000,1775497,1657177,118320
1978-03-01,Wisconsin,3352000,2227663,2120948,106715
1978-03-01,Wyoming,300000,206215,200541,5674
1978-04-01,Alabama,2734000,1610270,1510271,99999
1978-04-01,Alaska,254000,181209,161171,20038
1978-04-01,Arizona,1790000,1066144,1001458,64686
1978-04-01,Arkansas,1609000,941983,884710,57273
1978-04-01,California,16665000,10825396,10023312,802084
1978-04-01,Colorado,1979000,1340464,1261301,79163
1978-04-01,Connecticut,2307000,1501549,1420464,81085
1978-04-01,Delaware,434000,275507,256031,19476
1978-04-01,Florida,6912000,3922808,3654670,268138
1978-04-01,Georgia,3713000,2387496,2254504,132992
1978-04-01,Hawaii,620000,418653,389373,29280
1978-04-01,Idaho,628000,412772,391365,21407
1978-04-01,Illinois,8351000,5405730,5070632,335098
1978-04-01,Indiana,3917000,2561882,2417503,144379
1978-04-01,Iowa,2126000,1410018,1354819,55199
1978-04-01,Kansas,1693000,1130364,1095042,35322
1978-04-01,Kentucky,2573000,1572319,1494528,77791
1978-04-01,Louisiana,2823000,1666219,1544372,121847
1978-04-01,Maine,802000,481003,450390,30613
1978-04-01,Maryland,3068000,2033530,1919446,114084
1978-04-01,Massachusetts,4288000,2803770,2627721,176049
1978-04-01,Michigan,6616000,4190589,3901892,288697
1978-04-01,Minnesota,2898000,1960744,1884183,76561
1978-04-01,Mississippi,1716000,1008133,937539,70594
1978-04-01,Missouri,3573000,2257911,2140957,116954
1978-04-01,Montana,562000,361683,340721,20962
1978-04-01,Nebraska,1125000,751868,727277,24591
1978-04-01,Nevada,521000,367713,351989,15724
1978-04-01,Ohio,7877000,4906798,4634840,271958
1978-04-01,Oklahoma,2102000,1265648,1220869,44779
1978-04-01,Oregon,1849000,1198044,1130299,67745
1978-04-01,Pennsylvania,8926000,5275090,4902442,372648
1978-04-01,Tennessee,3239000,1964022,1851012,113010
1978-04-01,Texas,9470000,6171665,5867132,304533
1978-04-01,Utah,890000,562105,539408,22697
1978-04-01,Vermont,358000,236338,222587,13751
1978-04-01,Virginia,3739000,2473990,2342156,131834
1978-04-01,Washington,2800000,1787791,1668751,119040
1978-04-01,Wisconsin,3356000,2233194,2126801,106393
1978-04-01,Wyoming,301000,207414,201662,5752
1978-05-01,Alabama,2739000,1613550,1513699,99851
1978-05-01,Alaska,255000,181554,161664,19890
1978-05-01,Arizona,1797000,1071375,1008536,62839
1978-05-01,Arkansas,1612000,944470,887385,57085
1978-05-01,California,16706000,10875201,10076881,798320
1978-05-01,Colorado,1985000,1346240,1268450,77790
1978-05-01,Connecticut,2310000,1504068,1424056,80012
1978-05-01,Delaware,434000,276587,257009,19578
1978-05-01,Florida,6933000,3945035,3677009,268026
1978-05-01,Georgia,3720000,2398968,2263497,135471
1978-05-01,Hawaii,622000,419820,390231,29589
1978-05-01,Idaho,630000,414435,392696,21739
1978-05-01,Illinois,8359000,5412839,5081049,331790
1978-05-01,Indiana,3923000,2573041,2430244,142797
1978-05-01,Iowa,2128000,1415307,1361285,54022
1978-05-01,Kansas,1695000,1132531,1098347,34184
1978-05-01,Kentucky,2577000,1574332,1496406,77926
1978-05-01,Louisiana,2828000,1667218,1548841,118377
1978-05-01,Maine,804000,482573,452281,30292
1978-05-01,Maryland,3072000,2041147,1927577,113570
1978-05-01,Massachusetts,4292000,2808122,2634179,173943
1978-05-01,Michigan,6624000,4200277,3911070,289207
1978-05-01,Minnesota,2902000,1966662,1890523,76139
1978-05-01,Mississippi,1719000,1008966,938434,70532
1978-05-01,Missouri,3577000,2259982,2146530,113452
1978-05-01,Montana,564000,363333,342793,20540
1978-05-01,Nebraska,1126000,751657,728608,23049
1978-05-01,Nevada,524000,369854,354273,15581
1978-05-01,Ohio,7884000,4930395,4658453,271942
1978-05-01,Oklahoma,2106000,1265907,1223885,42022
1978-05-01,Oregon,1855000,1203952,1134701,69251
1978-05-01,Pennsylvania,8931000,5286307,4918457,367850
1978-05-01,Tennessee,3245000,1972218,1858500,113718
1978-05-01,Texas,9494000,6194406,5892873,301533
1978-05-01,Utah,893000,564046,542364,21682
1978-05-01,Vermont,359000,237161,223630,13531
1978-05-01,Virginia,3747000,2484164,2352600,131564
1978-05-01,Washington,2809000,1798853,1678413,120440
1978-05-01,Wisconsin,3360000,2239416,2132958,106458
1978-05-01,Wyoming,302000,208622,202714,5908
1978-06-01,Alabama,2744000,1617496,1517187,100309
1978-06-01,Alaska,255000,181747,162101,19646
1978-06-01,Arizona,1803000,1077443,1016059,61384
1978-06-01,Arkansas,1615000,947133,889782,57351
1978-06-01,California,16748000,10918582,10128069,790513
1978-06-01,Colorado,1991000,1351735,1275809,75926
1978-06-01,Connecticut,2312000,1507105,1428056,79049
1978-06-01,Delaware,435000,277656,258013,19643
1978-06-01,Florida,6953000,3965759,3698065,267694
1978-06-01,Georgia,3727000,2409887,2271819,138068
1978-06-01,Hawaii,623000,421208,391316,29892
1978-06-01,Idaho,631000,415928,393728,22200
1978-06-01,Illinois,8366000,5420516,5093233,327283
1978-06-01,Indiana,3928000,2584575,2443163,141412
1978-06-01,Iowa,2129000,1420083,1367402,52681
1978-06-01,Kansas,1697000,1134426,1101281,33145
1978-06-01,Kentucky,2580000,1576429,1498063,78366
1978-06-01,Louisiana,2833000,1667912,1553153,114759
1978-06-01,Maine,805000,484340,454112,30228
1978-06-01,Maryland,3076000,2048180,1935339,112841
1978-06-01,Massachusetts,4295000,2811794,2639849,171945
1978-06-01,Michigan,6631000,4210324,3919596,290728
1978-06-01,Minnesota,2905000,1973159,1897164,75995
1978-06-01,Mississippi,1721000,1010092,940087,70005
1978-06-01,Missouri,3581000,2261750,2151608,110142
1978-06-01,Montana,565000,364964,344819,20145
1978-06-01,Nebraska,1127000,751432,729952,21480
1978-06-01,Nevada,527000,372141,356515,15626
1978-06-01,Ohio,7890000,4952204,4680784,271420
1978-06-01,Oklahoma,2110000,1265963,1226564,39399
1978-06-01,Oregon,1860000,1209727,1138430,71297
1978-06-01,Pennsylvania,8935000,5297581,4933262,364319
1978-06-01,Tennessee,3250000,1979214,1864255,114959
1978-06-01,Texas,9518000,6217251,5917371,299880
1978-06-01,Utah,895000,566267,545443,20824
1978-06-01,Vermont,359000,237893,224570,13323
1978-06-01,Virginia,3754000,2491918,2360942,130976
1978-06-01,Washington,2818000,1808520,1686847,121673
1978-06-01,Wisconsin,3363000,2246528,2139676,106852
1978-06-01,Wyoming,304000,209832,203748,6084
1978-07-01,Alabama,2749000,1622316,1520668,101648
1978-07-01,Alaska,256000,181963,162538,19425
1978-07-01,Arizona,1810000,1083840,1023252,60588
1978-07-01,Arkansas,1618000,949586,891556,58030
1978-07-01,California,16789000,10953156,10173539,779617
1978-07-01,Colorado,1997000,1356935,1282962,73973
1978-07-01,Connecticut,2314000,1510340,1432107,78233
1978-07-01,Delaware,435000,278411,258761,19650
1978-07-01,Florida,6974000,3984312,3717463,266849
1978-07-01,Georgia,3734000,2418937,2279013,139924
1978-07-01,Hawaii,624000,422532,392547,29985
1978-07-01,Idaho,633000,416874,394138,22736
1978-07-01,Illinois,8373000,5429310,5106550,322760
1978-07-01,Indiana,3933000,2594992,2454315,140677
1978-07-01,Iowa,2131000,1423737,1371805,51932
1978-07-01,Kansas,1699000,1136149,1103652,32497
1978-07-01,Kentucky,2584000,1578742,1499614,79128
1978-07-01,Louisiana,2838000,1668777,1557268,111509
1978-07-01,Maine,806000,486127,455807,30320
1978-07-01,Maryland,3080000,2054433,1941983,112450
1978-07-01,Massachusetts,4299000,2814916,2644777,170139
1978-07-01,Michigan,6639000,4220681,3927787,292894
1978-07-01,Minnesota,2909000,1979619,1903597,76022
1978-07-01,Mississippi,1724000,1011334,942286,69048
1978-07-01,Missouri,3585000,2263551,2155973,107578
1978-07-01,Montana,566000,366346,346542,19804
1978-07-01,Nebraska,1128000,751279,731028,20251
1978-07-01,Nevada,530000,374448,358612,15836
1978-07-01,Ohio,7897000,4969977,4699650,270327
1978-07-01,Oklahoma,2114000,1266385,1228673,37712
1978-07-01,Oregon,1865000,1214955,1141414,73541
1978-07-01,Pennsylvania,8940000,5308359,4945380,362979
1978-07-01,Tennessee,3255000,1984030,1867909,116121
1978-07-01,Texas,9542000,6239448,5938904,300544
1978-07-01,Utah,898000,568765,548490,20275
1978-07-01,Vermont,360000,238495,225353,13142
1978-07-01,Virginia,3762000,2496548,2366272,130276
1978-07-01,Washington,2827000,1817401,1694504,122897
1978-07-01,Wisconsin,3367000,2254545,2146518,108027
1978-07-01,Wyoming,305000,211008,204763,6245
1978-08-01,Alabama,2753000,1627501,1523802,103699
1978-08-01,Alaska,256000,182268,163024,19244
1978-08-01,Arizona,1819000,1090443,1029612,60831
1978-08-01,Arkansas,1621000,951771,892807,58964
1978-08-01,California,16825000,10981764,10213361,768403
1978-08-01,Colorado,2004000,1361997,1289908,72089
1978-08-01,Connecticut,2316000,1514160,1436417,77743
1978-08-01,Delaware,435000,278855,259201,19654
1978-08-01,Florida,7000000,4001454,3735248,266206
1978-08-01,Georgia,3742000,2425922,2284920,141002
1978-08-01,Hawaii,626000,423598,393758,29840
1978-08-01,Idaho,634000,417356,394036,23320
1978-08-01,Illinois,8377000,5438131,5119120,319011
1978-08-01,Indiana,3937000,2603444,2462646,140798
1978-08-01,Iowa,2132000,1425404,1373228,52176
1978-08-01,Kansas,1701000,1138055,1105610,32445
1978-08-01,Kentucky,2587000,1581256,1501149,80107
1978-08-01,Louisiana,2844000,1669905,1561270,108635
1978-08-01,Maine,807000,487884,457379,30505
1978-08-01,Maryland,3083000,2060041,1947223,112818
1978-08-01,Massachusetts,4303000,2817675,2648841,168834
1978-08-01,Michigan,6646000,4231826,3936084,295742
1978-08-01,Minnesota,2913000,1985713,1909521,76192
1978-08-01,Mississippi,1726000,1012508,944601,67907
1978-08-01,Missouri,3588000,2265765,2160110,105655
1978-08-01,Montana,567000,367294,347723,19571
1978-08-01,Nebraska,1129000,751361,731784,19577
1978-08-01,Nevada,533000,376752,360563,16189
1978-08-01,Ohio,7902000,4984903,4714962,269941
1978-08-01,Oklahoma,2118000,1267727,1230388,37339
1978-08-01,Oregon,1870000,1219284,1143345,75939
1978-08-01,Pennsylvania,8946000,5318957,4955273,363684
1978-08-01,Tennessee,3262000,1987035,1870051,116984
1978-08-01,Texas,9570000,6260442,5957611,302831
1978-08-01,Utah,901000,571690,551501,20189
1978-08-01,Vermont,361000,239054,226033,13021
1978-08-01,Virginia,3768000,2499275,2369256,130019
1978-08-01,Washington,2837000,1825910,1701522,124388
1978-08-01,Wisconsin,3372000,2262994,2152940,110054
1978-08-01,Wyoming,306000,212167,205788,6379
1978-09-01,Alabama,2756000,1632310,1526379,105931
1978-09-01,Alaska,256000,182680,163653,19027
1978-09-01,Arizona,1827000,1097675,1035679,61996
1978-09-01,Arkansas,1623000,953834,893907,59927
1978-09-01,California,16861000,11009558,10251598,757960
1978-09-01,Colorado,2010000,1367630,1297179,70451
1978-09-01,Connecticut,2318000,1519152,1441542,77610
1978-09-01,Delaware,436000,279137,259488,19649
1978-09-01,Florida,7027000,4018127,3752166,265961
1978-09-01,Georgia,3751000,2431556,2290280,141276
1978-09-01,Hawaii,628000,424374,394881,29493
1978-09-01,Idaho,636000,417752,393865,23887
1978-09-01,Illinois,8381000,5445023,5129818,315205
1978-09-01,Indiana,3941000,2609501,2467861,141640
1978-09-01,Iowa,2133000,1424452,1371281,53171
1978-09-01,Kansas,1703000,1140572,1107698,32874
1978-09-01,Kentucky,2590000,1583317,1502340,80977
1978-09-01,Louisiana,2850000,1671321,1565441,105880
1978-09-01,Maine,808000,489497,458798,30699
1978-09-01,Maryland,3086000,2065506,1951529,113977
1978-09-01,Massachusetts,4306000,2821024,2653044,167980
1978-09-01,Michigan,6653000,4244193,3945581,298612
1978-09-01,Minnesota,2917000,1991685,1915246,76439
1978-09-01,Mississippi,1728000,1013314,946723,66591
1978-09-01,Missouri,3591000,2268913,2165105,103808
1978-09-01,Montana,567000,367703,348287,19416
1978-09-01,Nebraska,1130000,751831,732488,19343
1978-09-01,Nevada,537000,379085,362483,16602
1978-09-01,Ohio,7906000,4999535,4728178,271357
1978-09-01,Oklahoma,2122000,1270422,1232472,37950
1978-09-01,Oregon,1875000,1222567,1143984,78583
1978-09-01,Pennsylvania,8951000,5329373,4963861,365512
1978-09-01,Tennessee,3268000,1989880,1872256,117624
1978-09-01,Texas,9599000,6281470,5976921,304549
1978-09-01,Utah,903000,575128,554623,20505
1978-09-01,Vermont,362000,239685,226711,12974
1978-09-01,Virginia,3773000,2501660,2371352,130308
1978-09-01,Washington,2846000,1834073,1708120,125953
1978-09-01,Wisconsin,3376000,2270955,2158835,112120
1978-09-01,Wyoming,308000,213317,206897,6420
1978-10-01,Alabama,2760000,1636636,1528574,108062
1978-10-01,Alaska,256000,183262,164489,18773
1978-10-01,Arizona,1836000,1106431,1042817,63614
1978-10-01,Arkansas,1626000,956204,895425,60779
1978-10-01,California,16897000,11041537,10292800,748737
1978-10-01,Colorado,2017000,1374559,1305034,69525
1978-10-01,Connecticut,2320000,1525728,1447893,77835
1978-10-01,Delaware,436000,279467,259834,19633
1978-10-01,Florida,7053000,4035724,3769685,266039
1978-10-01,Georgia,3759000,2437277,2296302,140975
1978-10-01,Hawaii,629000,424897,395954,28943
1978-10-01,Idaho,637000,418451,394054,24397
1978-10-01,Illinois,8385000,5450232,5138764,311468
1978-10-01,Indiana,3945000,2614460,2471552,142908
1978-10-01,Iowa,2134000,1421685,1367197,54488
1978-10-01,Kansas,1704000,1144015,1110529,33486
1978-10-01,Kentucky,2593000,1584730,1503067,81663
1978-10-01,Louisiana,2855000,1673479,1570217,103262
1978-10-01,Maine,809000,491066,460121,30945
1978-10-01,Maryland,3089000,2071376,1955845,115531
1978-10-01,Massachusetts,4310000,2826542,2658998,167544
1978-10-01,Michigan,6660000,4258962,3957486,301476
1978-10-01,Minnesota,2921000,1998037,1921336,76701
1978-10-01,Mississippi,1730000,1013860,948615,65245
1978-10-01,Missouri,3594000,2273551,2171823,101728
1978-10-01,Montana,568000,367568,348324,19244
1978-10-01,Nebraska,1130000,752699,733423,19276
1978-10-01,Nevada,540000,381532,364517,17015
1978-10-01,Ohio,7911000,5016924,4742263,274661
1978-10-01,Oklahoma,2126000,1274514,1235571,38943
1978-10-01,Oregon,1880000,1225137,1143899,81238
1978-10-01,Pennsylvania,8957000,5339517,4972244,367273
1978-10-01,Tennessee,3275000,1993891,1876269,117622
1978-10-01,Texas,9627000,6304655,6000860,303795
1978-10-01,Utah,906000,578972,557995,20977
1978-10-01,Vermont,362000,240485,227504,12981
1978-10-01,Virginia,3779000,2505259,2374465,130794
1978-10-01,Washington,2856000,1842516,1714933,127583
1978-10-01,Wisconsin,3381000,2277813,2164552,113261
1978-10-01,Wyoming,309000,214453,208150,6303
1978-11-01,Alabama,2764000,1640650,1530696,109954
1978-11-01,Alaska,257000,183977,165514,18463
1978-11-01,Arizona,1845000,1116473,1051380,65093
1978-11-01,Arkansas,1628000,958966,897506,61460
1978-11-01,California,16934000,11077465,10336820,740645
1978-11-01,Colorado,2023000,1382262,1313141,69121
1978-11-01,Connecticut,2323000,1533681,1455341,78340
1978-11-01,Delaware,437000,279919,260259,19660
1978-11-01,Florida,7079000,4054637,3788421,266216
1978-11-01,Georgia,3767000,2443523,2303225,140298
1978-11-01,Hawaii,631000,425235,396958,28277
1978-11-01,Idaho,638000,419609,394741,24868
1978-11-01,Illinois,8389000,5453739,5145509,308230
1978-11-01,Indiana,3949000,2618833,2474672,144161
1978-11-01,Iowa,2135000,1418303,1362554,55749
1978-11-01,Kansas,1706000,1148161,1114072,34089
1978-11-01,Kentucky,2597000,1586000,1503610,82390
1978-11-01,Louisiana,2861000,1676644,1575506,101138
1978-11-01,Maine,811000,492722,461436,31286
1978-11-01,Maryland,3093000,2077697,1960442,117255
1978-11-01,Massachusetts,4313000,2834206,2666852,167354
1978-11-01,Michigan,6668000,4275194,3970239,304955
1978-11-01,Minnesota,2925000,2004599,1927517,77082
1978-11-01,Mississippi,1733000,1014427,950452,63975
1978-11-01,Missouri,3597000,2279504,2179924,99580
1978-11-01,Montana,568000,367026,347944,19082
1978-11-01,Nebraska,1131000,753783,734600,19183
1978-11-01,Nevada,543000,384106,366695,17411
1978-11-01,Ohio,7915000,5036737,4757606,279131
1978-11-01,Oklahoma,2131000,1279646,1239633,40013
1978-11-01,Oregon,1885000,1227352,1143669,83683
1978-11-01,Pennsylvania,8963000,5348897,4980436,368461
1978-11-01,Tennessee,3281000,1999069,1882521,116548
1978-11-01,Texas,9655000,6330086,6030030,300056
1978-11-01,Utah,909000,582959,561546,21413
1978-11-01,Vermont,363000,241443,228429,13014
1978-11-01,Virginia,3784000,2510379,2379374,131005
1978-11-01,Washington,2866000,1851800,1722652,129148
1978-11-01,Wisconsin,3385000,2283492,2170410,113082
1978-11-01,Wyoming,310000,215595,209517,6078
1978-12-01,Alabama,2767000,1644203,1532571,111632
1978-12-01,Alaska,257000,184591,166480,18111
1978-12-01,Arizona,1853000,1126093,1060283,65810
1978-12-01,Arkansas,1631000,961823,899908,61915
1978-12-01,California,16970000,11112366,10378926,733440
1978-12-01,Colorado,2030000,1389775,1320821,68954
1978-12-01,Connecticut,2325000,1542025,1463021,79004
1978-12-01,Delaware,437000,280424,260650,19774
1978-12-01,Florida,7105000,4073109,3807073,266036
1978-12-01,Georgia,3776000,2449252,2310052,139200
1978-12-01,Hawaii,633000,425456,397800,27656
1978-12-01,Idaho,640000,421098,395803,25295
1978-12-01,Illinois,8393000,5453350,5147901,305449
1978-12-01,Indiana,3953000,2622524,2477199,145325
1978-12-01,Iowa,2136000,1415293,1358579,56714
1978-12-01,Kansas,1708000,1152069,1117506,34563
1978-12-01,Kentucky,2600000,1587441,1504131,83310
1978-12-01,Louisiana,2867000,1680582,1580786,99796
1978-12-01,Maine,812000,494409,462638,31771
1978-12-01,Maryland,3096000,2083844,1964745,119099
1978-12-01,Massachusetts,4317000,2842500,2675324,167176
1978-12-01,Michigan,6675000,4289876,3980713,309163
1978-12-01,Minnesota,2929000,2010420,1932617,77803
1978-12-01,Mississippi,1735000,1014852,952227,62625
1978-12-01,Missouri,3600000,2285707,2187706,98001
1978-12-01,Montana,569000,366259,347264,18995
1978-12-01,Nebraska,1132000,754812,735630,19182
1978-12-01,Nevada,546000,386633,368864,17769
1978-12-01,Ohio,7920000,5054477,4770571,283906
1978-12-01,Oklahoma,2135000,1284900,1244070,40830
1978-12-01,Oregon,1890000,1229186,1143594,85592
1978-12-01,Pennsylvania,8968000,5356250,4987040,369210
1978-12-01,Tennessee,3288000,2004599,1889597,115002
1978-12-01,Texas,9684000,6355857,6061189,294668
1978-12-01,Utah,911000,586692,564936,21756
1978-12-01,Vermont,364000,242387,229339,13048
1978-12-01,Virginia,3790000,2515672,2385142,130530
1978-12-01,Washington,2875000,1861871,1731290,130581
1978-12-01,Wisconsin,3390000,2287887,2176295,111592
1978-12-01,Wyoming,311000,216643,210851,5792
1979-01-01,Alabama,2771000,1647083,1533846,113237
1979-01-01,Alaska,257000,184941,167216,17725
1979-01-01,Arizona,1862000,1133847,1068338,65509
1979-01-01,Arkansas,1633000,964489,902443,62046
1979-01-01,California,17006000,11141282,10414825,726457
1979-01-01,Colorado,2036000,1396518,1327993,68525
1979-01-01,Connecticut,2327000,1549162,1469502,79660
1979-01-01,Delaware,437000,280867,260932,19935
1979-01-01,Florida,7132000,4088847,3823949,264898
1979-01-01,Georgia,3784000,2453372,2315782,137590
1979-01-01,Hawaii,635000,425620,398440,27180
1979-01-01,Idaho,641000,422826,397235,25591
1979-01-01,Illinois,8397000,5447651,5144664,302987
1979-01-01,Indiana,3957000,2625227,2478875,146352
1979-01-01,Iowa,2137000,1413363,1356092,57271
1979-01-01,Kansas,1710000,1154742,1119945,34797
1979-01-01,Kentucky,2603000,1588841,1504576,84265
1979-01-01,Louisiana,2873000,1685080,1585594,99486
1979-01-01,Maine,813000,495881,463522,32359
1979-01-01,Maryland,3099000,2089179,1968448,120731
1979-01-01,Massachusetts,4320000,2849651,2682911,166740
1979-01-01,Michigan,6682000,4300331,3986924,313407
1979-01-01,Minnesota,2933000,2014878,1935977,78901
1979-01-01,Mississippi,1737000,1015088,953866,61222
1979-01-01,Missouri,3603000,2290830,2193347,97483
1979-01-01,Montana,569000,365651,346668,18983
1979-01-01,Nebraska,1133000,755516,736146,19370
1979-01-01,Nevada,550000,389030,370904,18126
1979-01-01,Ohio,7924000,5065499,4777655,287844
1979-01-01,Oklahoma,2139000,1289239,1248010,41229
1979-01-01,Oregon,1895000,1230590,1144035,86555
1979-01-01,Pennsylvania,8974000,5360067,4990510,369557
1979-01-01,Tennessee,3294000,2009545,1895659,113886
1979-01-01,Texas,9712000,6378780,6089864,288916
1979-01-01,Utah,914000,590014,567907,22107
1979-01-01,Vermont,365000,243098,230075,13023
1979-01-01,Virginia,3795000,2519362,2390195,129167
1979-01-01,Washington,2885000,1872124,1740524,131600
1979-01-01,Wisconsin,3394000,2290872,2181857,109015
1979-01-01,Wyoming,313000,217541,212059,5482
1979-02-01,Alabama,2775000,1649483,1534802,114681
1979-02-01,Alaska,257000,184966,167620,17346
1979-02-01,Arizona,1871000,1138850,1074943,63907
1979-02-01,Arkansas,1636000,966878,905064,61814
1979-02-01,California,17042000,11162945,10445021,717924
1979-02-01,Colorado,2043000,1402575,1335042,67533
1979-02-01,Connecticut,2329000,1553902,1473871,80031
1979-02-01,Delaware,438000,281095,261060,20035
1979-02-01,Florida,7158000,4100456,3838339,262117
1979-02-01,Georgia,3792000,2455570,2320387,135183
1979-02-01,Hawaii,636000,425792,398971,26821
1979-02-01,Idaho,642000,424566,398928,25638
1979-02-01,Illinois,8402000,5439016,5138643,300373
1979-02-01,Indiana,3961000,2626298,2479206,147092
1979-02-01,Iowa,2138000,1412725,1355331,57394
1979-02-01,Kansas,1711000,1155966,1121160,34806
1979-02-01,Kentucky,2606000,1590539,1505558,84981
1979-02-01,Louisiana,2878000,1690010,1589607,100403
1979-02-01,Maine,814000,496844,463935,32909
1979-02-01,Maryland,3102000,2093464,1971931,121533
1979-02-01,Massachusetts,4324000,2854573,2689061,165512
1979-02-01,Michigan,6689000,4305383,3989405,315978
1979-02-01,Minnesota,2938000,2018401,1938245,80156
1979-02-01,Mississippi,1739000,1015371,955643,59728
1979-02-01,Missouri,3606000,2294033,2196383,97650
1979-02-01,Montana,570000,365527,346506,19021
1979-02-01,Nebraska,1134000,755907,736250,19657
1979-02-01,Nevada,553000,391350,372844,18506
1979-02-01,Ohio,7929000,5067951,4777984,289967
1979-02-01,Oklahoma,2143000,1292478,1251327,41151
1979-02-01,Oregon,1901000,1231737,1145379,86358
1979-02-01,Pennsylvania,8980000,5360392,4991187,369205
1979-02-01,Tennessee,3301000,2013437,1899806,113631
1979-02-01,Texas,9740000,6397642,6113863,283779
1979-02-01,Utah,917000,593101,570485,22616
1979-02-01,Vermont,365000,243444,230582,12862
1979-02-01,Virginia,3801000,2520725,2393901,126824
1979-02-01,Washington,2895000,1881952,1750142,131810
1979-02-01,Wisconsin,3399000,2293003,2187109,105894
1979-02-01,Wyoming,314000,218372,213159,5213
1979-03-01,Alabama,2778000,1651916,1535922,115994
1979-03-01,Alaska,257000,184735,167740,16995
1979-03-01,Arizona,1879000,1141140,1079814,61326
1979-03-01,Arkansas,1639000,969124,907743,61381
1979-03-01,California,17078000,11179494,10471986,707508
1979-03-01,Colorado,2050000,1408652,1342410,66242
1979-03-01,Connecticut,2331000,1556341,1476436,79905
1979-03-01,Delaware,438000,280987,261010,19977
1979-03-01,Florida,7184000,4108520,3850714,257806
1979-03-01,Georgia,3801000,2456219,2324268,131951
1979-03-01,Hawaii,638000,426107,399608,26499
1979-03-01,Idaho,644000,425923,400551,25372
1979-03-01,Illinois,8406000,5431075,5134804,296271
1979-03-01,Indiana,3965000,2625583,2477354,148229
1979-03-01,Iowa,2139000,1413192,1355958,57234
1979-03-01,Kansas,1713000,1156056,1121367,34689
1979-03-01,Kentucky,2609000,1593282,1507850,85432
1979-03-01,Louisiana,2884000,1695385,1592543,102842
1979-03-01,Maine,815000,497171,463942,33229
1979-03-01,Maryland,3105000,2096891,1975445,121446
1979-03-01,Massachusetts,4328000,2857018,2693808,163210
1979-03-01,Michigan,6696000,4306298,3989890,316408
1979-03-01,Minnesota,2942000,2021790,1940433,81357
1979-03-01,Mississippi,1741000,1015800,957822,57978
1979-03-01,Missouri,3609000,2295581,2197231,98350
1979-03-01,Montana,571000,365916,346853,19063
1979-03-01,Nebraska,1135000,756136,736133,20003
1979-03-01,Nevada,556000,393641,374748,18893
1979-03-01,Ohio,7934000,5063252,4772653,290599
1979-03-01,Oklahoma,2147000,1295406,1254625,40781
1979-03-01,Oregon,1906000,1233330,1147929,85401
1979-03-01,Pennsylvania,8985000,5358243,4990182,368061
1979-03-01,Tennessee,3308000,2016772,1902490,114282
1979-03-01,Texas,9769000,6413638,6133154,280484
1979-03-01,Utah,919000,596189,572802,23387
1979-03-01,Vermont,366000,243453,230892,12561
1979-03-01,Virginia,3806000,2520464,2396637,123827
1979-03-01,Washington,2904000,1890961,1760059,130902
1979-03-01,Wisconsin,3403000,2294703,2191913,102790
1979-03-01,Wyoming,315000,219201,214172,5029
1979-04-01,Alabama,2782000,1654464,1537206,117258
1979-04-01,Alaska,257000,184383,167695,16688
1979-04-01,Arizona,1888000,1141757,1083109,58648
1979-04-01,Arkansas,1641000,971238,910173,61065
1979-04-01,California,17114000,11195157,10497326,697831
1979-04-01,Colorado,2056000,1415391,1350293,65098
1979-04-01,Connecticut,2333000,1557503,1478086,79417
1979-04-01,Delaware,439000,280593,260814,19779
1979-04-01,Florida,7210000,4114736,3861612,253124
1979-04-01,Georgia,3809000,2456102,2327806,128296
1979-04-01,Hawaii,640000,426702,400593,26109
1979-04-01,Idaho,645000,426699,401808,24891
1979-04-01,Illinois,8410000,5426910,5135796,291114
1979-04-01,Indiana,3969000,2623894,2473190,150704
1979-04-01,Iowa,2140000,1414486,1357328,57158
1979-04-01,Kansas,1715000,1155723,1121061,34662
1979-04-01,Kentucky,2612000,1597506,1511619,85887
1979-04-01,Louisiana,2890000,1701530,1594694,106836
1979-04-01,Maine,816000,497120,463841,33279
1979-04-01,Maryland,3108000,2100074,1978903,121171
1979-04-01,Massachusetts,4331000,2857968,2697654,160314
1979-04-01,Michigan,6703000,4305927,3989580,316347
1979-04-01,Minnesota,2946000,2025651,1943022,82629
1979-04-01,Mississippi,1743000,1016400,960073,56327
1979-04-01,Missouri,3612000,2296622,2196655,99967
1979-04-01,Montana,571000,366764,347665,19099
1979-04-01,Nebraska,1135000,756387,735886,20501
1979-04-01,Nevada,559000,395934,376659,19275
1979-04-01,Ohio,7938000,5055128,4764352,290776
1979-04-01,Oklahoma,2151000,1298825,1258351,40474
1979-04-01,Oregon,1911000,1235972,1151636,84336
1979-04-01,Pennsylvania,8991000,5355603,4988480,367123
1979-04-01,Tennessee,3314000,2020900,1905126,115774
1979-04-01,Texas,9797000,6429400,6149376,280024
1979-04-01,Utah,922000,599408,574953,24455
1979-04-01,Vermont,367000,243285,231066,12219
1979-04-01,Virginia,3812000,2519664,2398816,120848
1979-04-01,Washington,2914000,1899765,1770415,129350
1979-04-01,Wisconsin,3408000,2296456,2196020,100436
1979-04-01,Wyoming,316000,220075,215095,4980
1979-05-01,Alabama,2786000,1657348,1538757,118591
1979-05-01,Alaska,258000,184094,167613,16481
1979-05-01,Arizona,1897000,1142299,1085926,56373
1979-05-01,Arkansas,1644000,973245,912255,60990
1979-05-01,California,17151000,11215470,10523859,691611
1979-05-01,Colorado,2063000,1423372,1358892,64480
1979-05-01,Connecticut,2336000,1558740,1479863,78877
1979-05-01,Delaware,439000,280171,260629,19542
1979-05-01,Florida,7237000,4121425,3872289,249136
1979-05-01,Georgia,3817000,2456837,2331874,124963
1979-05-01,Hawaii,642000,427577,402052,25525
1979-05-01,Idaho,646000,427173,402772,24401
1979-05-01,Illinois,8414000,5428521,5141772,286749
1979-05-01,Indiana,3973000,2623043,2467901,155142
1979-05-01,Iowa,2141000,1416441,1359106,57335
1979-05-01,Kansas,1717000,1155934,1121000,34934
1979-05-01,Kentucky,2616000,1603326,1516746,86580
1979-05-01,Louisiana,2896000,1708767,1597000,111767
1979-05-01,Maine,818000,497172,463991,33181
1979-05-01,Maryland,3112000,2103534,1982333,121201
1979-05-01,Massachusetts,4335000,2858486,2701000,157486
1979-05-01,Michigan,6711000,4307552,3989250,318302
1979-05-01,Minnesota,2950000,2030558,1946492,84066
1979-05-01,Mississippi,1746000,1017521,962217,55304
1979-05-01,Missouri,3615000,2298292,2195762,102530
1979-05-01,Montana,572000,367923,348774,19149
1979-05-01,Nebraska,1136000,756825,735624,21201
1979-05-01,Nevada,563000,398307,378688,19619
1979-05-01,Ohio,7943000,5048181,4756657,291524
1979-05-01,Oklahoma,2156000,1303113,1262744,40369
1979-05-01,Oregon,1916000,1239744,1156202,83542
1979-05-01,Pennsylvania,8997000,5355093,4987777,367316
1979-05-01,Tennessee,3321000,2026700,1909052,117648
1979-05-01,Texas,9825000,6447648,6165789,281859
1979-05-01,Utah,925000,602819,577108,25711
1979-05-01,Vermont,368000,243176,231241,11935
1979-05-01,Virginia,3817000,2520005,2401429,118576
1979-05-01,Washington,2924000,1909318,1781246,128072
1979-05-01,Wisconsin,3412000,2299119,2199729,99390
1979-05-01,Wyoming,318000,221089,216000,5089
1979-06-01,Alabama,2789000,1660470,1540401,120069
1979-06-01,Alaska,258000,183993,167575,16418
1979-06-01,Arizona,1905000,1144131,1089245,54886
1979-06-01,Arkansas,1646000,975205,914014,61191
1979-06-01,California,17187000,11243986,10553509,690477
1979-06-01,Colorado,2069000,1432078,1367375,64703
1979-06-01,Connecticut,2338000,1560733,1482125,78608
1979-06-01,Delaware,440000,280054,260674,19380
1979-06-01,Florida,7263000,4130138,3883670,246468
1979-06-01,Georgia,3826000,2459200,2336738,122462
1979-06-01,Hawaii,643000,428596,403723,24873
1979-06-01,Idaho,648000,427690,403600,24090
1979-06-01,Illinois,8418000,5435636,5150508,285128
1979-06-01,Indiana,3977000,2624380,2462864,161516
1979-06-01,Iowa,2142000,1418793,1360921,57872
1979-06-01,Kansas,1718000,1157131,1121640,35491
1979-06-01,Kentucky,2619000,1609979,1522300,87679
1979-06-01,Louisiana,2901000,1717070,1600206,116864
1979-06-01,Maine,819000,497593,464493,33100
1979-06-01,Maryland,3115000,2107238,1985502,121736
1979-06-01,Massachusetts,4338000,2858486,2703160,155326
1979-06-01,Michigan,6718000,4312569,3989027,323542
1979-06-01,Minnesota,2954000,2036822,1951085,85737
1979-06-01,Mississippi,1748000,1019311,964001,55310
1979-06-01,Missouri,3618000,2300960,2195128,105832
1979-06-01,Montana,572000,369124,349894,19230
1979-06-01,Nebraska,1137000,757441,735447,21994
1979-06-01,Nevada,566000,400766,380828,19938
1979-06-01,Ohio,7947000,5044942,4751142,293800
1979-06-01,Oklahoma,2160000,1307910,1267487,40423
1979-06-01,Oregon,1921000,1244135,1160822,83313
1979-06-01,Pennsylvania,9002000,5358230,4988822,369408
1979-06-01,Tennessee,3327000,2033452,1913807,119645
1979-06-01,Texas,9854000,6468922,6184122,284800
1979-06-01,Utah,927000,606193,579239,26954
1979-06-01,Vermont,368000,243283,231511,11772
1979-06-01,Virginia,3823000,2522473,2405052,117421
1979-06-01,Washington,2933000,1919333,1791624,127709
1979-06-01,Wisconsin,3417000,2303504,2203546,99958
1979-06-01,Wyoming,319000,222219,216909,5310
1979-07-01,Alabama,2793000,1663440,1542100,121340
1979-07-01,Alaska,258000,184087,167608,16479
1979-07-01,Arizona,1914000,1148329,1094122,54207
1979-07-01,Arkansas,1649000,977184,915721,61463
1979-07-01,California,17223000,11281439,10588578,692861
1979-07-01,Colorado,2076000,1440989,1375366,65623
1979-07-01,Connecticut,2340000,1563475,1484854,78621
1979-07-01,Delaware,440000,280456,261131,19325
1979-07-01,Florida,7289000,4141442,3896867,244575
1979-07-01,Georgia,3834000,2463188,2342425,120763
1979-07-01,Hawaii,645000,429561,405290,24271
1979-07-01,Idaho,649000,428599,404583,24016
1979-07-01,Illinois,8422000,5447782,5160721,287061
1979-07-01,Indiana,3981000,2628259,2459156,169103
1979-07-01,Iowa,2143000,1421449,1362748,58701
1979-07-01,Kansas,1720000,1159424,1123323,36101
1979-07-01,Kentucky,2622000,1616565,1527561,89004
1979-07-01,Louisiana,2907000,1726069,1604983,121086
1979-07-01,Maine,820000,498424,465360,33064
1979-07-01,Maryland,3118000,2110972,1988685,122287
1979-07-01,Massachusetts,4342000,2858056,2704268,153788
1979-07-01,Michigan,6725000,4320426,3989015,331411
1979-07-01,Minnesota,2958000,2044529,1957033,87496
1979-07-01,Mississippi,1750000,1021597,965445,56152
1979-07-01,Missouri,3621000,2304789,2195283,109506
1979-07-01,Montana,573000,370126,350855,19271
1979-07-01,Nebraska,1138000,758280,735647,22633
1979-07-01,Nevada,569000,403309,383155,20154
1979-07-01,Ohio,7952000,5046005,4749074,296931
1979-07-01,Oklahoma,2164000,1312910,1272438,40472
1979-07-01,Oregon,1926000,1248515,1165082,83433
1979-07-01,Pennsylvania,9008000,5365109,4992374,372735
1979-07-01,Tennessee,3334000,2040268,1918976,121292
1979-07-01,Texas,9882000,6493062,6206713,286349
1979-07-01,Utah,930000,609374,581431,27943
1979-07-01,Vermont,369000,243641,231912,11729
1979-07-01,Virginia,3828000,2527217,2410122,117095
1979-07-01,Washington,2943000,1929147,1801039,128108
1979-07-01,Wisconsin,3421000,2309605,2208235,101370
1979-07-01,Wyoming,320000,223447,217892,5555
1979-08-01,Alabama,2796000,1666328,1543883,122445
1979-08-01,Alaska,258000,184312,167730,16582
1979-08-01,Arizona,1921000,1155250,1100860,54390
1979-08-01,Arkansas,1651000,979170,917574,61596
1979-08-01,California,17267000,11324860,10628240,696620
1979-08-01,Colorado,2080000,1449487,1382640,66847
1979-08-01,Connecticut,2342000,1566841,1487931,78910
1979-08-01,Delaware,440000,281324,261916,19408
1979-08-01,Florida,7318000,4155394,3912436,242958
1979-08-01,Georgia,3841000,2468650,2348545,120105
1979-08-01,Hawaii,647000,430405,406706,23699
1979-08-01,Idaho,650000,429886,405680,24206
1979-08-01,Illinois,8426000,5464630,5171099,293531
1979-08-01,Indiana,3984000,2634121,2456718,177403
1979-08-01,Iowa,2144000,1424664,1364850,59814
1979-08-01,Kansas,1722000,1162614,1125983,36631
1979-08-01,Kentucky,2625000,1622646,1532343,90303
1979-08-01,Louisiana,2914000,1735099,1611259,123840
1979-08-01,Maine,820000,499640,466523,33117
1979-08-01,Maryland,3120000,2114594,1992016,122578
1979-08-01,Massachusetts,4344000,2857515,2704746,152769
1979-08-01,Michigan,6730000,4329825,3988151,341674
1979-08-01,Minnesota,2963000,2053231,1963751,89480
1979-08-01,Mississippi,1752000,1024319,966786,57533
1979-08-01,Missouri,3625000,2309622,2196100,113522
1979-08-01,Montana,573000,370841,351571,19270
1979-08-01,Nebraska,1139000,759272,736257,23015
1979-08-01,Nevada,572000,405881,385669,20212
1979-08-01,Ohio,7956000,5050681,4750511,300170
1979-08-01,Oklahoma,2169000,1318069,1277498,40571
1979-08-01,Oregon,1931000,1252953,1169203,83750
1979-08-01,Pennsylvania,9011000,5375281,4998239,377042
1979-08-01,Tennessee,3340000,2046872,1924602,122270
1979-08-01,Texas,9913000,6519815,6233683,286132
1979-08-01,Utah,933000,612252,583675,28577
1979-08-01,Vermont,370000,244196,232419,11777
1979-08-01,Virginia,3833000,2533603,2416264,117339
1979-08-01,Washington,2954000,1938433,1809207,129226
1979-08-01,Wisconsin,3426000,2316917,2213987,102930
1979-08-01,Wyoming,321000,224739,218975,5764
1979-09-01,Alabama,2799000,1669055,1545533,123522
1979-09-01,Alaska,259000,184641,167987,16654
1979-09-01,Arizona,1929000,1164057,1108628,55429
1979-09-01,Arkansas,1653000,981107,919580,61527
1979-09-01,California,17310000,11369128,10668358,700770
1979-09-01,Colorado,2085000,1456840,1388977,67863
1979-09-01,Connecticut,2345000,1570469,1490985,79484
1979-09-01,Delaware,440000,282416,262809,19607
1979-09-01,Florida,7347000,4171496,3929967,241529
1979-09-01,Georgia,3849000,2475015,2354321,120694
1979-09-01,Hawaii,649000,431212,408050,23162
1979-09-01,Idaho,651000,431290,406665,24625
1979-09-01,Illinois,8431000,5484329,5179226,305103
1979-09-01,Indiana,3987000,2640565,2454839,185726
1979-09-01,Iowa,2144000,1428786,1367509,61277
1979-09-01,Kansas,1724000,1166136,1129036,37100
1979-09-01,Kentucky,2627000,1628098,1536376,91722
1979-09-01,Louisiana,2921000,1743366,1618214,125152
1979-09-01,Maine,821000,501125,467824,33301
1979-09-01,Maryland,3121000,2118035,1995458,122577
1979-09-01,Massachusetts,4347000,2856911,2704651,152260
1979-09-01,Michigan,6734000,4339231,3984539,354692
1979-09-01,Minnesota,2968000,2062108,1969946,92162
1979-09-01,Mississippi,1753000,1027514,968181,59333
1979-09-01,Missouri,3629000,2314591,2196752,117839
1979-09-01,Montana,573000,371363,352073,19290
1979-09-01,Nebraska,1140000,760257,737074,23183
1979-09-01,Nevada,576000,408379,388244,20135
1979-09-01,Ohio,7959000,5057443,4754299,303144
1979-09-01,Oklahoma,2174000,1323058,1282414,40644
1979-09-01,Oregon,1936000,1257383,1173485,83898
1979-09-01,Pennsylvania,9014000,5388082,5006271,381811
1979-09-01,Tennessee,3347000,2053298,1930545,122753
1979-09-01,Texas,9943000,6547943,6261950,285993
1979-09-01,Utah,936000,614780,585815,28965
1979-09-01,Vermont,370000,244839,232950,11889
1979-09-01,Virginia,3838000,2540459,2422735,117724
1979-09-01,Washington,2966000,1946985,1815994,130991
1979-09-01,Wisconsin,3431000,2325040,2219963,105077
1979-09-01,Wyoming,323000,226067,220097,5970
1979-10-01,Alabama,2803000,1671084,1546854,124230
1979-10-01,Alaska,259000,184969,168402,16567
1979-10-01,Arizona,1936000,1173376,1116241,57135
1979-10-01,Arkansas,1655000,982805,921676,61129
1979-10-01,California,17354000,11409331,10706202,703129
1979-10-01,Colorado,2089000,1462395,1394592,67803
1979-10-01,Connecticut,2347000,1573707,1493660,80047
1979-10-01,Delaware,440000,283435,263690,19745
1979-10-01,Florida,7376000,4188719,3948874,239845
1979-10-01,Georgia,3856000,2481527,2359254,122273
1979-10-01,Hawaii,650000,432069,409410,22659
1979-10-01,Idaho,652000,432487,407374,25113
1979-10-01,Illinois,8435000,5503092,5183506,319586
1979-10-01,Indiana,3990000,2645571,2452726,192845
1979-10-01,Iowa,2145000,1433403,1370743,62660
1979-10-01,Kansas,1725000,1169158,1131742,37416
1979-10-01,Kentucky,2630000,1632553,1539214,93339
1979-10-01,Louisiana,2927000,1749794,1624981,124813
1979-10-01,Maine,821000,502409,469048,33361
1979-10-01,Maryland,3123000,2120896,1998951,121945
1979-10-01,Massachusetts,4349000,2856085,2704343,151742
1979-10-01,Michigan,6739000,4345801,3976867,368934
1979-10-01,Minnesota,2973000,2070474,1974878,95596
1979-10-01,Mississippi,1755000,1030935,969808,61127
1979-10-01,Missouri,3633000,2318537,2196537,122000
1979-10-01,Montana,573000,371819,352479,19340
1979-10-01,Nebraska,1141000,761023,737925,23098
1979-10-01,Nevada,579000,410721,390754,19967
1979-10-01,Ohio,7963000,5063702,4758886,304816
1979-10-01,Oklahoma,2179000,1327531,1287102,40429
1979-10-01,Oregon,1941000,1260858,1177677,83181
1979-10-01,Pennsylvania,9017000,5401246,5016035,385211
1979-10-01,Tennessee,3353000,2059339,1936373,122966
1979-10-01,Texas,9974000,6575376,6288133,287243
1979-10-01,Utah,939000,617046,587733,29313
1979-10-01,Vermont,371000,245401,233394,12007
1979-10-01,Virginia,3843000,2546256,2428788,117468
1979-10-01,Washington,2977000,1953741,1821417,132324
1979-10-01,Wisconsin,3437000,2332467,2224861,107606
1979-10-01,Wyoming,324000,227408,221184,6224
1979-11-01,Alabama,2806000,1672076,1547532,124544
1979-11-01,Alaska,260000,185332,168958,16374
1979-11-01,Arizona,1944000,1182611,1123369,59242
1979-11-01,Arkansas,1657000,984261,923671,60590
1979-11-01,California,17397000,11443437,10740319,703118
1979-11-01,Colorado,2093000,1466555,1399963,66592
1979-11-01,Connecticut,2350000,1576324,1495961,80363
1979-11-01,Delaware,440000,284114,264415,19699
1979-11-01,Florida,7405000,4205947,3968196,237751
1979-11-01,Georgia,3864000,2488098,2363325,124773
1979-11-01,Hawaii,652000,433066,410913,22153
1979-11-01,Idaho,653000,433246,407612,25634
1979-11-01,Illinois,8439000,5517541,5183227,334314
1979-11-01,Indiana,3993000,2647654,2449457,198197
1979-11-01,Iowa,2146000,1437934,1374430,63504
1979-11-01,Kansas,1727000,1171256,1133563,37693
1979-11-01,Kentucky,2632000,1635737,1540469,95268
1979-11-01,Louisiana,2934000,1753982,1630962,123020
1979-11-01,Maine,822000,503225,470003,33222
1979-11-01,Maryland,3125000,2123327,2002346,120981
1979-11-01,Massachusetts,4352000,2855470,2704579,150891
1979-11-01,Michigan,6744000,4348352,3965054,383298
1979-11-01,Minnesota,2978000,2077989,1978505,99484
1979-11-01,Mississippi,1757000,1034238,971730,62508
1979-11-01,Missouri,3637000,2320934,2195071,125863
1979-11-01,Montana,573000,372336,352850,19486
1979-11-01,Nebraska,1142000,761458,738642,22816
1979-11-01,Nevada,583000,412953,393114,19839
1979-11-01,Ohio,7967000,5068220,4762679,305541
1979-11-01,Oklahoma,2184000,1331472,1291496,39976
1979-11-01,Oregon,1946000,1263141,1181601,81540
1979-11-01,Pennsylvania,9020000,5412774,5026176,386598
1979-11-01,Tennessee,3360000,2064582,1941375,123207
1979-11-01,Texas,10005000,6601483,6310316,291167
1979-11-01,Utah,942000,619281,589395,29886
1979-11-01,Vermont,372000,245810,233724,12086
1979-11-01,Virginia,3848000,2550048,2433590,116458
1979-11-01,Washington,2988000,1958074,1825242,132832
1979-11-01,Wisconsin,3442000,2337343,2227082,110261
1979-11-01,Wyoming,326000,228707,222193,6514
1979-12-01,Alabama,2809000,1672440,1547367,125073
1979-12-01,Alaska,260000,185810,169583,16227
1979-12-01,Arizona,1951000,1191780,1129987,61793
1979-12-01,Arkansas,1659000,985678,925153,60525
1979-12-01,California,17441000,11472705,10768752,703953
1979-12-01,Colorado,2098000,1470449,1405036,65413
1979-12-01,Connecticut,2352000,1578580,1497966,80614
1979-12-01,Delaware,439000,284350,264816,19534
1979-12-01,Florida,7434000,4222533,3986207,236326
1979-12-01,Georgia,3871000,2495286,2366609,128677
1979-12-01,Hawaii,654000,434304,412663,21641
1979-12-01,Idaho,654000,433535,407201,26334
1979-12-01,Illinois,8444000,5527854,5179315,348539
1979-12-01,Indiana,3996000,2646409,2443469,202940
1979-12-01,Iowa,2146000,1441794,1377688,64106
1979-12-01,Kansas,1729000,1172650,1134273,38377
1979-12-01,Kentucky,2635000,1638294,1540287,98007
1979-12-01,Louisiana,2941000,1756428,1635504,120924
1979-12-01,Maine,822000,503736,470647,33089
1979-12-01,Maryland,3126000,2125800,2005140,120660
1979-12-01,Massachusetts,4354000,2855872,2705672,150200
1979-12-01,Michigan,6749000,4348471,3948557,399914
1979-12-01,Minnesota,2982000,2084434,1981051,103383
1979-12-01,Mississippi,1759000,1037554,973843,63711
1979-12-01,Missouri,3641000,2322207,2192256,129951
1979-12-01,Montana,573000,372908,353076,19832
1979-12-01,Nebraska,1143000,761595,739057,22538
1979-12-01,Nevada,586000,415183,395240,19943
1979-12-01,Ohio,7970000,5071541,4763035,308506
1979-12-01,Oklahoma,2189000,1335039,1295342,39697
1979-12-01,Oregon,1951000,1265393,1185002,80391
1979-12-01,Pennsylvania,9023000,5422063,5034454,387609
1979-12-01,Tennessee,3366000,2068414,1944551,123863
1979-12-01,Texas,10035000,6626499,6327833,298666
1979-12-01,Utah,945000,621613,590768,30845
1979-12-01,Vermont,373000,246123,233967,12156
1979-12-01,Virginia,3853000,2552190,2436729,115461
1979-12-01,Washington,3000000,1960197,1827313,132884
1979-12-01,Wisconsin,3447000,2339572,2225371,114201
1979-12-01,Wyoming,327000,229934,223108,6826
1980-01-01,Alabama,2812000,1672687,1546209,126478
1980-01-01,Alaska,261000,186379,170123,16256
1980-01-01,Arizona,1959000,1200696,1135663,65033
1980-01-01,Arkansas,1661000,986939,925485,61454
1980-01-01,California,17485000,11497843,10787840,710003
1980-01-01,Colorado,2102000,1474630,1408927,65703
1980-01-01,Connecticut,2355000,1580710,1499549,81161
1980-01-01,Delaware,439000,284212,264803,19409
1980-01-01,Florida,7463000,4237136,4000347,236789
1980-01-01,Georgia,3879000,2503147,2368769,134378
1980-01-01,Hawaii,656000,435729,414532,21197
1980-01-01,Idaho,655000,433223,405812,27411
1980-01-01,Illinois,8448000,5534485,5171463,363022
1980-01-01,Indiana,4000000,2643183,2433485,209698
1980-01-01,Iowa,2147000,1444035,1378735,65300
1980-01-01,Kansas,1731000,1173756,1133816,39940
1980-01-01,Kentucky,2637000,1641080,1538809,102271
1980-01-01,Louisiana,2948000,1757569,1638094,119475
1980-01-01,Maine,822000,504200,470943,33257
1980-01-01,Maryland,3128000,2128297,2006189,122108
1980-01-01,Massachusetts,4357000,2856820,2706365,150455
1980-01-01,Michigan,6753000,4347500,3925544,421956
1980-01-01,Minnesota,2987000,2089255,1982087,107168
1980-01-01,Mississippi,1760000,1040912,975734,65178
1980-01-01,Missouri,3645000,2323214,2188029,135185
1980-01-01,Montana,573000,373217,352842,20375
1980-01-01,Nebraska,1143000,761606,738976,22630
1980-01-01,Nevada,589000,417418,396980,20438
1980-01-01,Ohio,7974000,5073129,4755451,317678
1980-01-01,Oklahoma,2194000,1338325,1298225,40100
1980-01-01,Oregon,1955000,1268565,1187062,81503
1980-01-01,Pennsylvania,9026000,5429163,5038000,391163
1980-01-01,Tennessee,3372000,2069857,1944542,125315
1980-01-01,Texas,10066000,6649920,6339884,310036
1980-01-01,Utah,948000,623862,591667,32195
1980-01-01,Vermont,373000,246385,234074,12311
1980-01-01,Virginia,3858000,2553269,2437767,115502
1980-01-01,Washington,3011000,1960776,1827130,133646
1980-01-01,Wisconsin,3452000,2340273,2219229,121044
1980-01-01,Wyoming,329000,230986,223835,7151
1980-02-01,Alabama,2815000,1673059,1543743,129316
1980-02-01,Alaska,261000,187064,170512,16552
1980-02-01,Arizona,1966000,1209565,1140171,69394
1980-02-01,Arkansas,1663000,987870,924261,63609
1980-02-01,California,17528000,11519633,10795311,724322
1980-02-01,Colorado,2106000,1479326,1410950,68376
1980-02-01,Connecticut,2357000,1582944,1500549,82395
1980-02-01,Delaware,439000,283924,264436,19488
1980-02-01,Florida,7491000,4248773,4009238,239535
1980-02-01,Georgia,3886000,2511320,2369496,141824
1980-02-01,Hawaii,657000,437142,416251,20891
1980-02-01,Idaho,655000,432478,403552,28926
1980-02-01,Illinois,8452000,5537420,5157757,379663
1980-02-01,Indiana,4003000,2640113,2419559,220554
1980-02-01,Iowa,2148000,1444402,1376591,67811
1980-02-01,Kansas,1733000,1174919,1132380,42539
1980-02-01,Kentucky,2640000,1644299,1535949,108350
1980-02-01,Louisiana,2955000,1758063,1639109,118954
1980-02-01,Maine,823000,504839,470883,33956
1980-02-01,Maryland,3130000,2130868,2004911,125957
1980-02-01,Massachusetts,4359000,2857250,2704818,152432
1980-02-01,Michigan,6758000,4346957,3895665,451292
1980-02-01,Minnesota,2992000,2092054,1980940,111114
1980-02-01,Mississippi,1762000,1043946,976759,67187
1980-02-01,Missouri,3648000,2324706,2182457,142249
1980-02-01,Montana,573000,373040,351957,21083
1980-02-01,Nebraska,1144000,761597,738198,23399
1980-02-01,Nevada,593000,419692,398289,21403
1980-02-01,Ohio,7978000,5072377,4736906,335471
1980-02-01,Oklahoma,2199000,1341325,1299832,41493
1980-02-01,Oregon,1960000,1272943,1186893,86050
1980-02-01,Pennsylvania,9029000,5434074,5034292,399782
1980-02-01,Tennessee,3379000,2069082,1940886,128196
1980-02-01,Texas,10097000,6670529,6346353,324176
1980-02-01,Utah,951000,625862,592012,33850
1980-02-01,Vermont,374000,246685,234012,12673
1980-02-01,Virginia,3863000,2553916,2436403,117513
1980-02-01,Washington,3023000,1960848,1824416,136432
1980-02-01,Wisconsin,3457000,2340584,2209298,131286
1980-02-01,Wyoming,330000,231781,224309,7472
1980-03-01,Alabama,2818000,1673967,1540076,133891
1980-03-01,Alaska,262000,187884,170754,17130
1980-03-01,Arizona,1974000,1218278,1143426,74852
1980-03-01,Arkansas,1665000,988439,921573,66866
1980-03-01,California,17572000,11540580,10793087,747493
1980-03-01,Colorado,2111000,1484619,1411018,73601
1980-03-01,Connecticut,2360000,1585156,1500648,84508
1980-03-01,Delaware,439000,283727,263850,19877
1980-03-01,Florida,7520000,4258033,4013729,244304
1980-03-01,Georgia,3894000,2519373,2368845,150528
1980-03-01,Hawaii,659000,438278,417483,20795
1980-03-01,Idaho,656000,431642,400899,30743
1980-03-01,Illinois,8457000,5537864,5137472,400392
1980-03-01,Indiana,4006000,2637896,2402255,235641
1980-03-01,Iowa,2148000,1443093,1370937,72156
1980-03-01,Kansas,1735000,1176474,1130447,46027
1980-03-01,Kentucky,2642000,1647892,1532058,115834
1980-03-01,Louisiana,2961000,1758658,1639547,119111
1980-03-01,Maine,823000,505687,470474,35213
1980-03-01,Maryland,3132000,2133828,2002044,131784
1980-03-01,Massachusetts,4362000,2856954,2700595,156359
1980-03-01,Michigan,6763000,4347619,3861330,486289
1980-03-01,Minnesota,2997000,2093114,1977804,115310
1980-03-01,Mississippi,1764000,1046593,976610,69983
1980-03-01,Missouri,3652000,2327198,2176171,151027
1980-03-01,Montana,573000,372457,350537,21920
1980-03-01,Nebraska,1145000,761788,736864,24924
1980-03-01,Nevada,596000,422129,399267,22862
1980-03-01,Ohio,7981000,5069578,4708189,361389
1980-03-01,Oklahoma,2204000,1344129,1300267,43862
1980-03-01,Oregon,1965000,1278016,1184266,93750
1980-03-01,Pennsylvania,9032000,5437900,5023174,414726
1980-03-01,Tennessee,3385000,2066780,1933794,132986
1980-03-01,Texas,10127000,6688726,6349543,339183
1980-03-01,Utah,953000,627592,591900,35692
1980-03-01,Vermont,375000,247122,233834,13288
1980-03-01,Virginia,3868000,2554661,2432865,121796
1980-03-01,Washington,3034000,1961352,1819708,141644
1980-03-01,Wisconsin,3462000,2341851,2197462,144389
1980-03-01,Wyoming,331000,232370,224572,7798
1980-04-01,Alabama,2822000,1675653,1536048,139605
1980-04-01,Alaska,262000,188693,170820,17873
1980-04-01,Arizona,1981000,1226164,1145552,80612
1980-04-01,Arkansas,1667000,988643,918069,70574
1980-04-01,California,17615000,11561952,10786253,775699
1980-04-01,Colorado,2115000,1490135,1409416,80719
1980-04-01,Connecticut,2362000,1586768,1499597,87171
1980-04-01,Delaware,439000,283710,263166,20544
1980-04-01,Florida,7549000,4265827,4015812,250015
1980-04-01,Georgia,3901000,2526840,2367480,159360
1980-04-01,Hawaii,661000,438991,418007,20984
1980-04-01,Idaho,657000,430878,398346,32532
1980-04-01,Illinois,8461000,5536887,5112952,423935
1980-04-01,Indiana,4009000,2636078,2383215,252863
1980-04-01,Iowa,2149000,1439782,1361693,78089
1980-04-01,Kansas,1736000,1178444,1128550,49894
1980-04-01,Kentucky,2645000,1651922,1528036,123886
1980-04-01,Louisiana,2968000,1759585,1640266,119319
1980-04-01,Maine,824000,506472,469656,36816
1980-04-01,Maryland,3133000,2136949,1998763,138186
1980-04-01,Massachusetts,4364000,2855983,2694623,161360
1980-04-01,Michigan,6768000,4348385,3826789,521596
1980-04-01,Minnesota,3002000,2093308,1973814,119494
1980-04-01,Mississippi,1766000,1048758,975621,73137
1980-04-01,Missouri,3656000,2330517,2170232,160285
1980-04-01,Montana,573000,371500,348735,22765
1980-04-01,Nebraska,1146000,762319,735378,26941
1980-04-01,Nevada,600000,424777,400108,24669
1980-04-01,Ohio,7985000,5064854,4673088,391766
1980-04-01,Oklahoma,2209000,1347146,1300360,46786
1980-04-01,Oregon,1970000,1282760,1179782,102978
1980-04-01,Pennsylvania,9036000,5441549,5007433,434116
1980-04-01,Tennessee,3392000,2063617,1924433,139184
1980-04-01,Texas,10158000,6705365,6353160,352205
1980-04-01,Utah,956000,629053,591558,37495
1980-04-01,Vermont,376000,247705,233648,14057
1980-04-01,Virginia,3873000,2556111,2428507,127604
1980-04-01,Washington,3045000,1962271,1814013,148258
1980-04-01,Wisconsin,3468000,2344306,2185754,158552
1980-04-01,Wyoming,333000,232851,224749,8102
1980-05-01,Alabama,2825000,1677891,1532322,145569
1980-05-01,Alaska,263000,189352,170781,18571
1980-05-01,Arizona,1986000,1232546,1146803,85743
1980-05-01,Arkansas,1668000,988771,914652,74119
1980-05-01,California,17646000,11583664,10779902,803762
1980-05-01,Colorado,2120000,1495447,1406923,88524
1980-05-01,Connecticut,2364000,1587519,1497649,89870
1980-05-01,Delaware,439000,283816,262476,21340
1980-05-01,Florida,7574000,4273224,4017643,255581
1980-05-01,Georgia,3909000,2533169,2366155,167014
1980-05-01,Hawaii,662000,439398,417935,21463
1980-05-01,Idaho,658000,430194,396237,33957
1980-05-01,Illinois,8466000,5535656,5088188,447468
1980-05-01,Indiana,4011000,2633783,2364934,268849
1980-05-01,Iowa,2150000,1434524,1349858,84666
1980-05-01,Kansas,1737000,1180434,1127025,53409
1980-05-01,Kentucky,2647000,1656252,1524547,131705
1980-05-01,Louisiana,2973000,1761729,1641942,119787
1980-05-01,Maine,825000,506944,468529,38415
1980-05-01,Maryland,3137000,2140034,1996039,143995
1980-05-01,Massachusetts,4368000,2855381,2689026,166355
1980-05-01,Michigan,6769000,4347575,3795714,551861
1980-05-01,Minnesota,3005000,2093625,1970298,123327
1980-05-01,Mississippi,1768000,1050223,974125,76098
1980-05-01,Missouri,3658000,2334226,2165374,168852
1980-05-01,Montana,574000,370406,346886,23520
1980-05-01,Nebraska,1147000,763124,734086,29038
1980-05-01,Nevada,602000,427585,401031,26554
1980-05-01,Ohio,7989000,5059701,4637913,421788
1980-05-01,Oklahoma,2213000,1350826,1301090,49736
1980-05-01,Oregon,1972000,1286563,1174855,111708
1980-05-01,Pennsylvania,9041000,5444936,4991058,453878
1980-05-01,Tennessee,3395000,2061124,1915153,145971
1980-05-01,Texas,10185000,6721357,6360261,361096
1980-05-01,Utah,958000,630358,591259,39099
1980-05-01,Vermont,376000,248402,233543,14859
1980-05-01,Virginia,3879000,2558452,2424841,133611
1980-05-01,Washington,3051000,1963457,1808485,154972
1980-05-01,Wisconsin,3471000,2346779,2175493,171286
1980-05-01,Wyoming,334000,233371,224983,8388
1980-06-01,Alabama,2828000,1680474,1529535,150939
1980-06-01,Alaska,263000,189815,170757,19058
1980-06-01,Arizona,1991000,1237479,1147880,89599
1980-06-01,Arkansas,1670000,989246,912182,77064
1980-06-01,California,17678000,11606681,10779355,827326
1980-06-01,Colorado,2125000,1500264,1404902,95362
1980-06-01,Connecticut,2367000,1587804,1495629,92175
1980-06-01,Delaware,440000,284029,261957,22072
1980-06-01,Florida,7599000,4282520,4022095,260425
1980-06-01,Georgia,3916000,2538411,2366030,172381
1980-06-01,Hawaii,663000,439811,417801,22010
1980-06-01,Idaho,659000,429586,394740,34846
1980-06-01,Illinois,8471000,5536190,5067596,468594
1980-06-01,Indiana,4013000,2630561,2350360,280201
1980-06-01,Iowa,2151000,1428369,1337698,90671
1980-06-01,Kansas,1739000,1182210,1126166,56044
1980-06-01,Kentucky,2649000,1660973,1522321,138652
1980-06-01,Louisiana,2979000,1765950,1645035,120915
1980-06-01,Maine,826000,507133,467459,39674
1980-06-01,Maryland,3142000,2143275,1994940,148335
1980-06-01,Massachusetts,4372000,2857415,2686940,170475
1980-06-01,Michigan,6771000,4344812,3771477,573335
1980-06-01,Minnesota,3008000,2095110,1968712,126398
1980-06-01,Mississippi,1770000,1051294,972655,78639
1980-06-01,Missouri,3661000,2337993,2162249,175744
1980-06-01,Montana,574000,369629,345506,24123
1980-06-01,Nebraska,1148000,764159,733303,30856
1980-06-01,Nevada,605000,430425,402242,28183
1980-06-01,Ohio,7992000,5057548,4610843,446705
1980-06-01,Oklahoma,2217000,1368684,1303385,65299
1980-06-01,Oregon,1974000,1289557,1171399,118158
1980-06-01,Pennsylvania,9046000,5448596,4978900,469696
1980-06-01,Tennessee,3399000,2061139,1908735,152404
1980-06-01,Texas,10211000,6739558,6373850,365708
1980-06-01,Utah,961000,631771,591270,40501
1980-06-01,Vermont,377000,249185,233610,15575
1980-06-01,Virginia,3885000,2561628,2423264,138364
1980-06-01,Washington,3056000,1965357,1804597,160760
1980-06-01,Wisconsin,3474000,2348032,2167685,180347
1980-06-01,Wyoming,335000,234146,225405,8741
1980-07-01,Alabama,2831000,1682886,1527894,154992
1980-07-01,Alaska,264000,189938,170731,19207
1980-07-01,Arizona,1996000,1241034,1149473,91561
1980-07-01,Arkansas,1671000,990168,911065,79103
1980-07-01,California,17709000,11628111,10786083,842028
1980-07-01,Colorado,2130000,1504084,1404450,99634
1980-07-01,Connecticut,2369000,1587700,1494012,93688
1980-07-01,Delaware,440000,284254,261712,22542
1980-07-01,Florida,7624000,4295189,4031279,263910
1980-07-01,Georgia,3924000,2542320,2367843,174477
1980-07-01,Hawaii,664000,440428,418040,22388
1980-07-01,Idaho,660000,428923,393813,35110
1980-07-01,Illinois,8476000,5538134,5053315,484819
1980-07-01,Indiana,4015000,2625886,2341568,284318
1980-07-01,Iowa,2152000,1422270,1327560,94710
1980-07-01,Kansas,1740000,1183257,1125761,57496
1980-07-01,Kentucky,2651000,1665612,1521621,143991
1980-07-01,Louisiana,2984000,1772119,1649365,122754
1980-07-01,Maine,826000,507054,466731,40323
1980-07-01,Maryland,3146000,2146185,1995601,150584
1980-07-01,Massachusetts,4376000,2862887,2689985,172902
1980-07-01,Michigan,6772000,4338870,3755570,583300
1980-07-01,Minnesota,3011000,2098132,1969956,128176
1980-07-01,Mississippi,1772000,1052253,971542,80711
1980-07-01,Missouri,3663000,2340590,2160620,179970
1980-07-01,Montana,575000,369442,344905,24537
1980-07-01,Nebraska,1149000,765104,733017,32087
1980-07-01,Nevada,607000,433130,403778,29352
1980-07-01,Ohio,7996000,5059265,4596549,462716
1980-07-01,Oklahoma,2221000,1377643,1307447,70196
1980-07-01,Oregon,1976000,1291914,1170690,121224
1980-07-01,Pennsylvania,9051000,5450646,4972918,477728
1980-07-01,Tennessee,3402000,2063637,1906335,157302
1980-07-01,Texas,10238000,6761137,6393876,367261
1980-07-01,Utah,963000,633275,591633,41642
1980-07-01,Vermont,377000,249953,233884,16069
1980-07-01,Virginia,3891000,2564946,2424365,140581
1980-07-01,Washington,3062000,1968138,1803344,164794
1980-07-01,Wisconsin,3478000,2346853,2162536,184317
1980-07-01,Wyoming,336000,235222,226045,9177
1980-08-01,Alabama,2834000,1684284,1526925,157359
1980-08-01,Alaska,265000,189828,170768,19060
1980-08-01,Arizona,2000000,1243183,1152186,90997
1980-08-01,Arkansas,1673000,991719,911539,80180
1980-08-01,California,17740000,11644984,10798842,846142
1980-08-01,Colorado,2135000,1506620,1405916,100704
1980-08-01,Connecticut,2372000,1586890,1492691,94199
1980-08-01,Delaware,441000,284400,261781,22619
1980-08-01,Florida,7649000,4310744,4045174,265570
1980-08-01,Georgia,3932000,2544378,2371752,172626
1980-08-01,Hawaii,665000,441296,418699,22597
1980-08-01,Idaho,661000,428247,393475,34772
1980-08-01,Illinois,8481000,5539863,5045309,494554
1980-08-01,Indiana,4016000,2619930,2339471,280459
1980-08-01,Iowa,2152000,1417481,1321438,96043
1980-08-01,Kansas,1741000,1183191,1125492,57699
1980-08-01,Kentucky,2653000,1669490,1522192,147298
1980-08-01,Louisiana,2989000,1779984,1654585,125399
1980-08-01,Maine,827000,506757,466451,40306
1980-08-01,Maryland,3151000,2148391,1997724,150667
1980-08-01,Massachusetts,4379000,2870867,2697566,173301
1980-08-01,Michigan,6773000,4329087,3747757,581330
1980-08-01,Minnesota,3014000,2102515,1974175,128340
1980-08-01,Mississippi,1774000,1053045,970733,82312
1980-08-01,Missouri,3665000,2341002,2159635,181367
1980-08-01,Montana,575000,369990,345233,24757
1980-08-01,Nebraska,1149000,765646,733068,32578
1980-08-01,Nevada,609000,435650,405566,30084
1980-08-01,Ohio,7999000,5063784,4594885,468899
1980-08-01,Oklahoma,2225000,1383370,1312870,70500
1980-08-01,Oregon,1979000,1293820,1173159,120661
1980-08-01,Pennsylvania,9056000,5449278,4973184,476094
1980-08-01,Tennessee,3406000,2067698,1907567,160131
1980-08-01,Texas,10264000,6785866,6418555,367311
1980-08-01,Utah,965000,634727,592253,42474
1980-08-01,Vermont,378000,250597,234357,16240
1980-08-01,Virginia,3897000,2567653,2427873,139780
1980-08-01,Washington,3067000,1971446,1804970,166476
1980-08-01,Wisconsin,3481000,2361508,2159890,201618
1980-08-01,Wyoming,337000,236514,226870,9644
1980-09-01,Alabama,2837000,1684447,1525980,158467
1980-09-01,Alaska,266000,189664,170910,18754
1980-09-01,Arizona,2005000,1243927,1155825,88102
1980-09-01,Arkansas,1674000,994204,913628,80576
1980-09-01,California,17772000,11658002,10815487,842515
1980-09-01,Colorado,2140000,1508094,1408722,99372
1980-09-01,Connecticut,2374000,1585549,1491565,93984
1980-09-01,Delaware,441000,284486,262093,22393
1980-09-01,Florida,7674000,4328514,4062424,266090
1980-09-01,Georgia,3939000,2545312,2377297,168015
1980-09-01,Hawaii,666000,442346,419649,22697
1980-09-01,Idaho,662000,427664,393643,34021
1980-09-01,Illinois,8486000,5541179,5042905,498274
1980-09-01,Indiana,4018000,2614091,2343020,271071
1980-09-01,Iowa,2153000,1414918,1319918,95000
1980-09-01,Kansas,1743000,1182289,1125322,56967
1980-09-01,Kentucky,2655000,1672497,1523912,148585
1980-09-01,Louisiana,2995000,1789035,1660358,128677
1980-09-01,Maine,828000,506478,466665,39813
1980-09-01,Maryland,3155000,2150024,2000785,149239
1980-09-01,Massachusetts,4383000,2880207,2707907,172300
1980-09-01,Michigan,6774000,4317021,3746005,571016
1980-09-01,Minnesota,3017000,2107759,1980673,127086
1980-09-01,Mississippi,1776000,1053566,970096,83470
1980-09-01,Missouri,3667000,2339459,2158619,180840
1980-09-01,Montana,576000,371261,346412,24849
1980-09-01,Nebraska,1150000,765752,733346,32406
1980-09-01,Nevada,612000,438029,407499,30530
1980-09-01,Ohio,8003000,5069771,4601487,468284
1980-09-01,Oklahoma,2229000,1387482,1319163,68319
1980-09-01,Oregon,1981000,1296197,1178184,118013
1980-09-01,Pennsylvania,9061000,5444732,4978180,466552
1980-09-01,Tennessee,3409000,2072764,1911325,161439
1980-09-01,Texas,10291000,6813115,6446343,366772
1980-09-01,Utah,968000,636013,593004,43009
1980-09-01,Vermont,378000,251140,235036,16104
1980-09-01,Virginia,3903000,2570005,2432898,137107
1980-09-01,Washington,3073000,1975279,1808975,166304
1980-09-01,Wisconsin,3484000,2361355,2159440,201915
1980-09-01,Wyoming,338000,237865,227813,10052
1980-10-01,Alabama,2840000,1683774,1524552,159222
1980-10-01,Alaska,266000,189613,171186,18427
1980-10-01,Arizona,2010000,1243708,1159599,84109
1980-10-01,Arkansas,1675000,997626,916762,80864
1980-10-01,California,17803000,11668794,10832315,836479
1980-10-01,Colorado,2145000,1509468,1412241,97227
1980-10-01,Connecticut,2377000,1584399,1490746,93653
1980-10-01,Delaware,441000,284590,262465,22125
1980-10-01,Florida,7699000,4348009,4080865,267144
1980-10-01,Georgia,3947000,2546204,2383318,162886
1980-10-01,Hawaii,667000,443539,420804,22735
1980-10-01,Idaho,663000,427260,394138,33122
1980-10-01,Illinois,8491000,5542993,5044553,498440
1980-10-01,Indiana,4020000,2609740,2349479,260261
1980-10-01,Iowa,2154000,1414904,1322177,92727
1980-10-01,Kansas,1744000,1181171,1125301,55870
1980-10-01,Kentucky,2657000,1674885,1526677,148208
1980-10-01,Louisiana,3000000,1798408,1665949,132459
1980-10-01,Maine,829000,506600,467380,39220
1980-10-01,Maryland,3159000,2151355,2003894,147461
1980-10-01,Massachusetts,4387000,2889614,2718477,171137
1980-10-01,Michigan,6776000,4305795,3747158,558637
1980-10-01,Minnesota,3020000,2113108,1987864,125244
1980-10-01,Mississippi,1778000,1053890,969359,84531
1980-10-01,Missouri,3670000,2336773,2157063,179710
1980-10-01,Montana,577000,373039,348156,24883
1980-10-01,Nebraska,1151000,765613,733722,31891
1980-10-01,Nevada,614000,440370,409469,30901
1980-10-01,Ohio,8007000,5076137,4610106,466031
1980-10-01,Oklahoma,2233000,1390605,1325903,64702
1980-10-01,Oregon,1983000,1300459,1184464,115995
1980-10-01,Pennsylvania,9066000,5440182,4985961,454221
1980-10-01,Tennessee,3413000,2078885,1916199,162686
1980-10-01,Texas,10318000,6841575,6475138,366437
1980-10-01,Utah,970000,637049,593774,43275
1980-10-01,Vermont,378000,251674,235876,15798
1980-10-01,Virginia,3909000,2572979,2438368,134611
1980-10-01,Washington,3078000,1979856,1814001,165855
1980-10-01,Wisconsin,3487000,2357911,2160444,197467
1980-10-01,Wyoming,339000,239145,228779,10366
1980-11-01,Alabama,2843000,1683165,1523039,160126
1980-11-01,Alaska,267000,189777,171682,18095
1980-11-01,Arizona,2015000,1243372,1163086,80286
1980-11-01,Arkansas,1677000,1001805,920443,81362
1980-11-01,California,17834000,11680834,10849153,831681
1980-11-01,Colorado,2150000,1511699,1416373,95326
1980-11-01,Connecticut,2379000,1584038,1490457,93581
1980-11-01,Delaware,442000,284824,262874,21950
1980-11-01,Florida,7724000,4369528,4100019,269509
1980-11-01,Georgia,3955000,2548279,2389376,158903
1980-11-01,Hawaii,668000,444847,422115,22732
1980-11-01,Idaho,664000,427167,394951,32216
1980-11-01,Illinois,8496000,5547226,5050123,497103
1980-11-01,Indiana,4022000,2608771,2357280,251491
1980-11-01,Iowa,2155000,1417351,1326965,90386
1980-11-01,Kansas,1745000,1180561,1125737,54824
1980-11-01,Kentucky,2659000,1677030,1530346,146684
1980-11-01,Louisiana,3005000,1807615,1671114,136501
1980-11-01,Maine,830000,507224,468566,38658
1980-11-01,Maryland,3164000,2152710,2006845,145865
1980-11-01,Massachusetts,4391000,2898275,2727655,170620
1980-11-01,Michigan,6777000,4298532,3750250,548282
1980-11-01,Minnesota,3023000,2118307,1994871,123436
1980-11-01,Mississippi,1780000,1054179,968613,85566
1980-11-01,Missouri,3672000,2334124,2155300,178824
1980-11-01,Montana,577000,375050,350258,24792
1980-11-01,Nebraska,1152000,765616,734302,31314
1980-11-01,Nevada,616000,442811,411522,31289
1980-11-01,Ohio,8010000,5082644,4617812,464832
1980-11-01,Oklahoma,2237000,1393430,1333061,60369
1980-11-01,Oregon,1985000,1306792,1190745,116047
1980-11-01,Pennsylvania,9071000,5439107,4995758,443349
1980-11-01,Tennessee,3416000,2086586,1921761,164825
1980-11-01,Texas,10344000,6870471,6504739,365732
1980-11-01,Utah,972000,637889,594660,43229
1980-11-01,Vermont,379000,252270,236829,15441
1980-11-01,Virginia,3915000,2577244,2443598,133646
1980-11-01,Washington,3084000,1985164,1819040,166124
1980-11-01,Wisconsin,3490000,2356333,2163275,193058
1980-11-01,Wyoming,340000,240360,229751,10609
1980-12-01,Alabama,2846000,1683630,1522224,161406
1980-12-01,Alaska,268000,190229,172520,17709
1980-12-01,Arizona,2020000,1244212,1166841,77371
1980-12-01,Arkansas,1678000,1006658,924548,82110
1980-12-01,California,17866000,11699070,10869860,829210
1980-12-01,Colorado,2155000,1515156,1421383,93773
1980-12-01,Connecticut,2382000,1585073,1491220,93853
1980-12-01,Delaware,442000,285281,263374,21907
1980-12-01,Florida,7749000,4394409,4121336,273073
1980-12-01,Georgia,3962000,2552941,2396088,156853
1980-12-01,Hawaii,669000,446234,423512,22722
1980-12-01,Idaho,664000,427576,396218,31358
1980-12-01,Illinois,8500000,5555765,5060522,495243
1980-12-01,Indiana,4024000,2612443,2366012,246431
1980-12-01,Iowa,2156000,1421612,1333046,88566
1980-12-01,Kansas,1747000,1181101,1127155,53946
1980-12-01,Kentucky,2662000,1679115,1534517,144598
1980-12-01,Louisiana,3011000,1816595,1676409,140186
1980-12-01,Maine,830000,508134,470104,38030
1980-12-01,Maryland,3168000,2154888,2010335,144553
1980-12-01,Massachusetts,4395000,2906274,2735296,170978
1980-12-01,Michigan,6778000,4296885,3756634,540251
1980-12-01,Minnesota,3027000,2123739,2001765,121974
1980-12-01,Mississippi,1782000,1054690,968298,86392
1980-12-01,Missouri,3674000,2332956,2154480,178476
1980-12-01,Montana,578000,377179,352591,24588
1980-12-01,Nebraska,1153000,766189,735402,30787
1980-12-01,Nevada,619000,445577,413867,31710
1980-12-01,Ohio,8014000,5090430,4625869,464561
1980-12-01,Oklahoma,2242000,1397123,1341084,56039
1980-12-01,Oregon,1987000,1314068,1196289,117779
1980-12-01,Pennsylvania,9077000,5443838,5007386,436452
1980-12-01,Tennessee,3420000,2096357,1928393,167964
1980-12-01,Texas,10371000,6901394,6537127,364267
1980-12-01,Utah,975000,638903,595974,42929
1980-12-01,Vermont,379000,252989,237887,15102
1980-12-01,Virginia,3921000,2583162,2448440,134722
1980-12-01,Washington,3089000,1991160,1823745,167415
1980-12-01,Wisconsin,3494000,2358329,2168949,189380
1980-12-01,Wyoming,342000,241578,230814,10764
1981-01-01,Alabama,2849000,1685498,1522218,163280
1981-01-01,Alaska,269000,190991,173651,17340
1981-01-01,Arizona,2025000,1246734,1171248,75486
1981-01-01,Arkansas,1680000,1011856,928642,83214
1981-01-01,California,17897000,11723969,10894361,829608
1981-01-01,Colorado,2160000,1519614,1426873,92741
1981-01-01,Connecticut,2384000,1587478,1492994,94484
1981-01-01,Delaware,443000,285848,263866,21982
1981-01-01,Florida,7774000,4422672,4144893,277779
1981-01-01,Georgia,3970000,2560176,2403277,156899
1981-01-01,Hawaii,670000,447619,424874,22745
1981-01-01,Idaho,665000,428412,397745,30667
1981-01-01,Illinois,8505000,5568437,5075311,493126
1981-01-01,Indiana,4026000,2618895,2374142,244753
1981-01-01,Iowa,2157000,1426331,1338810,87521
1981-01-01,Kansas,1748000,1182700,1129454,53246
1981-01-01,Kentucky,2664000,1680890,1538381,142509
1981-01-01,Louisiana,3016000,1825169,1681880,143289
1981-01-01,Maine,831000,509116,471673,37443
1981-01-01,Maryland,3173000,2158081,2014306,143775
1981-01-01,Massachusetts,4399000,2914164,2741869,172295
1981-01-01,Michigan,6779000,4300995,3767185,533810
1981-01-01,Minnesota,3030000,2129484,2008252,121232
1981-01-01,Mississippi,1784000,1055351,968574,86777
1981-01-01,Missouri,3676000,2333555,2154970,178585
1981-01-01,Montana,578000,379245,354822,24423
1981-01-01,Nebraska,1154000,767411,737040,30371
1981-01-01,Nevada,621000,448671,416536,32135
1981-01-01,Ohio,8017000,5099663,4635073,464590
1981-01-01,Oklahoma,2246000,1402254,1349893,52361
1981-01-01,Oregon,1989000,1321021,1200618,120403
1981-01-01,Pennsylvania,9082000,5453990,5019085,434905
1981-01-01,Tennessee,3423000,2107537,1935409,172128
1981-01-01,Texas,10397000,6935389,6572110,363279
1981-01-01,Utah,977000,640297,597770,42527
1981-01-01,Vermont,380000,253865,239018,14847
1981-01-01,Virginia,3927000,2590292,2452455,137837
1981-01-01,Washington,3095000,1997590,1827884,169706
1981-01-01,Wisconsin,3497000,2363182,2176736,186446
1981-01-01,Wyoming,343000,242807,232001,10806
1981-02-01,Alabama,2852000,1688377,1522734,165643
1981-02-01,Alaska,269000,191959,174915,17044
1981-02-01,Arizona,2030000,1250512,1176120,74392
1981-02-01,Arkansas,1681000,1016623,932104,84519
1981-02-01,California,17928000,11750764,10918962,831802
1981-02-01,Colorado,2165000,1524485,1432404,92081
1981-02-01,Connecticut,2387000,1590456,1495144,95312
1981-02-01,Delaware,443000,286384,264303,22081
1981-02-01,Florida,7799000,4452450,4169086,283364
1981-02-01,Georgia,3978000,2568537,2410259,158278
1981-02-01,Hawaii,671000,448880,426066,22814
1981-02-01,Idaho,666000,429370,399083,30287
1981-02-01,Illinois,8510000,5583009,5093302,489707
1981-02-01,Indiana,4028000,2624955,2379944,245011
1981-02-01,Iowa,2158000,1429913,1342673,87240
1981-02-01,Kansas,1749000,1184629,1132047,52582
1981-02-01,Kentucky,2666000,1681597,1540934,140663
1981-02-01,Louisiana,3021000,1832920,1686833,146087
1981-02-01,Maine,832000,509972,473058,36914
1981-02-01,Maryland,3177000,2161440,2017806,143634
1981-02-01,Massachusetts,4403000,2922141,2747802,174339
1981-02-01,Michigan,6781000,4307862,3780026,527836
1981-02-01,Minnesota,3033000,2134856,2013912,120944
1981-02-01,Mississippi,1786000,1056026,969344,86682
1981-02-01,Missouri,3679000,2334719,2156256,178463
1981-02-01,Montana,579000,380921,356596,24325
1981-02-01,Nebraska,1155000,769093,739016,30077
1981-02-01,Nevada,623000,451788,419338,32450
1981-02-01,Ohio,8021000,5108835,4644887,463948
1981-02-01,Oklahoma,2250000,1408484,1358844,49640
1981-02-01,Oregon,1991000,1326362,1203465,122897
1981-02-01,Pennsylvania,9087000,5466528,5029178,437350
1981-02-01,Tennessee,3427000,2117526,1941013,176513
1981-02-01,Texas,10424000,6971036,6607523,363513
1981-02-01,Utah,979000,641939,599799,42140
1981-02-01,Vermont,380000,254817,240134,14683
1981-02-01,Virginia,3933000,2597419,2455304,142115
1981-02-01,Washington,3100000,2003585,1831159,172426
1981-02-01,Wisconsin,3500000,2368927,2184802,184125
1981-02-01,Wyoming,344000,243999,233270,10729
1981-03-01,Alabama,2855000,1691098,1523245,167853
1981-03-01,Alaska,270000,192992,176114,16878
1981-03-01,Arizona,2035000,1255162,1181441,73721
1981-03-01,Arkansas,1682000,1020332,934619,85713
1981-03-01,California,17960000,11774300,10941358,832942
1981-03-01,Colorado,2170000,1529299,1438251,91048
1981-03-01,Connecticut,2389000,1593354,1497309,96045
1981-03-01,Delaware,443000,286890,264781,22109
1981-03-01,Florida,7824000,4481415,4192596,288819
1981-03-01,Georgia,3985000,2576725,2417114,159611
1981-03-01,Hawaii,672000,449883,427029,22854
1981-03-01,Idaho,667000,430199,399978,30221
1981-03-01,Illinois,8515000,5596778,5112980,483798
1981-03-01,Indiana,4030000,2629283,2383795,245488
1981-03-01,Iowa,2159000,1431552,1344249,87303
1981-03-01,Kansas,1751000,1186223,1134536,51687
1981-03-01,Kentucky,2668000,1680588,1541350,139238
1981-03-01,Louisiana,3027000,1839670,1690744,148926
1981-03-01,Maine,833000,510632,474287,36345
1981-03-01,Maryland,3181000,2164063,2020115,143948
1981-03-01,Massachusetts,4407000,2930165,2753577,176588
1981-03-01,Michigan,6782000,4313304,3792230,521074
1981-03-01,Minnesota,3036000,2139367,2018907,120460
1981-03-01,Mississippi,1788000,1056524,970317,86207
1981-03-01,Missouri,3681000,2334989,2157755,177234
1981-03-01,Montana,580000,382037,357784,24253
1981-03-01,Nebraska,1156000,770955,741107,29848
1981-03-01,Nevada,626000,454632,422111,32521
1981-03-01,Ohio,8025000,5116967,4655024,461943
1981-03-01,Oklahoma,2254000,1415073,1367229,47844
1981-03-01,Oregon,1993000,1329444,1205006,124438
1981-03-01,Pennsylvania,9092000,5478341,5037860,440481
1981-03-01,Tennessee,3430000,2124340,1944627,179713
1981-03-01,Texas,10451000,7006295,6641393,364902
1981-03-01,Utah,982000,643675,601852,41823
1981-03-01,Vermont,380000,255719,241156,14563
1981-03-01,Virginia,3939000,2603817,2457617,146200
1981-03-01,Washington,3106000,2008451,1833337,175114
1981-03-01,Wisconsin,3503000,2373741,2191924,181817
1981-03-01,Wyoming,345000,245133,234581,10552
1981-04-01,Alabama,2858000,1692219,1522540,169679
1981-04-01,Alaska,271000,194082,177186,16896
1981-04-01,Arizona,2039000,1260215,1186880,73335
1981-04-01,Arkansas,1684000,1022615,935998,86617
1981-04-01,California,17991000,11790031,10957775,832256
1981-04-01,Colorado,2175000,1533694,1444505,89189
1981-04-01,Connecticut,2392000,1595715,1499120,96595
1981-04-01,Delaware,444000,287384,265361,22023
1981-04-01,Florida,7849000,4506802,4213318,293484
1981-04-01,Georgia,3993000,2583432,2423412,160020
1981-04-01,Hawaii,673000,450484,427712,22772
1981-04-01,Idaho,668000,430742,400312,30430
1981-04-01,Illinois,8520000,5607095,5130635,476460
1981-04-01,Indiana,4031000,2630786,2385645,245141
1981-04-01,Iowa,2159000,1431617,1344114,87503
1981-04-01,Kansas,1752000,1186766,1136311,50455
1981-04-01,Kentucky,2670000,1677559,1539336,138223
1981-04-01,Louisiana,3032000,1844965,1693226,151739
1981-04-01,Maine,834000,511065,475296,35769
1981-04-01,Maryland,3186000,2165682,2020928,144754
1981-04-01,Massachusetts,4410000,2937365,2758556,178809
1981-04-01,Michigan,6783000,4313987,3799979,514008
1981-04-01,Minnesota,3039000,2142569,2023091,119478
1981-04-01,Mississippi,1790000,1056486,970766,85720
1981-04-01,Missouri,3683000,2333164,2158263,174901
1981-04-01,Montana,580000,382612,358349,24263
1981-04-01,Nebraska,1156000,772540,742815,29725
1981-04-01,Nevada,628000,457010,424674,32336
1981-04-01,Ohio,8028000,5122788,4663185,459603
1981-04-01,Oklahoma,2258000,1421146,1374305,46841
1981-04-01,Oregon,1996000,1330420,1205507,124913
1981-04-01,Pennsylvania,9097000,5485393,5043177,442216
1981-04-01,Tennessee,3434000,2126974,1945659,181315
1981-04-01,Texas,10477000,7038486,6670790,367696
1981-04-01,Utah,984000,645343,603704,41639
1981-04-01,Vermont,381000,256470,241982,14488
1981-04-01,Virginia,3945000,2608524,2459378,149146
1981-04-01,Washington,3111000,2011743,1834123,177620
1981-04-01,Wisconsin,3506000,2376293,2197131,179162
1981-04-01,Wyoming,346000,246171,235841,10330
1981-05-01,Alabama,2861000,1690978,1519595,171383
1981-05-01,Alaska,272000,195256,178121,17135
1981-05-01,Arizona,2044000,1264947,1191756,73191
1981-05-01,Arkansas,1685000,1023402,936357,87045
1981-05-01,California,18022000,11796687,10965053,831634
1981-05-01,Colorado,2180000,1537296,1450725,86571
1981-05-01,Connecticut,2394000,1597195,1500200,96995
1981-05-01,Delaware,444000,287855,266009,21846
1981-05-01,Florida,7874000,4526968,4229482,297486
1981-05-01,Georgia,4001000,2588069,2428358,159711
1981-05-01,Hawaii,674000,450659,428068,22591
1981-05-01,Idaho,669000,430835,399971,30864
1981-05-01,Illinois,8525000,5611739,5142327,469412
1981-05-01,Indiana,4033000,2628998,2384868,244130
1981-05-01,Iowa,2160000,1430813,1342827,87986
1981-05-01,Kansas,1753000,1185871,1136715,49156
1981-05-01,Kentucky,2672000,1672869,1535277,137592
1981-05-01,Louisiana,3037000,1848021,1694308,153713
1981-05-01,Maine,834000,511265,475948,35317
1981-05-01,Maryland,3190000,2166227,2020196,146031
1981-05-01,Massachusetts,4414000,2942698,2761727,180971
1981-05-01,Michigan,6784000,4308744,3801140,507604
1981-05-01,Minnesota,3042000,2144086,2025861,118225
1981-05-01,Mississippi,1792000,1055682,970140,85542
1981-05-01,Missouri,3685000,2329089,2156721,172368
1981-05-01,Montana,581000,382692,358286,24406
1981-05-01,Nebraska,1157000,773510,743683,29827
1981-05-01,Nevada,630000,458890,426828,32062
1981-05-01,Ohio,8032000,5124578,4665650,458928
1981-05-01,Oklahoma,2262000,1426165,1379714,46451
1981-05-01,Oregon,1998000,1329992,1205319,124673
1981-05-01,Pennsylvania,9102000,5485295,5042858,442437
1981-05-01,Tennessee,3437000,2125265,1943428,181837
1981-05-01,Texas,10504000,7065284,6693816,371468
1981-05-01,Utah,986000,646764,605129,41635
1981-05-01,Vermont,381000,257009,242550,14459
1981-05-01,Virginia,3951000,2610903,2460177,150726
1981-05-01,Washington,3117000,2013005,1833151,179854
1981-05-01,Wisconsin,3510000,2376251,2199665,176586
1981-05-01,Wyoming,347000,247014,236912,10102
1981-06-01,Alabama,2864000,1687704,1514252,173452
1981-06-01,Alaska,272000,196600,179044,17556
1981-06-01,Arizona,2049000,1269046,1195802,73244
1981-06-01,Arkansas,1687000,1023234,936142,87092
1981-06-01,California,18054000,11798722,10964400,834322
1981-06-01,Colorado,2185000,1540648,1456853,83795
1981-06-01,Connecticut,2397000,1598138,1500772,97366
1981-06-01,Delaware,445000,288207,266530,21677
1981-06-01,Florida,7899000,4542138,4240700,301438
1981-06-01,Georgia,4008000,2591462,2431836,159626
1981-06-01,Hawaii,675000,450590,428126,22464
1981-06-01,Idaho,670000,430575,399165,31410
1981-06-01,Illinois,8530000,5610993,5146700,464293
1981-06-01,Indiana,4035000,2624799,2381500,243299
1981-06-01,Iowa,2161000,1429749,1340846,88903
1981-06-01,Kansas,1755000,1183879,1135755,48124
1981-06-01,Kentucky,2674000,1667502,1529958,137544
1981-06-01,Louisiana,3043000,1849087,1694461,154626
1981-06-01,Maine,835000,511432,476265,35167
1981-06-01,Maryland,3195000,2166128,2018263,147865
1981-06-01,Massachusetts,4418000,2946206,2762950,183256
1981-06-01,Michigan,6786000,4299513,3796103,503410
1981-06-01,Minnesota,3045000,2144209,2026785,117424
1981-06-01,Mississippi,1794000,1054262,968356,85906
1981-06-01,Missouri,3688000,2323888,2153148,170740
1981-06-01,Montana,581000,382498,357791,24707
1981-06-01,Nebraska,1158000,773861,743631,30230
1981-06-01,Nevada,633000,460528,428591,31937
1981-06-01,Ohio,8035000,5122315,4660241,462074
1981-06-01,Oklahoma,2266000,1430233,1383680,46553
1981-06-01,Oregon,2000000,1328771,1204448,124323
1981-06-01,Pennsylvania,9107000,5479478,5037093,442385
1981-06-01,Tennessee,3441000,2120604,1938384,182220
1981-06-01,Texas,10530000,7086544,6711343,375201
1981-06-01,Utah,989000,648019,606220,41799
1981-06-01,Vermont,382000,257385,242907,14478
1981-06-01,Virginia,3957000,2611606,2460094,151512
1981-06-01,Washington,3122000,2012251,1830205,182046
1981-06-01,Wisconsin,3513000,2374731,2199478,175253
1981-06-01,Wyoming,348000,247664,237747,9917
1981-07-01,Alabama,2867000,1683638,1506961,176677
1981-07-01,Alaska,273000,198164,180052,18112
1981-07-01,Arizona,2054000,1272625,1198644,73981
1981-07-01,Arkansas,1688000,1022961,935714,87247
1981-07-01,California,18085000,11803386,10958160,845226
1981-07-01,Colorado,2190000,1544166,1462378,81788
1981-07-01,Connecticut,2399000,1599354,1501305,98049
1981-07-01,Delaware,445000,288380,266717,21663
1981-07-01,Florida,7924000,4553762,4246980,306782
1981-07-01,Georgia,4016000,2594830,2433524,161306
1981-07-01,Hawaii,676000,450497,427986,22511
1981-07-01,Idaho,671000,430252,398179,32073
1981-07-01,Illinois,8535000,5606767,5143544,463223
1981-07-01,Indiana,4037000,2620040,2375622,244418
1981-07-01,Iowa,2162000,1429031,1338410,90621
1981-07-01,Kansas,1756000,1181449,1133743,47706
1981-07-01,Kentucky,2676000,1662527,1523832,138695
1981-07-01,Louisiana,3048000,1849329,1694063,155266
1981-07-01,Maine,836000,511883,476401,35482
1981-07-01,Maryland,3199000,2166150,2015545,150605
1981-07-01,Massachusetts,4422000,2948906,2762612,186294
1981-07-01,Michigan,6787000,4290056,3785395,504661
1981-07-01,Minnesota,3048000,2143749,2025780,117969
1981-07-01,Mississippi,1796000,1052811,965661,87150
1981-07-01,Missouri,3690000,2319107,2147888,171219
1981-07-01,Montana,582000,382417,357190,25227
1981-07-01,Nebraska,1159000,773817,742821,30996
1981-07-01,Nevada,635000,462239,430012,32227
1981-07-01,Ohio,8039000,5118066,4646606,471460
1981-07-01,Oklahoma,2270000,1433776,1386470,47306
1981-07-01,Oregon,2002000,1327746,1202739,125007
1981-07-01,Pennsylvania,9112000,5471378,5026919,444459
1981-07-01,Tennessee,3444000,2115315,1931548,183767
1981-07-01,Texas,10557000,7103336,6724751,378585
1981-07-01,Utah,991000,649353,607110,42243
1981-07-01,Vermont,382000,257719,243123,14596
1981-07-01,Virginia,3963000,2611890,2459075,152815
1981-07-01,Washington,3128000,2009828,1824962,184866
1981-07-01,Wisconsin,3516000,2373369,2196959,176410
1981-07-01,Wyoming,349000,248189,238352,9837
1981-08-01,Alabama,2869000,1680501,1498987,181514
1981-08-01,Alaska,275000,199895,181194,18701
1981-08-01,Arizona,2060000,1276300,1200097,76203
1981-08-01,Arkansas,1689000,1022897,935039,87858
1981-08-01,California,18116000,11815570,10948874,866696
1981-08-01,Colorado,2196000,1547783,1466635,81148
1981-08-01,Connecticut,2401000,1601367,1502129,99238
1981-08-01,Delaware,446000,288452,266556,21896
1981-08-01,Florida,7944000,4563563,4249731,313832
1981-08-01,Georgia,4022000,2599069,2433433,165636
1981-08-01,Hawaii,677000,450550,427797,22753
1981-08-01,Idaho,672000,430119,397205,32914
1981-08-01,Illinois,8537000,5600965,5134016,466949
1981-08-01,Indiana,4038000,2616148,2367169,248979
1981-08-01,Iowa,2162000,1428597,1335271,93326
1981-08-01,Kansas,1757000,1179222,1131088,48134
1981-08-01,Kentucky,2678000,1658753,1517482,141271
1981-08-01,Louisiana,3053000,1849501,1693125,156376
1981-08-01,Maine,837000,512712,476486,36226
1981-08-01,Maryland,3202000,2166828,2012493,154335
1981-08-01,Massachusetts,4424000,2951828,2761367,190461
1981-08-01,Michigan,6784000,4283450,3770015,513435
1981-08-01,Minnesota,3050000,2143405,2023287,120118
1981-08-01,Mississippi,1798000,1051886,962669,89217
1981-08-01,Missouri,3691000,2316019,2141786,174233
1981-08-01,Montana,583000,382585,356685,25900
1981-08-01,Nebraska,1159000,773671,741638,32033
1981-08-01,Nevada,637000,464177,431174,33003
1981-08-01,Ohio,8040000,5113477,4626744,486733
1981-08-01,Oklahoma,2277000,1437420,1388545,48875
1981-08-01,Oregon,2002000,1327385,1200036,127349
1981-08-01,Pennsylvania,9115000,5463821,5013039,450782
1981-08-01,Tennessee,3447000,2110879,1923742,187137
1981-08-01,Texas,10593000,7116988,6735502,381486
1981-08-01,Utah,993000,650929,607947,42982
1981-08-01,Vermont,382000,258112,243253,14859
1981-08-01,Virginia,3968000,2612628,2457170,155458
1981-08-01,Washington,3131000,2006766,1817850,188916
1981-08-01,Wisconsin,3518000,2373326,2192921,180405
1981-08-01,Wyoming,350000,248624,238748,9876
1981-09-01,Alabama,2871000,1679619,1491854,187765
1981-09-01,Alaska,276000,201610,182413,19197
1981-09-01,Arizona,2065000,1280890,1200974,79916
1981-09-01,Arkansas,1690000,1022891,933923,88968
1981-09-01,California,18146000,11836665,10939588,897077
1981-09-01,Colorado,2202000,1551398,1469377,82021
1981-09-01,Connecticut,2402000,1604252,1503406,100846
1981-09-01,Delaware,446000,288559,266176,22383
1981-09-01,Florida,7965000,4573121,4251210,321911
1981-09-01,Georgia,4028000,2604125,2432272,171853
1981-09-01,Hawaii,678000,450801,427609,23192
1981-09-01,Idaho,673000,430412,396399,34013
1981-09-01,Illinois,8539000,5595793,5120853,474940
1981-09-01,Indiana,4039000,2613766,2356868,256898
1981-09-01,Iowa,2161000,1428186,1331501,96685
1981-09-01,Kansas,1759000,1177519,1128133,49386
1981-09-01,Kentucky,2680000,1656552,1511642,144910
1981-09-01,Louisiana,3059000,1850202,1691667,158535
1981-09-01,Maine,837000,513795,476559,37236
1981-09-01,Maryland,3204000,2168432,2009515,158917
1981-09-01,Massachusetts,4426000,2955256,2759664,195592
1981-09-01,Michigan,6782000,4280878,3752131,528747
1981-09-01,Minnesota,3052000,2143528,2020017,123511
1981-09-01,Mississippi,1799000,1051926,959996,91930
1981-09-01,Missouri,3692000,2315064,2135803,179261
1981-09-01,Montana,583000,382951,356337,26614
1981-09-01,Nebraska,1160000,773610,740435,33175
1981-09-01,Nevada,639000,466393,432206,34187
1981-09-01,Ohio,8041000,5110039,4604897,505142
1981-09-01,Oklahoma,2284000,1441656,1390344,51312
1981-09-01,Oregon,2002000,1327227,1196392,130835
1981-09-01,Pennsylvania,9118000,5458833,4996878,461955
1981-09-01,Tennessee,3450000,2107357,1915207,192150
1981-09-01,Texas,10629000,7129802,6745214,384588
1981-09-01,Utah,995000,652786,608914,43872
1981-09-01,Vermont,383000,258581,243333,15248
1981-09-01,Virginia,3973000,2614404,2454812,159592
1981-09-01,Washington,3133000,2004403,1809930,194473
1981-09-01,Wisconsin,3520000,2375099,2188645,186454
1981-09-01,Wyoming,351000,249015,239003,10012
1981-10-01,Alabama,2873000,1681576,1486599,194977
1981-10-01,Alaska,278000,203206,183641,19565
1981-10-01,Arizona,2071000,1286900,1202269,84631
1981-10-01,Arkansas,1690000,1022800,932339,90461
1981-10-01,California,18177000,11866712,10932487,934225
1981-10-01,Colorado,2207000,1554880,1470419,84461
1981-10-01,Connecticut,2404000,1607678,1504921,102757
1981-10-01,Delaware,447000,288841,265811,23030
1981-10-01,Florida,7985000,4583662,4253200,330462
1981-10-01,Georgia,4034000,2609757,2431170,178587
1981-10-01,Hawaii,679000,451211,427350,23861
1981-10-01,Idaho,673000,431321,395910,35411
1981-10-01,Illinois,8541000,5592736,5106154,486582
1981-10-01,Indiana,4040000,2613124,2345649,267475
1981-10-01,Iowa,2161000,1427339,1326954,100385
1981-10-01,Kansas,1760000,1176580,1125240,51340
1981-10-01,Kentucky,2681000,1655770,1506595,149175
1981-10-01,Louisiana,3064000,1852027,1690004,162023
1981-10-01,Maine,838000,514978,476538,38440
1981-10-01,Maryland,3207000,2171116,2006970,164146
1981-10-01,Massachusetts,4427000,2959274,2757816,201458
1981-10-01,Michigan,6779000,4282783,3733727,549056
1981-10-01,Minnesota,3054000,2144485,2016749,127736
1981-10-01,Mississippi,1801000,1053099,958162,94937
1981-10-01,Missouri,3693000,2316130,2130626,185504
1981-10-01,Montana,584000,383517,356121,27396
1981-10-01,Nebraska,1160000,773767,739426,34341
1981-10-01,Nevada,641000,468849,433194,35655
1981-10-01,Ohio,8041000,5109162,4584313,524849
1981-10-01,Oklahoma,2291000,1446604,1392077,54527
1981-10-01,Oregon,2002000,1326835,1192007,134828
1981-10-01,Pennsylvania,9121000,5457418,4980051,477367
1981-10-01,Tennessee,3453000,2104724,1905990,198734
1981-10-01,Texas,10665000,7145053,6755616,389437
1981-10-01,Utah,997000,654957,610111,44846
1981-10-01,Vermont,383000,259093,243412,15681
1981-10-01,Virginia,3978000,2617504,2452315,165189
1981-10-01,Washington,3136000,2003785,1802612,201173
1981-10-01,Wisconsin,3522000,2378284,2185301,192983
1981-10-01,Wyoming,351000,249335,239203,10132
1981-11-01,Alabama,2875000,1685624,1483079,202545
1981-11-01,Alaska,279000,204485,184652,19833
1981-11-01,Arizona,2076000,1293525,1203518,90007
1981-11-01,Arkansas,1691000,1022290,930170,92120
1981-11-01,California,18208000,11901732,10926218,975514
1981-11-01,Colorado,2213000,1557866,1469637,88229
1981-11-01,Connecticut,2405000,1610840,1506029,104811
1981-11-01,Delaware,447000,289362,265644,23718
1981-11-01,Florida,8005000,4595133,4255819,339314
1981-11-01,Georgia,4040000,2615247,2430460,184787
1981-11-01,Hawaii,681000,451606,426900,24706
1981-11-01,Idaho,674000,432684,395612,37072
1981-11-01,Illinois,8543000,5591237,5090236,501001
1981-11-01,Indiana,4041000,2613025,2333439,279586
1981-11-01,Iowa,2161000,1425200,1320979,104221
1981-11-01,Kansas,1761000,1176383,1122607,53776
1981-11-01,Kentucky,2683000,1655933,1502217,153716
1981-11-01,Louisiana,3069000,1854387,1688048,166339
1981-11-01,Maine,838000,516062,476286,39776
1981-11-01,Maryland,3209000,2174314,2004613,169701
1981-11-01,Massachusetts,4429000,2963194,2755527,207667
1981-11-01,Michigan,6776000,4286652,3714189,572463
1981-11-01,Minnesota,3056000,2145883,2013395,132488
1981-11-01,Mississippi,1803000,1054973,957034,97939
1981-11-01,Missouri,3694000,2318097,2126326,191771
1981-11-01,Montana,584000,384090,355774,28316
1981-11-01,Nebraska,1161000,774067,738660,35407
1981-11-01,Nevada,643000,471336,433994,37342
1981-11-01,Ohio,8042000,5109536,4564749,544787
1981-11-01,Oklahoma,2298000,1451783,1393622,58161
1981-11-01,Oregon,2002000,1325814,1186790,139024
1981-11-01,Pennsylvania,9124000,5458880,4963387,495493
1981-11-01,Tennessee,3456000,2102455,1895816,206639
1981-11-01,Texas,10701000,7163312,6766201,397111
1981-11-01,Utah,1000000,657185,611318,45867
1981-11-01,Vermont,384000,259650,243490,16160
1981-11-01,Virginia,3983000,2621775,2450074,171701
1981-11-01,Washington,3139000,2005034,1796706,208328
1981-11-01,Wisconsin,3524000,2382227,2182522,199705
1981-11-01,Wyoming,352000,249514,239314,10200
1981-12-01,Alabama,2877000,1690724,1480970,209754
1981-12-01,Alaska,281000,205430,185377,20053
1981-12-01,Arizona,2082000,1300346,1204430,95916
1981-12-01,Arkansas,1692000,1021219,927597,93622
1981-12-01,California,18238000,11938852,10921096,1017756
1981-12-01,Colorado,2219000,1560875,1468238,92637
1981-12-01,Connecticut,2407000,1613234,1506492,106742
1981-12-01,Delaware,448000,290176,265860,24316
1981-12-01,Florida,8025000,4607654,4259202,348452
1981-12-01,Georgia,4046000,2620395,2430583,189812
1981-12-01,Hawaii,682000,451931,426342,25589
1981-12-01,Idaho,675000,434339,395444,38895
1981-12-01,Illinois,8545000,5590452,5073409,517043
1981-12-01,Indiana,4042000,2612658,2321423,291235
1981-12-01,Iowa,2160000,1421896,1314054,107842
1981-12-01,Kansas,1763000,1176891,1120481,56410
1981-12-01,Kentucky,2685000,1657217,1498983,158234
1981-12-01,Louisiana,3075000,1856719,1685998,170721
1981-12-01,Maine,839000,517033,475894,41139
1981-12-01,Maryland,3212000,2177386,2002339,175047
1981-12-01,Massachusetts,4431000,2966731,2753066,213665
1981-12-01,Michigan,6773000,4289540,3693599,595941
1981-12-01,Minnesota,3058000,2147684,2010114,137570
1981-12-01,Mississippi,1804000,1057205,956306,100899
1981-12-01,Missouri,3695000,2319647,2122952,196695
1981-12-01,Montana,585000,384534,355215,29319
1981-12-01,Nebraska,1161000,774579,738194,36385
1981-12-01,Nevada,645000,473692,434523,39169
1981-12-01,Ohio,8043000,5109864,4546152,563712
1981-12-01,Oklahoma,2305000,1456801,1395115,61686
1981-12-01,Oregon,2002000,1324249,1181312,142937
1981-12-01,Pennsylvania,9127000,5463094,4949152,513942
1981-12-01,Tennessee,3459000,2100796,1885816,214980
1981-12-01,Texas,10737000,7184541,6776911,407630
1981-12-01,Utah,1002000,659255,612399,46856
1981-12-01,Vermont,384000,260273,243590,16683
1981-12-01,Virginia,3988000,2627401,2449226,178175
1981-12-01,Washington,3141000,2007738,1792573,215165
1981-12-01,Wisconsin,3526000,2387035,2179775,207260
1981-12-01,Wyoming,353000,249674,239343,10331
1982-01-01,Alabama,2879000,1696066,1480163,215903
1982-01-01,Alaska,282000,206145,185922,20223
1982-01-01,Arizona,2087000,1307630,1205533,102097
1982-01-01,Arkansas,1693000,1019808,925247,94561
1982-01-01,California,18269000,11977339,10920493,1056846
1982-01-01,Colorado,2225000,1564632,1467872,96760
1982-01-01,Connecticut,2408000,1614841,1506580,108261
1982-01-01,Delaware,448000,291291,266577,24714
1982-01-01,Florida,8046000,4621497,4264328,357169
1982-01-01,Georgia,4052000,2625783,2432452,193331
1982-01-01,Hawaii,683000,452286,425920,26366
1982-01-01,Idaho,676000,436242,395605,40637
1982-01-01,Illinois,8547000,5590465,5056953,533512
1982-01-01,Indiana,4043000,2612301,2312107,300194
1982-01-01,Iowa,2160000,1418441,1307589,110852
1982-01-01,Kansas,1764000,1178288,1119210,59078
1982-01-01,Kentucky,2687000,1659929,1497571,162358
1982-01-01,Louisiana,3080000,1859105,1684565,174540
1982-01-01,Maine,839000,517943,475691,42252
1982-01-01,Maryland,3214000,2180045,2000724,179321
1982-01-01,Massachusetts,4433000,2969919,2751134,218785
1982-01-01,Michigan,6771000,4288979,3673651,615328
1982-01-01,Minnesota,3060000,2150169,2007770,142399
1982-01-01,Mississippi,1806000,1059485,955739,103746
1982-01-01,Missouri,3695000,2320288,2120716,199572
1982-01-01,Montana,585000,384923,354603,30320
1982-01-01,Nebraska,1161000,775432,738067,37365
1982-01-01,Nevada,647000,475856,434878,40978
1982-01-01,Ohio,8044000,5110850,4531045,579805
1982-01-01,Oklahoma,2312000,1461530,1396904,64626
1982-01-01,Oregon,2002000,1322511,1176578,145933
1982-01-01,Pennsylvania,9130000,5468685,4939092,529593
1982-01-01,Tennessee,3461000,2100720,1878340,222380
1982-01-01,Texas,10773000,7209230,6789610,419620
1982-01-01,Utah,1004000,661157,613461,47696
1982-01-01,Vermont,384000,260921,243777,17144
1982-01-01,Virginia,3992000,2634487,2450901,183586
1982-01-01,Washington,3144000,2011125,1790275,220850
1982-01-01,Wisconsin,3527000,2392993,2177740,215253
1982-01-01,Wyoming,354000,249906,239374,10532
1982-02-01,Alabama,2881000,1701014,1479948,221066
1982-02-01,Alaska,284000,206871,186494,20377
1982-02-01,Arizona,2093000,1315378,1207024,108354
1982-02-01,Arkansas,1693000,1018554,923674,94880
1982-02-01,California,18300000,12017422,10924825,1092597
1982-02-01,Colorado,2230000,1569221,1468764,100457
1982-02-01,Connecticut,2410000,1615841,1506457,109384
1982-02-01,Delaware,449000,292534,267648,24886
1982-02-01,Florida,8066000,4636608,4271313,365295
1982-02-01,Georgia,4059000,2631824,2436029,195795
1982-02-01,Hawaii,684000,452818,425793,27025
1982-02-01,Idaho,676000,438247,396221,42026
1982-02-01,Illinois,8549000,5592216,5040845,551371
1982-02-01,Indiana,4044000,2612310,2306667,305643
1982-02-01,Iowa,2160000,1415734,1302454,113280
1982-02-01,Kansas,1765000,1180523,1118691,61832
1982-02-01,Kentucky,2689000,1664182,1497840,166342
1982-02-01,Louisiana,3085000,1861488,1684014,177474
1982-02-01,Maine,840000,518836,475709,43127
1982-02-01,Maryland,3217000,2182181,2000235,181946
1982-02-01,Massachusetts,4434000,2972620,2749662,222958
1982-02-01,Michigan,6768000,4284947,3656158,628789
1982-02-01,Minnesota,3062000,2153326,2006287,147039
1982-02-01,Mississippi,1808000,1061424,954922,106502
1982-02-01,Missouri,3696000,2320586,2119361,201225
1982-02-01,Montana,586000,385373,354090,31283
1982-02-01,Nebraska,1162000,776579,738125,38454
1982-02-01,Nevada,650000,477822,435130,42692
1982-02-01,Ohio,8045000,5113892,4520672,593220
1982-02-01,Oklahoma,2320000,1466134,1398907,67227
1982-02-01,Oregon,2003000,1321130,1173533,147597
1982-02-01,Pennsylvania,9133000,5474147,4932086,542061
1982-02-01,Tennessee,3464000,2103674,1875206,228468
1982-02-01,Texas,10810000,7237662,6804732,432930
1982-02-01,Utah,1006000,662980,614553,48427
1982-02-01,Vermont,385000,261557,244053,17504
1982-02-01,Virginia,3997000,2642431,2454818,187613
1982-02-01,Washington,3147000,2014500,1789275,225225
1982-02-01,Wisconsin,3529000,2400036,2176729,223307
1982-02-01,Wyoming,355000,250265,239418,10847
1982-03-01,Alabama,2883000,1705264,1479530,225734
1982-03-01,Alaska,286000,207852,187312,20540
1982-03-01,Arizona,2098000,1323148,1208626,114522
1982-03-01,Arkansas,1694000,1017725,922929,94796
1982-03-01,California,18330000,12057227,10930905,1126322
1982-03-01,Colorado,2236000,1574255,1470160,104095
1982-03-01,Connecticut,2412000,1616059,1505884,110175
1982-03-01,Delaware,449000,293564,268712,24852
1982-03-01,Florida,8086000,4651988,4279046,372942
1982-03-01,Georgia,4065000,2637878,2440222,197656
1982-03-01,Hawaii,685000,453597,425999,27598
1982-03-01,Idaho,677000,440044,397113,42931
1982-03-01,Illinois,8551000,5595928,5024547,571381
1982-03-01,Indiana,4045000,2611871,2304057,307814
1982-03-01,Iowa,2159000,1414209,1299085,115124
1982-03-01,Kansas,1767000,1183201,1118327,64874
1982-03-01,Kentucky,2691000,1669373,1499129,170244
1982-03-01,Louisiana,3091000,1863512,1684013,179499
1982-03-01,Maine,841000,519679,475781,43898
1982-03-01,Maryland,3219000,2183340,2000384,182956
1982-03-01,Massachusetts,4436000,2974644,2748309,226335
1982-03-01,Michigan,6765000,4279124,3642513,636611
1982-03-01,Minnesota,3064000,2156749,2004506,152243
1982-03-01,Mississippi,1809000,1062745,953561,109184
1982-03-01,Missouri,3697000,2320721,2118111,202610
1982-03-01,Montana,586000,385907,353771,32136
1982-03-01,Nebraska,1162000,777811,738125,39686
1982-03-01,Nevada,652000,479524,435251,44273
1982-03-01,Ohio,8046000,5118254,4513335,604919
1982-03-01,Oklahoma,2327000,1470731,1400724,70007
1982-03-01,Oregon,2003000,1320363,1172371,147992
1982-03-01,Pennsylvania,9136000,5477909,4925139,552770
1982-03-01,Tennessee,3467000,2109734,1876186,233548
1982-03-01,Texas,10846000,7268101,6820671,447430
1982-03-01,Utah,1008000,664743,615589,49154
1982-03-01,Vermont,385000,262152,244363,17789
1982-03-01,Virginia,4002000,2649800,2459349,190451
1982-03-01,Washington,3149000,2017252,1788724,228528
1982-03-01,Wisconsin,3531000,2407195,2175980,231215
1982-03-01,Wyoming,356000,250824,239407,11417
1982-04-01,Alabama,2885000,1709179,1478975,230204
1982-04-01,Alaska,287000,209206,188499,20707
1982-04-01,Arizona,2104000,1330924,1210338,120586
1982-04-01,Arkansas,1695000,1017553,922968,94585
1982-04-01,California,18361000,12096312,10938209,1158103
1982-04-01,Colorado,2242000,1579607,1471694,107913
1982-04-01,Connecticut,2413000,1615587,1504953,110634
1982-04-01,Delaware,450000,294201,269512,24689
1982-04-01,Florida,8106000,4667571,4287373,380198
1982-04-01,Georgia,4071000,2643635,2444546,199089
1982-04-01,Hawaii,686000,454635,426545,28090
1982-04-01,Idaho,678000,441609,398296,43313
1982-04-01,Illinois,8553000,5602282,5009249,593033
1982-04-01,Indiana,4046000,2610823,2303153,307670
1982-04-01,Iowa,2159000,1414025,1297746,116279
1982-04-01,Kansas,1768000,1186338,1117951,68387
1982-04-01,Kentucky,2692000,1674657,1500769,173888
1982-04-01,Louisiana,3096000,1865350,1684151,181199
1982-04-01,Maine,841000,520524,476071,44453
1982-04-01,Maryland,3222000,2183467,2000763,182704
1982-04-01,Massachusetts,4438000,2976981,2747948,229033
1982-04-01,Michigan,6762000,4273513,3633343,640170
1982-04-01,Minnesota,3066000,2160075,2001882,158193
1982-04-01,Mississippi,1811000,1063702,951883,111819
1982-04-01,Missouri,3698000,2321059,2116811,204248
1982-04-01,Montana,587000,386541,353764,32777
1982-04-01,Nebraska,1163000,779118,738182,40936
1982-04-01,Nevada,654000,481007,435295,45712
1982-04-01,Ohio,8046000,5123684,4507874,615810
1982-04-01,Oklahoma,2334000,1475538,1402185,73353
1982-04-01,Oregon,2003000,1320358,1172794,147564
1982-04-01,Pennsylvania,9139000,5480396,4917659,562737
1982-04-01,Tennessee,3470000,2117999,1880300,237699
1982-04-01,Texas,10882000,7299096,6836736,462360
1982-04-01,Utah,1010000,666639,616593,50046
1982-04-01,Vermont,386000,262698,244706,17992
1982-04-01,Virginia,4007000,2656160,2463695,192465
1982-04-01,Washington,3152000,2019115,1788126,230989
1982-04-01,Wisconsin,3533000,2413901,2175185,238716
1982-04-01,Wyoming,356000,251565,239325,12240
1982-05-01,Alabama,2887000,1713158,1478707,234451
1982-05-01,Alaska,289000,210822,189961,20861
1982-05-01,Arizona,2109000,1338465,1211947,126518
1982-05-01,Arkansas,1696000,1018103,923638,94465
1982-05-01,California,18392000,12133491,10946059,1187432
1982-05-01,Colorado,2248000,1584965,1472785,112180
1982-05-01,Connecticut,2415000,1614521,1503726,110795
1982-05-01,Delaware,450000,294450,269978,24472
1982-05-01,Florida,8127000,4682916,4296031,386885
1982-05-01,Georgia,4077000,2648777,2448630,200147
1982-05-01,Hawaii,688000,455833,427388,28445
1982-05-01,Idaho,679000,443027,399739,43288
1982-05-01,Illinois,8555000,5610453,4995491,614962
1982-05-01,Indiana,4047000,2609626,2303169,306457
1982-05-01,Iowa,2159000,1414745,1297922,116823
1982-05-01,Kansas,1769000,1189967,1117781,72186
1982-05-01,Kentucky,2694000,1679402,1502339,177063
1982-05-01,Louisiana,3101000,1866799,1683518,183281
1982-05-01,Maine,842000,521335,476618,44717
1982-05-01,Maryland,3224000,2182705,2001149,181556
1982-05-01,Massachusetts,4440000,2980097,2749004,231093
1982-05-01,Michigan,6760000,4268998,3627142,641856
1982-05-01,Minnesota,3068000,2162944,1998509,164435
1982-05-01,Mississippi,1813000,1064614,950229,114385
1982-05-01,Missouri,3699000,2321735,2115482,206253
1982-05-01,Montana,587000,387218,354067,33151
1982-05-01,Nebraska,1163000,780460,738445,42015
1982-05-01,Nevada,656000,482266,435282,46984
1982-05-01,Ohio,8047000,5129188,4503145,626043
1982-05-01,Oklahoma,2341000,1480624,1403000,77624
1982-05-01,Oregon,2003000,1320936,1174112,146824
1982-05-01,Pennsylvania,9142000,5481914,4909376,572538
1982-05-01,Tennessee,3473000,2127067,1886024,241043
1982-05-01,Texas,10918000,7328925,6851337,477588
1982-05-01,Utah,1013000,668695,617523,51172
1982-05-01,Vermont,386000,263136,245051,18085
1982-05-01,Virginia,4012000,2661607,2467499,194108
1982-05-01,Washington,3155000,2020131,1787313,232818
1982-05-01,Wisconsin,3535000,2419756,2174547,245209
1982-05-01,Wyoming,357000,252410,239158,13252
1982-06-01,Alabama,2889000,1717506,1478887,238619
1982-06-01,Alaska,290000,212495,191484,21011
1982-06-01,Arizona,2115000,1345200,1212891,132309
1982-06-01,Arkansas,1696000,1019095,924585,94510
1982-06-01,California,18422000,12165384,10950479,1214905
1982-06-01,Colorado,2253000,1590073,1472764,117309
1982-06-01,Connecticut,2416000,1612770,1502019,110751
1982-06-01,Delaware,451000,294463,270180,24283
1982-06-01,Florida,8147000,4697052,4303863,393189
1982-06-01,Georgia,4083000,2652922,2451649,201273
1982-06-01,Hawaii,689000,457043,428468,28575
1982-06-01,Idaho,679000,444365,401204,43161
1982-06-01,Illinois,8557000,5617611,4981498,636113
1982-06-01,Indiana,4048000,2608616,2302496,306120
1982-06-01,Iowa,2158000,1415728,1298554,117174
1982-06-01,Kansas,1771000,1193659,1117737,75922
1982-06-01,Kentucky,2696000,1683327,1503624,179703
1982-06-01,Louisiana,3107000,1867388,1681378,186010
1982-06-01,Maine,842000,521902,477130,44772
1982-06-01,Maryland,3227000,2181335,2001262,180073
1982-06-01,Massachusetts,4441000,2982975,2750305,232670
1982-06-01,Michigan,6757000,4265547,3620277,645270
1982-06-01,Minnesota,3070000,2164812,1994195,170617
1982-06-01,Mississippi,1814000,1065591,948798,116793
1982-06-01,Missouri,3700000,2322592,2113708,208884
1982-06-01,Montana,588000,387826,354508,33318
1982-06-01,Nebraska,1164000,781665,738855,42810
1982-06-01,Nevada,658000,483262,435135,48127
1982-06-01,Ohio,8048000,5132348,4496311,636037
1982-06-01,Oklahoma,2348000,1485802,1402721,83081
1982-06-01,Oregon,2003000,1322105,1175598,146507
1982-06-01,Pennsylvania,9145000,5481677,4898482,583195
1982-06-01,Tennessee,3476000,2135180,1890984,244196
1982-06-01,Texas,10954000,7355102,6861966,493136
1982-06-01,Utah,1015000,670750,618212,52538
1982-06-01,Vermont,387000,263390,245297,18093
1982-06-01,Virginia,4017000,2666179,2470405,195774
1982-06-01,Washington,3157000,2020912,1786419,234493
1982-06-01,Wisconsin,3537000,2423690,2173796,249894
1982-06-01,Wyoming,358000,253224,238872,14352
1982-07-01,Alabama,2891000,1722420,1479496,242924
1982-07-01,Alaska,292000,214150,192953,21197
1982-07-01,Arizona,2120000,1351086,1212999,138087
1982-07-01,Arkansas,1697000,1020298,925420,94878
1982-07-01,California,18453000,12191944,10949543,1242401
1982-07-01,Colorado,2259000,1595289,1471778,123511
1982-07-01,Connecticut,2418000,1610566,1499895,110671
1982-07-01,Delaware,451000,294452,270241,24211
1982-07-01,Florida,8167000,4710432,4310408,400024
1982-07-01,Georgia,4089000,2656876,2453513,203363
1982-07-01,Hawaii,690000,458259,429736,28523
1982-07-01,Idaho,680000,445672,402436,43236
1982-07-01,Illinois,8559000,5623162,4966699,656463
1982-07-01,Indiana,4049000,2608500,2300403,308097
1982-07-01,Iowa,2158000,1416671,1298872,117799
1982-07-01,Kansas,1772000,1197133,1117795,79338
1982-07-01,Kentucky,2698000,1686924,1504609,182315
1982-07-01,Louisiana,3112000,1867311,1677908,189403
1982-07-01,Maine,843000,522141,477385,44756
1982-07-01,Maryland,3229000,2179884,2001044,178840
1982-07-01,Massachusetts,4443000,2985057,2750911,234146
1982-07-01,Michigan,6754000,4264222,3610757,653465
1982-07-01,Minnesota,3072000,2165417,1988904,176513
1982-07-01,Mississippi,1816000,1066600,947694,118906
1982-07-01,Missouri,3701000,2324275,2111490,212785
1982-07-01,Montana,588000,388385,354953,33432
1982-07-01,Nebraska,1164000,782759,739380,43379
1982-07-01,Nevada,660000,484072,434829,49243
1982-07-01,Ohio,8049000,5132075,4485211,646864
1982-07-01,Oklahoma,2355000,1491226,1401403,89823
1982-07-01,Oregon,2003000,1323908,1176673,147235
1982-07-01,Pennsylvania,9148000,5481500,4885118,596382
1982-07-01,Tennessee,3479000,2141609,1893229,248380
1982-07-01,Texas,10990000,7378097,6868264,509833
1982-07-01,Utah,1017000,672723,618586,54137
1982-07-01,Vermont,387000,263443,245385,18058
1982-07-01,Virginia,4022000,2670512,2472543,197969
1982-07-01,Washington,3160000,2022633,1786028,236605
1982-07-01,Wisconsin,3539000,2425685,2172460,253225
1982-07-01,Wyoming,359000,253886,238445,15441
1982-08-01,Alabama,2893000,1727495,1480152,247343
1982-08-01,Alaska,295000,215712,194237,21475
1982-08-01,Arizona,2126000,1356206,1212411,143795
1982-08-01,Arkansas,1699000,1021740,925923,95817
1982-08-01,California,18475000,12215113,10944096,1271017
1982-08-01,Colorado,2264000,1601430,1471110,130320
1982-08-01,Connecticut,2419000,1608543,1497843,110700
1982-08-01,Delaware,451000,294470,270189,24281
1982-08-01,Florida,8187000,4723872,4315377,408495
1982-08-01,Georgia,4094000,2661515,2454417,207098
1982-08-01,Hawaii,692000,459562,431190,28372
1982-08-01,Idaho,681000,446994,403264,43730
1982-08-01,Illinois,8561000,5627875,4951964,675911
1982-08-01,Indiana,4049000,2609732,2297226,312506
1982-08-01,Iowa,2158000,1417203,1298101,119102
1982-08-01,Kansas,1773000,1200225,1118048,82177
1982-08-01,Kentucky,2700000,1690618,1504989,185629
1982-08-01,Louisiana,3117000,1867306,1673893,193413
1982-08-01,Maine,844000,522249,477414,44835
1982-08-01,Maryland,3230000,2179025,2000777,178248
1982-08-01,Massachusetts,4445000,2986220,2750481,235739
1982-08-01,Michigan,6750000,4266025,3598946,667079
1982-08-01,Minnesota,3073000,2165120,1983279,181841
1982-08-01,Mississippi,1817000,1067583,946712,120871
1982-08-01,Missouri,3703000,2327072,2109019,218053
1982-08-01,Montana,589000,389009,355339,33670
1982-08-01,Nebraska,1165000,783903,739927,43976
1982-08-01,Nevada,661000,484832,434393,50439
1982-08-01,Ohio,8047000,5129047,4469539,659508
1982-08-01,Oklahoma,2361000,1496693,1399249,97444
1982-08-01,Oregon,2003000,1326510,1177206,149304
1982-08-01,Pennsylvania,9151000,5483273,4870609,612664
1982-08-01,Tennessee,3481000,2146480,1892194,254286
1982-08-01,Texas,11017000,7400886,6871978,528908
1982-08-01,Utah,1020000,674629,618651,55978
1982-08-01,Vermont,387000,263361,245330,18031
1982-08-01,Virginia,4027000,2675666,2474566,201100
1982-08-01,Washington,3162000,2025655,1786368,239287
1982-08-01,Wisconsin,3539000,2426694,2170002,256692
1982-08-01,Wyoming,359000,254428,237907,16521
1982-09-01,Alabama,2894000,1732062,1480336,251726
1982-09-01,Alaska,297000,217181,195276,21905
1982-09-01,Arizona,2132000,1360649,1211247,149402
1982-09-01,Arkansas,1701000,1023481,926072,97409
1982-09-01,California,18497000,12235476,10935247,1300229
1982-09-01,Colorado,2269000,1608719,1472129,136590
1982-09-01,Connecticut,2420000,1607085,1496203,110882
1982-09-01,Delaware,452000,294507,270081,24426
1982-09-01,Florida,8207000,4737229,4318452,418777
1982-09-01,Georgia,4099000,2667203,2454625,212578
1982-09-01,Hawaii,693000,460991,432778,28213
1982-09-01,Idaho,682000,448282,403627,44655
1982-09-01,Illinois,8562000,5631157,4937216,693941
1982-09-01,Indiana,4050000,2612007,2293280,318727
1982-09-01,Iowa,2158000,1416937,1295686,121251
1982-09-01,Kansas,1774000,1202691,1118469,84222
1982-09-01,Kentucky,2702000,1694402,1504276,190126
1982-09-01,Louisiana,3122000,1868148,1670140,198008
1982-09-01,Maine,845000,522519,477367,45152
1982-09-01,Maryland,3232000,2179099,2000829,178270
1982-09-01,Massachusetts,4448000,2986035,2748617,237418
1982-09-01,Michigan,6746000,4270252,3586223,684029
1982-09-01,Minnesota,3074000,2164629,1978289,186340
1982-09-01,Mississippi,1818000,1068433,945462,122971
1982-09-01,Missouri,3706000,2330546,2106413,224133
1982-09-01,Montana,590000,389770,355611,34159
1982-09-01,Nebraska,1166000,785261,740387,44874
1982-09-01,Nevada,662000,485612,433829,51783
1982-09-01,Ohio,8046000,5124001,4450129,673872
1982-09-01,Oklahoma,2367000,1501828,1396468,105360
1982-09-01,Oregon,2004000,1330447,1177681,152766
1982-09-01,Pennsylvania,9153000,5486499,4855564,630935
1982-09-01,Tennessee,3483000,2150492,1889002,261490
1982-09-01,Texas,11043000,7425521,6874903,550618
1982-09-01,Utah,1023000,676487,618409,58078
1982-09-01,Vermont,388000,263264,245183,18081
1982-09-01,Virginia,4032000,2682004,2477193,204811
1982-09-01,Washington,3164000,2029146,1787163,241983
1982-09-01,Wisconsin,3539000,2427559,2166004,261555
1982-09-01,Wyoming,360000,254887,237300,17587
1982-10-01,Alabama,2896000,1735656,1479997,255659
1982-10-01,Alaska,300000,218601,196135,22466
1982-10-01,Arizona,2138000,1364589,1210006,154583
1982-10-01,Arkansas,1702000,1025268,925815,99453
1982-10-01,California,18518000,12251814,10924678,1327136
1982-10-01,Colorado,2274000,1616603,1475402,141201
1982-10-01,Connecticut,2421000,1606163,1495079,111084
1982-10-01,Delaware,452000,294545,269944,24601
1982-10-01,Florida,8227000,4749112,4319550,429562
1982-10-01,Georgia,4104000,2673580,2454602,218978
1982-10-01,Hawaii,695000,462533,434372,28161
1982-10-01,Idaho,682000,449400,403560,45840
1982-10-01,Illinois,8564000,5632495,4922989,709506
1982-10-01,Indiana,4050000,2614343,2289332,325011
1982-10-01,Iowa,2158000,1415967,1292026,123941
1982-10-01,Kansas,1775000,1204207,1118880,85327
1982-10-01,Kentucky,2704000,1698252,1502622,195630
1982-10-01,Louisiana,3126000,1870354,1667107,203247
1982-10-01,Maine,846000,523102,477385,45717
1982-10-01,Maryland,3233000,2180214,2001524,178690
1982-10-01,Massachusetts,4450000,2983890,2745005,238885
1982-10-01,Michigan,6743000,4274269,3574472,699797
1982-10-01,Minnesota,3075000,2164166,1974408,189758
1982-10-01,Mississippi,1818000,1069033,943707,125326
1982-10-01,Missouri,3708000,2334212,2103891,230321
1982-10-01,Montana,590000,390564,355723,34841
1982-10-01,Nebraska,1166000,786765,740656,46109
1982-10-01,Nevada,663000,486353,433166,53187
1982-10-01,Ohio,8044000,5118093,4430269,687824
1982-10-01,Oklahoma,2373000,1506407,1393267,113140
1982-10-01,Oregon,2004000,1335219,1178533,156686
1982-10-01,Pennsylvania,9156000,5489153,4840098,649055
1982-10-01,Tennessee,3485000,2154113,1885625,268488
1982-10-01,Texas,11070000,7452250,6878080,574170
1982-10-01,Utah,1025000,678211,617911,60300
1982-10-01,Vermont,388000,263255,245020,18235
1982-10-01,Virginia,4037000,2688963,2480870,208093
1982-10-01,Washington,3166000,2032285,1788033,244252
1982-10-01,Wisconsin,3539000,2428753,2160632,268121
1982-10-01,Wyoming,360000,255296,236649,18647
1982-11-01,Alabama,2898000,1738155,1479607,258548
1982-11-01,Alaska,302000,220086,197024,23062
1982-11-01,Arizona,2144000,1368581,1210107,158474
1982-11-01,Arkansas,1704000,1026845,925334,101511
1982-11-01,California,18540000,12262703,10915325,1347378
1982-11-01,Colorado,2279000,1624662,1480791,143871
1982-11-01,Connecticut,2423000,1605786,1494679,111107
1982-11-01,Delaware,453000,294546,269784,24762
1982-11-01,Florida,8247000,4759026,4320056,438970
1982-11-01,Georgia,4109000,2679533,2454923,224610
1982-11-01,Hawaii,696000,464103,435814,28289
1982-11-01,Idaho,683000,450324,403377,46947
1982-11-01,Illinois,8565000,5632037,4910778,721259
1982-11-01,Indiana,4051000,2615090,2285990,329100
1982-11-01,Iowa,2158000,1414723,1288157,126566
1982-11-01,Kansas,1776000,1204435,1118996,85439
1982-11-01,Kentucky,2706000,1701560,1500485,201075
1982-11-01,Louisiana,3131000,1874128,1665149,208979
1982-11-01,Maine,847000,524024,477641,46383
1982-11-01,Maryland,3235000,2182165,2003232,178933
1982-11-01,Massachusetts,4453000,2980008,2740327,239681
1982-11-01,Michigan,6739000,4276244,3566345,709899
1982-11-01,Minnesota,3076000,2163829,1972016,191813
1982-11-01,Mississippi,1819000,1069475,941577,127898
1982-11-01,Missouri,3710000,2337773,2101692,236081
1982-11-01,Montana,591000,391295,355773,35522
1982-11-01,Nebraska,1167000,788176,740627,47549
1982-11-01,Nevada,664000,486913,432567,54346
1982-11-01,Ohio,8042000,5113365,4414636,698729
1982-11-01,Oklahoma,2379000,1510250,1390137,120113
1982-11-01,Oregon,2004000,1339854,1180141,159713
1982-11-01,Pennsylvania,9158000,5489025,4824861,664164
1982-11-01,Tennessee,3488000,2157737,1884003,273734
1982-11-01,Texas,11096000,7480149,6882595,597554
1982-11-01,Utah,1028000,679799,617393,62406
1982-11-01,Vermont,389000,263337,244929,18408
1982-11-01,Virginia,4042000,2695790,2485795,209995
1982-11-01,Washington,3169000,2034558,1788865,245693
1982-11-01,Wisconsin,3539000,2429763,2154913,274850
1982-11-01,Wyoming,361000,255727,236046,19681
1982-12-01,Alabama,2899000,1738941,1479174,259767
1982-12-01,Alaska,305000,221621,198061,23560
1982-12-01,Arizona,2150000,1371983,1211841,160142
1982-12-01,Arkansas,1706000,1027806,924710,103096
1982-12-01,California,18562000,12264221,10907614,1356607
1982-12-01,Colorado,2284000,1631945,1487247,144698
1982-12-01,Connecticut,2424000,1605356,1494731,110625
1982-12-01,Delaware,453000,294367,269529,24838
1982-12-01,Florida,8267000,4766109,4321086,445023
1982-12-01,Georgia,4114000,2682953,2455271,227682
1982-12-01,Hawaii,698000,465401,436842,28559
1982-12-01,Idaho,684000,450782,403274,47508
1982-12-01,Illinois,8567000,5628671,4900979,727692
1982-12-01,Indiana,4051000,2611714,2282307,329407
1982-12-01,Iowa,2158000,1412863,1284353,128510
1982-12-01,Kansas,1777000,1202946,1118411,84535
1982-12-01,Kentucky,2708000,1702466,1497490,204976
1982-12-01,Louisiana,3136000,1878585,1663879,214706
1982-12-01,Maine,848000,525141,478138,47003
1982-12-01,Maryland,3236000,2184025,2005876,178149
1982-12-01,Massachusetts,4455000,2974360,2735244,239116
1982-12-01,Michigan,6735000,4274772,3563053,711719
1982-12-01,Minnesota,3077000,2163153,1970866,192287
1982-12-01,Mississippi,1820000,1069311,938999,130312
1982-12-01,Missouri,3713000,2340569,2099684,240885
1982-12-01,Montana,592000,391736,355720,36016
1982-12-01,Nebraska,1168000,789060,740188,48872
1982-12-01,Nevada,665000,487080,432105,54975
1982-12-01,Ohio,8041000,5109593,4405096,704497
1982-12-01,Oklahoma,2385000,1512998,1387336,125662
1982-12-01,Oregon,2004000,1343108,1182193,160915
1982-12-01,Pennsylvania,9161000,5483503,4810066,673437
1982-12-01,Tennessee,3490000,2160654,1884343,276311
1982-12-01,Texas,11123000,7504854,6887396,617458
1982-12-01,Utah,1031000,681166,616954,64212
1982-12-01,Vermont,389000,263420,244900,18520
1982-12-01,Virginia,4047000,2700598,2491075,209523
1982-12-01,Washington,3171000,2035233,1789465,245768
1982-12-01,Wisconsin,3539000,2428630,2149605,279025
1982-12-01,Wyoming,361000,256141,235491,20650
1983-01-01,Alabama,2901000,1738100,1478740,259360
1983-01-01,Alaska,307000,223161,199315,23846
1983-01-01,Arizona,2156000,1374083,1214778,159305
1983-01-01,Arkansas,1708000,1028172,924129,104043
1983-01-01,California,18584000,12257740,10902953,1354787
1983-01-01,Colorado,2289000,1637723,1493797,143926
1983-01-01,Connecticut,2425000,1604589,1495056,109533
1983-01-01,Delaware,453000,294000,269168,24832
1983-01-01,Florida,8286000,4772196,4324548,447648
1983-01-01,Georgia,4119000,2683043,2455535,227508
1983-01-01,Hawaii,699000,466160,437281,28879
1983-01-01,Idaho,685000,450727,403414,47313
1983-01-01,Illinois,8568000,5623067,4894028,729039
1983-01-01,Indiana,4051000,2603477,2277616,325861
1983-01-01,Iowa,2158000,1410459,1281127,129332
1983-01-01,Kansas,1778000,1200017,1117218,82799
1983-01-01,Kentucky,2710000,1700557,1493706,206851
1983-01-01,Louisiana,3141000,1883129,1662969,220160
1983-01-01,Maine,848000,526249,478761,47488
1983-01-01,Maryland,3237000,2185728,2009508,176220
1983-01-01,Massachusetts,4457000,2967821,2730830,236991
1983-01-01,Michigan,6731000,4270825,3564753,706072
1983-01-01,Minnesota,3078000,2162211,1970578,191633
1983-01-01,Mississippi,1821000,1068549,936048,132501
1983-01-01,Missouri,3715000,2342561,2098187,244374
1983-01-01,Montana,593000,391831,355593,36238
1983-01-01,Nebraska,1169000,789253,739522,49731
1983-01-01,Nevada,665000,486892,431871,55021
1983-01-01,Ohio,8039000,5106393,4401030,705363
1983-01-01,Oklahoma,2391000,1515176,1385392,129784
1983-01-01,Oregon,2005000,1344523,1184630,159893
1983-01-01,Pennsylvania,9163000,5474072,4797670,676402
1983-01-01,Tennessee,3492000,2162599,1886319,276280
1983-01-01,Texas,11149000,7524154,6892087,632067
1983-01-01,Utah,1034000,682446,616737,65709
1983-01-01,Vermont,389000,263516,244917,18599
1983-01-01,Virginia,4052000,2702724,2496362,206362
1983-01-01,Washington,3173000,2034619,1790045,244574
1983-01-01,Wisconsin,3539000,2424457,2145485,278972
1983-01-01,Wyoming,361000,256642,234996,21646
1983-02-01,Alabama,2903000,1737094,1479636,257458
1983-02-01,Alaska,310000,224658,200818,23840
1983-02-01,Arizona,2163000,1375429,1219185,156244
1983-02-01,Arkansas,1709000,1028397,924136,104261
1983-02-01,California,18606000,12249015,10907130,1341885
1983-02-01,Colorado,2295000,1642086,1500494,141592
1983-02-01,Connecticut,2426000,1603970,1496202,107768
1983-02-01,Delaware,454000,293602,268857,24745
1983-02-01,Florida,8306000,4781301,4333952,447349
1983-02-01,Georgia,4124000,2681077,2456647,224430
1983-02-01,Hawaii,701000,466443,437377,29066
1983-02-01,Idaho,686000,450433,404030,46403
1983-02-01,Illinois,8570000,5616253,4891130,725123
1983-02-01,Indiana,4052000,2592261,2273325,318936
1983-02-01,Iowa,2159000,1408254,1279725,128529
1983-02-01,Kansas,1780000,1196718,1116191,80527
1983-02-01,Kentucky,2713000,1697071,1490606,206465
1983-02-01,Louisiana,3146000,1888001,1663122,224879
1983-02-01,Maine,849000,527303,479634,47669
1983-02-01,Maryland,3239000,2187874,2014555,173319
1983-02-01,Massachusetts,4460000,2962702,2729547,233155
1983-02-01,Michigan,6727000,4266108,3572043,694065
1983-02-01,Minnesota,3080000,2162010,1972037,189973
1983-02-01,Mississippi,1822000,1068006,933733,134273
1983-02-01,Missouri,3717000,2344474,2098128,246346
1983-02-01,Montana,593000,391834,355651,36183
1983-02-01,Nebraska,1170000,788908,739057,49851
1983-02-01,Nevada,666000,486556,432089,54467
1983-02-01,Ohio,8037000,5104342,4403213,701129
1983-02-01,Oklahoma,2397000,1517649,1385294,132355
1983-02-01,Oregon,2005000,1344575,1187662,156913
1983-02-01,Pennsylvania,9166000,5464774,4791900,672874
1983-02-01,Tennessee,3494000,2163818,1889909,273909
1983-02-01,Texas,11176000,7539850,6899534,640316
1983-02-01,Utah,1037000,683853,617083,66770
1983-02-01,Vermont,390000,263641,245057,18584
1983-02-01,Virginia,4058000,2703700,2503030,200670
1983-02-01,Washington,3175000,2033822,1791576,242246
1983-02-01,Wisconsin,3538000,2417924,2143984,273940
1983-02-01,Wyoming,362000,257248,234670,22578
1983-03-01,Alabama,2904000,1737472,1482980,254492
1983-03-01,Alaska,313000,226092,202511,23581
1983-03-01,Arizona,2169000,1377000,1225383,151617
1983-03-01,Arkansas,1711000,1028895,925122,103773
1983-03-01,California,18628000,12243605,10924179,1319426
1983-03-01,Colorado,2300000,1645399,1507590,137809
1983-03-01,Connecticut,2427000,1604387,1498941,105446
1983-03-01,Delaware,454000,293382,268820,24562
1983-03-01,Florida,8326000,4796569,4351637,444932
1983-03-01,Georgia,4129000,2679039,2459279,219760
1983-03-01,Hawaii,703000,466645,437650,28995
1983-03-01,Idaho,687000,450282,405215,45067
1983-03-01,Illinois,8571000,5609287,4892749,716538
1983-03-01,Indiana,4052000,2581234,2271040,310194
1983-03-01,Iowa,2159000,1406991,1280515,126476
1983-03-01,Kansas,1781000,1193945,1116098,77847
1983-03-01,Kentucky,2715000,1693581,1489294,204287
1983-03-01,Louisiana,3151000,1893320,1664820,228500
1983-03-01,Maine,850000,528563,481087,47476
1983-03-01,Maryland,3240000,2190868,2021274,169594
1983-03-01,Massachusetts,4462000,2960248,2732483,227765
1983-03-01,Michigan,6723000,4261608,3583715,677893
1983-03-01,Minnesota,3081000,2162916,1975869,187047
1983-03-01,Mississippi,1823000,1068095,932896,135199
1983-03-01,Missouri,3720000,2347236,2100248,246988
1983-03-01,Montana,594000,391980,356025,35955
1983-03-01,Nebraska,1171000,788279,739139,49140
1983-03-01,Nevada,667000,486263,432877,53386
1983-03-01,Ohio,8036000,5103796,4411861,691935
1983-03-01,Oklahoma,2403000,1520758,1387481,133277
1983-03-01,Oregon,2005000,1343849,1190836,153013
1983-03-01,Pennsylvania,9169000,5458327,4794953,663374
1983-03-01,Tennessee,3496000,2164853,1894896,269957
1983-03-01,Texas,11203000,7554506,6912132,642374
1983-03-01,Utah,1040000,685457,618201,67256
1983-03-01,Vermont,390000,263848,245417,18431
1983-03-01,Virginia,4063000,2705348,2512013,193335
1983-03-01,Washington,3177000,2033583,1794455,239128
1983-03-01,Wisconsin,3538000,2410673,2145852,264821
1983-03-01,Wyoming,362000,257736,234569,23167
1983-04-01,Alabama,2906000,1740441,1489054,251387
1983-04-01,Alaska,315000,227478,204255,23223
1983-04-01,Arizona,2175000,1379506,1233410,146096
1983-04-01,Arkansas,1713000,1030222,927248,102974
1983-04-01,California,18649000,12248042,10955935,1292107
1983-04-01,Colorado,2305000,1648400,1515354,133046
1983-04-01,Connecticut,2428000,1606693,1503774,102919
1983-04-01,Delaware,455000,293495,269194,24301
1983-04-01,Florida,8346000,4820144,4378636,441508
1983-04-01,Georgia,4134000,2679194,2464001,215193
1983-04-01,Hawaii,704000,467284,438580,28704
1983-04-01,Idaho,687000,450521,406825,43696
1983-04-01,Illinois,8573000,5604324,4899243,705081
1983-04-01,Indiana,4053000,2574097,2272324,301773
1983-04-01,Iowa,2159000,1407459,1283568,123891
1983-04-01,Kansas,1782000,1192280,1117361,74919
1983-04-01,Kentucky,2717000,1691634,1490224,201410
1983-04-01,Louisiana,3155000,1899459,1668450,231009
1983-04-01,Maine,851000,530281,483232,47049
1983-04-01,Maryland,3242000,2195102,2029852,165250
1983-04-01,Massachusetts,4465000,2961037,2739443,221594
1983-04-01,Michigan,6720000,4259951,3598717,661234
1983-04-01,Minnesota,3082000,2165253,1982025,183228
1983-04-01,Mississippi,1823000,1068997,933940,135057
1983-04-01,Missouri,3722000,2351610,2104909,246701
1983-04-01,Montana,595000,392580,356892,35688
1983-04-01,Nebraska,1171000,787756,739994,47762
1983-04-01,Nevada,668000,486222,434230,51992
1983-04-01,Ohio,8034000,5105462,4426083,679379
1983-04-01,Oklahoma,2409000,1524684,1391816,132868
1983-04-01,Oregon,2005000,1342906,1193653,149253
1983-04-01,Pennsylvania,9171000,5457291,4807027,650264
1983-04-01,Tennessee,3498000,2167126,1901355,265771
1983-04-01,Texas,11229000,7572254,6931685,640569
1983-04-01,Utah,1042000,687266,620128,67138
1983-04-01,Vermont,391000,264232,246049,18183
1983-04-01,Virginia,4068000,2709350,2523574,185776
1983-04-01,Washington,3179000,2034872,1798807,236065
1983-04-01,Wisconsin,3538000,2404580,2150904,253676
1983-04-01,Wyoming,363000,258026,234714,23312
1983-05-01,Alabama,2908000,1746093,1497406,248687
1983-05-01,Alaska,318000,228906,205993,22913
1983-05-01,Arizona,2181000,1383210,1243114,140096
1983-05-01,Arkansas,1715000,1032509,930189,102320
1983-05-01,California,18671000,12263379,11000522,1262857
1983-05-01,Colorado,2310000,1652054,1524496,127558
1983-05-01,Connecticut,2430000,1610878,1510438,100440
1983-05-01,Delaware,455000,293955,269923,24032
1983-05-01,Florida,8366000,4851026,4413354,437672
1983-05-01,Georgia,4139000,2682644,2471023,211621
1983-05-01,Hawaii,706000,468544,440259,28285
1983-05-01,Idaho,688000,451247,408733,42514
1983-05-01,Illinois,8574000,5602091,4910594,691497
1983-05-01,Indiana,4053000,2572839,2277920,294919
1983-05-01,Iowa,2159000,1410116,1289021,121095
1983-05-01,Kansas,1783000,1191827,1119763,72064
1983-05-01,Kentucky,2719000,1691731,1493237,198494
1983-05-01,Louisiana,3160000,1906452,1674288,232164
1983-05-01,Maine,852000,532397,485951,46446
1983-05-01,Maryland,3243000,2200604,2039907,160697
1983-05-01,Massachusetts,4467000,2964853,2749528,215325
1983-05-01,Michigan,6716000,4262474,3616395,646079
1983-05-01,Minnesota,3083000,2169266,1990200,179066
1983-05-01,Mississippi,1824000,1070608,936706,133902
1983-05-01,Missouri,3724000,2357142,2111562,245580
1983-05-01,Montana,596000,393774,358325,35449
1983-05-01,Nebraska,1172000,787519,741526,45993
1983-05-01,Nevada,669000,486538,436044,50494
1983-05-01,Ohio,8032000,5109314,4444464,664850
1983-05-01,Oklahoma,2415000,1529032,1397694,131338
1983-05-01,Oregon,2006000,1342185,1195685,146500
1983-05-01,Pennsylvania,9174000,5462729,4826886,635843
1983-05-01,Tennessee,3501000,2171322,1909206,262116
1983-05-01,Texas,11256000,7595543,6958649,636894
1983-05-01,Utah,1045000,689204,622762,66442
1983-05-01,Vermont,391000,264797,246901,17896
1983-05-01,Virginia,4073000,2716242,2537153,179089
1983-05-01,Washington,3182000,2038301,1804763,233538
1983-05-01,Wisconsin,3538000,2400858,2158087,242771
1983-05-01,Wyoming,363000,258080,235111,22969
1983-06-01,Alabama,2909000,1753368,1507143,246225
1983-06-01,Alaska,320000,230378,207646,22732
1983-06-01,Arizona,2187000,1387704,1254035,133669
1983-06-01,Arkansas,1716000,1035449,933588,101861
1983-06-01,California,18693000,12285912,11053889,1232023
1983-06-01,Colorado,2315000,1656470,1535236,121234
1983-06-01,Connecticut,2431000,1616369,1518271,98098
1983-06-01,Delaware,456000,294726,270958,23768
1983-06-01,Florida,8386000,4885773,4452590,433183
1983-06-01,Georgia,4144000,2689117,2480214,208903
1983-06-01,Hawaii,707000,470261,442396,27865
1983-06-01,Idaho,689000,452416,410862,41554
1983-06-01,Illinois,8576000,5601866,4926369,675497
1983-06-01,Indiana,4054000,2577336,2287827,289509
1983-06-01,Iowa,2159000,1414494,1296255,118239
1983-06-01,Kansas,1784000,1192322,1122740,69582
1983-06-01,Kentucky,2721000,1693388,1497752,195636
1983-06-01,Louisiana,3165000,1913498,1682061,231437
1983-06-01,Maine,853000,534726,489103,45623
1983-06-01,Maryland,3245000,2206847,2050774,156073
1983-06-01,Massachusetts,4470000,2970999,2761731,209268
1983-06-01,Michigan,6712000,4267547,3636206,631341
1983-06-01,Minnesota,3084000,2174573,1999920,174653
1983-06-01,Mississippi,1825000,1072380,940504,131876
1983-06-01,Missouri,3727000,2362720,2119321,243399
1983-06-01,Montana,596000,395374,360138,35236
1983-06-01,Nebraska,1173000,787514,743403,44111
1983-06-01,Nevada,670000,487148,438131,49017
1983-06-01,Ohio,8031000,5114604,4465863,648741
1983-06-01,Oklahoma,2421000,1533277,1404434,128843
1983-06-01,Oregon,2006000,1341693,1196844,144849
1983-06-01,Pennsylvania,9176000,5472690,4852018,620672
1983-06-01,Tennessee,3503000,2177256,1918457,258799
1983-06-01,Texas,11282000,7623387,6991604,631783
1983-06-01,Utah,1048000,691092,625852,65240
1983-06-01,Vermont,392000,265478,247891,17587
1983-06-01,Virginia,4078000,2725169,2551500,173669
1983-06-01,Washington,3184000,2043456,1812181,231275
1983-06-01,Wisconsin,3538000,2400109,2166261,233848
1983-06-01,Wyoming,364000,257828,235712,22116
1983-07-01,Alabama,2911000,1760993,1517530,243463
1983-07-01,Alaska,323000,231786,209085,22701
1983-07-01,Arizona,2193000,1392192,1265792,126400
1983-07-01,Arkansas,1718000,1038671,937328,101343
1983-07-01,California,18715000,12310447,11111350,1199097
1983-07-01,Colorado,2320000,1661507,1547189,114318
1983-07-01,Connecticut,2432000,1622330,1526477,95853
1983-07-01,Delaware,456000,295758,272280,23478
1983-07-01,Florida,8406000,4920365,4493251,427114
1983-07-01,Georgia,4149000,2697207,2491148,206059
1983-07-01,Hawaii,709000,472161,444623,27538
1983-07-01,Idaho,690000,453879,413128,40751
1983-07-01,Illinois,8577000,5601716,4945373,656343
1983-07-01,Indiana,4054000,2585223,2300729,284494
1983-07-01,Iowa,2159000,1419450,1304076,115374
1983-07-01,Kansas,1785000,1193352,1125782,67570
1983-07-01,Kentucky,2723000,1695759,1503427,192332
1983-07-01,Louisiana,3170000,1919533,1691008,228525
1983-07-01,Maine,854000,536993,492377,44616
1983-07-01,Maryland,3246000,2213170,2061773,151397
1983-07-01,Massachusetts,4472000,2978213,2774857,203356
1983-07-01,Michigan,6708000,4272570,3657611,614959
1983-07-01,Minnesota,3085000,2180293,2010188,170105
1983-07-01,Mississippi,1826000,1073814,944588,129226
1983-07-01,Missouri,3729000,2367122,2127507,239615
1983-07-01,Montana,597000,397030,362055,34975
1983-07-01,Nebraska,1174000,787612,745219,42393
1983-07-01,Nevada,671000,487858,440312,47546
1983-07-01,Ohio,8029000,5119518,4488926,630592
1983-07-01,Oklahoma,2427000,1536790,1411252,125538
1983-07-01,Oregon,2006000,1340849,1197210,143639
1983-07-01,Pennsylvania,9179000,5482828,4878389,604439
1983-07-01,Tennessee,3505000,2184197,1929186,255011
1983-07-01,Texas,11309000,7652739,7027875,624864
1983-07-01,Utah,1051000,692721,629145,63576
1983-07-01,Vermont,392000,266209,248943,17266
1983-07-01,Virginia,4083000,2734421,2565497,168924
1983-07-01,Washington,3186000,2049452,1820736,228716
1983-07-01,Wisconsin,3538000,2401982,2174701,227281
1983-07-01,Wyoming,364000,257355,236446,20909
1983-08-01,Alabama,2913000,1767730,1527681,240049
1983-08-01,Alaska,324000,232974,210165,22809
1983-08-01,Arizona,2200000,1396222,1278069,118153
1983-08-01,Arkansas,1719000,1041648,941094,100554
1983-08-01,California,18754000,12331225,11166476,1164749
1983-08-01,Colorado,2323000,1666627,1558855,107772
1983-08-01,Connecticut,2434000,1627680,1533997,93683
1983-08-01,Delaware,457000,296961,273800,23161
1983-08-01,Florida,8428000,4951237,4532239,418998
1983-08-01,Georgia,4157000,2705190,2502825,202365
1983-08-01,Hawaii,710000,473760,446460,27300
1983-08-01,Idaho,691000,455372,415470,39902
1983-08-01,Illinois,8580000,5599385,4964499,634886
1983-08-01,Indiana,4056000,2593384,2314079,279305
1983-08-01,Iowa,2159000,1423764,1311327,112437
1983-08-01,Kansas,1786000,1194287,1128197,66090
1983-08-01,Kentucky,2724000,1698154,1509924,188230
1983-08-01,Louisiana,3171000,1923580,1699963,223617
1983-08-01,Maine,855000,538817,495294,43523
1983-08-01,Maryland,3250000,2218481,2071708,146773
1983-08-01,Massachusetts,4476000,2985227,2787628,197599
1983-08-01,Michigan,6711000,4274763,3678567,596196
1983-08-01,Minnesota,3087000,2185348,2019503,165845
1983-08-01,Mississippi,1827000,1074546,948245,126301
1983-08-01,Missouri,3732000,2369666,2135251,234415
1983-08-01,Montana,597000,398326,363732,34594
1983-08-01,Nebraska,1175000,787623,746597,41026
1983-08-01,Nevada,673000,488433,442418,46015
1983-08-01,Ohio,8030000,5121636,4510819,610817
1983-08-01,Oklahoma,2427000,1539173,1417217,121956
1983-08-01,Oregon,2008000,1339257,1196704,142553
1983-08-01,Pennsylvania,9181000,5489400,4901747,587653
1983-08-01,Tennessee,3508000,2191079,1940739,250340
1983-08-01,Texas,11328000,7678715,7062795,615920
1983-08-01,Utah,1051000,693897,632374,61523
1983-08-01,Vermont,392000,266890,249925,16965
1983-08-01,Virginia,4089000,2741847,2577793,164054
1983-08-01,Washington,3190000,2055414,1829492,225922
1983-08-01,Wisconsin,3540000,2404843,2182708,222135
1983-08-01,Wyoming,364000,256780,237184,19596
1983-09-01,Alabama,2916000,1772535,1536684,235851
1983-09-01,Alaska,325000,233905,210884,23021
1983-09-01,Arizona,2206000,1399610,1290474,109136
1983-09-01,Arkansas,1721000,1044054,944723,99331
1983-09-01,California,18792000,12345237,11215098,1130139
1983-09-01,Colorado,2326000,1671303,1568912,102391
1983-09-01,Connecticut,2435000,1631821,1540289,91532
1983-09-01,Delaware,457000,298203,275414,22789
1983-09-01,Florida,8449000,4976578,4567581,408997
1983-09-01,Georgia,4164000,2711658,2514128,197530
1983-09-01,Hawaii,711000,474644,447543,27101
1983-09-01,Idaho,692000,456651,417836,38815
1983-09-01,Illinois,8584000,5594730,4982118,612612
1983-09-01,Indiana,4058000,2599401,2326261,273140
1983-09-01,Iowa,2160000,1426662,1317195,109467
1983-09-01,Kansas,1787000,1194641,1129626,65015
1983-09-01,Kentucky,2724000,1700042,1516813,183229
1983-09-01,Louisiana,3173000,1925061,1707964,217097
1983-09-01,Maine,856000,539933,497585,42348
1983-09-01,Maryland,3253000,2221794,2079732,142062
1983-09-01,Massachusetts,4479000,2991568,2799663,191905
1983-09-01,Michigan,6714000,4273076,3697228,575848
1983-09-01,Minnesota,3089000,2189171,2027126,162045
1983-09-01,Mississippi,1828000,1074321,950988,123333
1983-09-01,Missouri,3734000,2370420,2142021,228399
1983-09-01,Montana,598000,398984,364980,34004
1983-09-01,Nebraska,1175000,787397,747350,40047
1983-09-01,Nevada,674000,488768,444370,44398
1983-09-01,Ohio,8030000,5119700,4529663,590037
1983-09-01,Oklahoma,2427000,1540444,1422033,118411
1983-09-01,Oregon,2009000,1336712,1195740,140972
1983-09-01,Pennsylvania,9182000,5490923,4920061,570862
1983-09-01,Tennessee,3511000,2197122,1952500,244622
1983-09-01,Texas,11347000,7696654,7093046,603608
1983-09-01,Utah,1051000,694564,635377,59187
1983-09-01,Vermont,393000,267386,250725,16661
1983-09-01,Virginia,4096000,2746435,2587630,158805
1983-09-01,Washington,3193000,2060706,1837660,223046
1983-09-01,Wisconsin,3541000,2406796,2189712,217084
1983-09-01,Wyoming,364000,256207,237807,18400
1983-10-01,Alabama,2918000,1774869,1543891,230978
1983-10-01,Alaska,326000,234683,211394,23289
1983-10-01,Arizona,2213000,1402252,1302374,99878
1983-10-01,Arkansas,1722000,1046005,948372,97633
1983-10-01,California,18831000,12353662,11256899,1096763
1983-10-01,Colorado,2329000,1675464,1577339,98125
1983-10-01,Connecticut,2437000,1634896,1545585,89311
1983-10-01,Delaware,458000,299344,277041,22303
1983-10-01,Florida,8471000,4996983,4599416,397567
1983-10-01,Georgia,4172000,2715870,2524218,191652
1983-10-01,Hawaii,712000,474684,447812,26872
1983-10-01,Idaho,693000,457605,420167,37438
1983-10-01,Illinois,8587000,5589093,4997781,591312
1983-10-01,Indiana,4060000,2601912,2336333,265579
1983-10-01,Iowa,2160000,1427810,1321196,106614
1983-10-01,Kansas,1788000,1194263,1130237,64026
1983-10-01,Kentucky,2725000,1700912,1523434,177478
1983-10-01,Louisiana,3174000,1924041,1714546,209495
1983-10-01,Maine,857000,540421,499342,41079
1983-10-01,Maryland,3257000,2222809,2085814,136995
1983-10-01,Massachusetts,4483000,2997313,2811290,186023
1983-10-01,Michigan,6716000,4268939,3713524,555415
1983-10-01,Minnesota,3090000,2191839,2033296,158543
1983-10-01,Mississippi,1829000,1073248,952636,120612
1983-10-01,Missouri,3737000,2369813,2147949,221864
1983-10-01,Montana,598000,399041,365853,33188
1983-10-01,Nebraska,1176000,786986,747649,39337
1983-10-01,Nevada,676000,488957,446217,42740
1983-10-01,Ohio,8031000,5113829,4544573,569256
1983-10-01,Oklahoma,2427000,1540785,1426006,114779
1983-10-01,Oregon,2011000,1333662,1195331,138331
1983-10-01,Pennsylvania,9184000,5487676,4933483,554193
1983-10-01,Tennessee,3514000,2201962,1964181,237781
1983-10-01,Texas,11366000,7705203,7118509,586694
1983-10-01,Utah,1050000,694945,638176,56769
1983-10-01,Vermont,393000,267694,251340,16354
1983-10-01,Virginia,4102000,2748818,2595715,153103
1983-10-01,Washington,3197000,2064678,1844959,219719
1983-10-01,Wisconsin,3543000,2406459,2195592,210867
1983-10-01,Wyoming,364000,255781,238276,17505
1983-11-01,Alabama,2921000,1775186,1549141,226045
1983-11-01,Alaska,328000,235450,211876,23574
1983-11-01,Arizona,2219000,1404297,1312871,91426
1983-11-01,Arkansas,1724000,1047707,951948,95759
1983-11-01,California,18869000,12361253,11293760,1067493
1983-11-01,Colorado,2332000,1678854,1584260,94594
1983-11-01,Connecticut,2439000,1637440,1550349,87091
1983-11-01,Delaware,458000,300344,278660,21684
1983-11-01,Florida,8493000,5014164,4628474,385690
1983-11-01,Georgia,4180000,2718417,2532951,185466
1983-11-01,Hawaii,713000,474141,447491,26650
1983-11-01,Idaho,694000,458188,422287,35901
1983-11-01,Illinois,8591000,5584291,5010695,573596
1983-11-01,Indiana,4062000,2601753,2344488,257265
1983-11-01,Iowa,2160000,1427277,1323202,104075
1983-11-01,Kansas,1789000,1193532,1130467,63065
1983-11-01,Kentucky,2726000,1701019,1529142,171877
1983-11-01,Louisiana,3175000,1921687,1719684,202003
1983-11-01,Maine,858000,540631,500828,39803
1983-11-01,Maryland,3260000,2222190,2090324,131866
1983-11-01,Massachusetts,4486000,3002659,2822591,180068
1983-11-01,Michigan,6719000,4265116,3728287,536829
1983-11-01,Minnesota,3092000,2194141,2038796,155345
1983-11-01,Mississippi,1830000,1071785,953330,118455
1983-11-01,Missouri,3739000,2368679,2153378,215301
1983-11-01,Montana,599000,398780,366484,32296
1983-11-01,Nebraska,1176000,786588,747757,38831
1983-11-01,Nevada,678000,489198,448017,41181
1983-11-01,Ohio,8032000,5105350,4555066,550284
1983-11-01,Oklahoma,2426000,1540745,1429290,111455
1983-11-01,Oregon,2013000,1331115,1196277,134838
1983-11-01,Pennsylvania,9185000,5481730,4942923,538807
1983-11-01,Tennessee,3517000,2205494,1975149,230345
1983-11-01,Texas,11385000,7707479,7140564,566915
1983-11-01,Utah,1050000,695380,640849,54531
1983-11-01,Vermont,393000,267909,251847,16062
1983-11-01,Virginia,4108000,2750457,2603082,147375
1983-11-01,Washington,3201000,2067115,1851178,215937
1983-11-01,Wisconsin,3544000,2403946,2200706,203240
1983-11-01,Wyoming,363000,255481,238552,16929
1983-12-01,Alabama,2923000,1774964,1553354,221610
1983-12-01,Alaska,329000,236296,212424,23872
1983-12-01,Arizona,2226000,1406680,1321980,84700
1983-12-01,Arkansas,1725000,1049374,955260,94114
1983-12-01,California,18908000,12374638,11330300,1044338
1983-12-01,Colorado,2335000,1681584,1589843,91741
1983-12-01,Connecticut,2440000,1640458,1555412,85046
1983-12-01,Delaware,459000,301345,280382,20963
1983-12-01,Florida,8514000,5030863,4656350,374513
1983-12-01,Georgia,4187000,2721200,2541417,179783
1983-12-01,Hawaii,714000,473590,447092,26498
1983-12-01,Idaho,695000,458569,424079,34490
1983-12-01,Illinois,8594000,5582542,5021762,560780
1983-12-01,Indiana,4064000,2601782,2352430,249352
1983-12-01,Iowa,2160000,1425963,1323802,102161
1983-12-01,Kansas,1790000,1193283,1130986,62297
1983-12-01,Kentucky,2726000,1701513,1534012,167501
1983-12-01,Louisiana,3177000,1919884,1723888,195996
1983-12-01,Maine,859000,540986,502411,38575
1983-12-01,Maryland,3264000,2221593,2094143,127450
1983-12-01,Massachusetts,4490000,3008377,2834061,174316
1983-12-01,Michigan,6722000,4264441,3742662,521779
1983-12-01,Minnesota,3094000,2197193,2044652,152541
1983-12-01,Mississippi,1831000,1070783,953894,116889
1983-12-01,Missouri,3742000,2368067,2158963,209104
1983-12-01,Montana,599000,398581,367127,31454
1983-12-01,Nebraska,1177000,786399,747942,38457
1983-12-01,Nevada,679000,489707,449885,39822
1983-12-01,Ohio,8032000,5097259,4562515,534744
1983-12-01,Oklahoma,2426000,1540824,1431971,108853
1983-12-01,Oregon,2014000,1330093,1198801,131292
1983-12-01,Pennsylvania,9187000,5476111,4949949,526162
1983-12-01,Tennessee,3520000,2208117,1985068,223049
1983-12-01,Texas,11404000,7709287,7162049,547238
1983-12-01,Utah,1050000,696175,643571,52604
1983-12-01,Vermont,394000,268175,252413,15762
1983-12-01,Virginia,4114000,2753666,2611028,142638
1983-12-01,Washington,3204000,2068603,1856382,212221
1983-12-01,Wisconsin,3546000,2401048,2205682,195366
1983-12-01,Wyoming,363000,255236,238647,16589
1984-01-01,Alabama,2925000,1775460,1557955,217505
1984-01-01,Alaska,330000,237307,213178,24129
1984-01-01,Arizona,2232000,1410353,1330606,79747
1984-01-01,Arkansas,1726000,1051032,958251,92781
1984-01-01,California,18946000,12398171,11372769,1025402
1984-01-01,Colorado,2338000,1684480,1594866,89614
1984-01-01,Connecticut,2442000,1644889,1561780,83109
1984-01-01,Delaware,459000,302468,282275,20193
1984-01-01,Florida,8536000,5049106,4685019,364087
1984-01-01,Georgia,4195000,2725872,2551121,174751
1984-01-01,Hawaii,714000,473594,447196,26398
1984-01-01,Idaho,695000,459007,425634,33373
1984-01-01,Illinois,8597000,5584713,5033958,550755
1984-01-01,Indiana,4066000,2604282,2362121,242161
1984-01-01,Iowa,2161000,1424726,1323822,100904
1984-01-01,Kansas,1791000,1194028,1132401,61627
1984-01-01,Kentucky,2727000,1702759,1538443,164316
1984-01-01,Louisiana,3178000,1919875,1728063,191812
1984-01-01,Maine,860000,541845,504505,37340
1984-01-01,Maryland,3267000,2222409,2098460,123949
1984-01-01,Massachusetts,4493000,3015140,2846557,168583
1984-01-01,Michigan,6725000,4268240,3758111,510129
1984-01-01,Minnesota,3096000,2201627,2051780,149847
1984-01-01,Mississippi,1832000,1070956,955429,115527
1984-01-01,Missouri,3744000,2368422,2165477,202945
1984-01-01,Montana,599000,398756,368050,30706
1984-01-01,Nebraska,1177000,786503,748553,37950
1984-01-01,Nevada,681000,490589,451924,38665
1984-01-01,Ohio,8033000,5091856,4569907,521949
1984-01-01,Oklahoma,2426000,1541175,1434492,106683
1984-01-01,Oregon,2016000,1330464,1202118,128346
1984-01-01,Pennsylvania,9188000,5472887,4957126,515761
1984-01-01,Tennessee,3523000,2210387,1994151,216236
1984-01-01,Texas,11423000,7714279,7186214,528065
1984-01-01,Utah,1050000,697420,646516,50904
1984-01-01,Vermont,394000,268604,253208,15396
1984-01-01,Virginia,4121000,2759975,2620497,139478
1984-01-01,Washington,3208000,2069553,1861093,208460
1984-01-01,Wisconsin,3547000,2399347,2211043,188304
1984-01-01,Wyoming,363000,254955,238632,16323
1984-02-01,Alabama,2928000,1776943,1563259,213684
1984-02-01,Alaska,331000,238549,214256,24293
1984-02-01,Arizona,2239000,1415246,1339478,75768
1984-02-01,Arkansas,1728000,1052456,960677,91779
1984-02-01,California,18985000,12432300,11423242,1009058
1984-02-01,Colorado,2342000,1688516,1600133,88383
1984-02-01,Connecticut,2444000,1650829,1569613,81216
1984-02-01,Delaware,460000,303704,284176,19528
1984-02-01,Florida,8558000,5069256,4714688,354568
1984-02-01,Georgia,4203000,2733195,2562689,170506
1984-02-01,Hawaii,715000,474244,447953,26291
1984-02-01,Idaho,696000,459639,427005,32634
1984-02-01,Illinois,8601000,5590833,5049923,540910
1984-02-01,Indiana,4069000,2609975,2374198,235777
1984-02-01,Iowa,2161000,1424005,1323849,100156
1984-02-01,Kansas,1793000,1195688,1134805,60883
1984-02-01,Kentucky,2728000,1704394,1542360,162034
1984-02-01,Louisiana,3179000,1921983,1732583,189400
1984-02-01,Maine,861000,543353,507229,36124
1984-02-01,Maryland,3271000,2225430,2103977,121453
1984-02-01,Massachusetts,4497000,3022773,2859973,162800
1984-02-01,Michigan,6728000,4276934,3775311,501623
1984-02-01,Minnesota,3098000,2207038,2059862,147176
1984-02-01,Mississippi,1834000,1072249,958028,114221
1984-02-01,Missouri,3747000,2369344,2173071,196273
1984-02-01,Montana,600000,399433,369278,30155
1984-02-01,Nebraska,1178000,786995,749769,37226
1984-02-01,Nevada,683000,491906,454109,37797
1984-02-01,Ohio,8034000,5090260,4579275,510985
1984-02-01,Oklahoma,2426000,1541849,1437067,104782
1984-02-01,Oregon,2018000,1331631,1205254,126377
1984-02-01,Pennsylvania,9190000,5473095,4965904,507191
1984-02-01,Tennessee,3526000,2212730,2002509,210221
1984-02-01,Texas,11443000,7722769,7213131,509638
1984-02-01,Utah,1049000,699069,649687,49382
1984-02-01,Vermont,394000,269197,254235,14962
1984-02-01,Virginia,4127000,2768923,2630862,138061
1984-02-01,Washington,3212000,2070364,1865703,204661
1984-02-01,Wisconsin,3549000,2399551,2216727,182824
1984-02-01,Wyoming,363000,254646,238611,16035
1984-03-01,Alabama,2930000,1779442,1568978,210464
1984-03-01,Alaska,332000,239959,215622,24337
1984-03-01,Arizona,2245000,1420705,1348510,72195
1984-03-01,Arkansas,1729000,1053408,962265,91143
1984-03-01,California,19024000,12475349,11479163,996186
1984-03-01,Colorado,2345000,1694118,1605775,88343
1984-03-01,Connecticut,2445000,1657525,1577954,79571
1984-03-01,Delaware,461000,304959,285844,19115
1984-03-01,Florida,8579000,5090916,4743951,346965
1984-03-01,Georgia,4210000,2743154,2575649,167505
1984-03-01,Hawaii,716000,475165,449013,26152
1984-03-01,Idaho,697000,460501,428193,32308
1984-03-01,Illinois,8604000,5599066,5068477,530589
1984-03-01,Indiana,4071000,2618026,2387811,230215
1984-03-01,Iowa,2161000,1424044,1324418,99626
1984-03-01,Kansas,1794000,1198128,1137837,60291
1984-03-01,Kentucky,2728000,1706241,1545752,160489
1984-03-01,Louisiana,3181000,1926174,1737477,188697
1984-03-01,Maine,862000,545188,510116,35072
1984-03-01,Maryland,3275000,2230938,2110666,120272
1984-03-01,Massachusetts,4501000,3030940,2873522,157418
1984-03-01,Michigan,6731000,4289943,3793629,496314
1984-03-01,Minnesota,3100000,2212709,2067830,144879
1984-03-01,Mississippi,1835000,1074641,961254,113387
1984-03-01,Missouri,3749000,2370439,2181083,189356
1984-03-01,Montana,600000,400602,370675,29927
1984-03-01,Nebraska,1179000,787826,751426,36400
1984-03-01,Nevada,684000,493658,456320,37338
1984-03-01,Ohio,8034000,5093241,4591145,502096
1984-03-01,Oklahoma,2426000,1543152,1439672,103480
1984-03-01,Oregon,2019000,1333361,1208116,125245
1984-03-01,Pennsylvania,9192000,5477073,4975981,501092
1984-03-01,Tennessee,3529000,2215609,2010072,205537
1984-03-01,Texas,11462000,7734209,7240584,493625
1984-03-01,Utah,1049000,701047,652938,48109
1984-03-01,Vermont,395000,269788,255316,14472
1984-03-01,Virginia,4133000,2779466,2641261,138205
1984-03-01,Washington,3215000,2071824,1870673,201151
1984-03-01,Wisconsin,3550000,2401306,2222193,179113
1984-03-01,Wyoming,363000,254444,238685,15759
1984-04-01,Alabama,2933000,1782498,1574780,207718
1984-04-01,Alaska,333000,241343,217085,24258
1984-04-01,Arizona,2252000,1425892,1357067,68825
1984-04-01,Arkansas,1731000,1053441,962844,90597
1984-04-01,California,19062000,12521157,11535006,986151
1984-04-01,Colorado,2348000,1700474,1611195,89279
1984-04-01,Connecticut,2447000,1663842,1585588,78254
1984-04-01,Delaware,461000,306115,287144,18971
1984-04-01,Florida,8601000,5112295,4770849,341446
1984-04-01,Georgia,4218000,2754289,2588488,165801
1984-04-01,Hawaii,717000,475837,449888,25949
1984-04-01,Idaho,698000,461477,429141,32336
1984-04-01,Illinois,8608000,5605496,5086105,519391
1984-04-01,Indiana,4073000,2626027,2400811,225216
1984-04-01,Iowa,2161000,1424379,1325339,99040
1984-04-01,Kansas,1795000,1200828,1140874,59954
1984-04-01,Kentucky,2729000,1707607,1548499,159108
1984-04-01,Louisiana,3182000,1931291,1742217,189074
1984-04-01,Maine,863000,546904,512613,34291
1984-04-01,Maryland,3278000,2237908,2117643,120265
1984-04-01,Massachusetts,4504000,3038607,2886057,152550
1984-04-01,Michigan,6733000,4303650,3811332,492318
1984-04-01,Minnesota,3101000,2217364,2074502,142862
1984-04-01,Mississippi,1836000,1077780,964595,113185
1984-04-01,Missouri,3752000,2371272,2188590,182682
1984-04-01,Montana,601000,402010,372001,30009
1984-04-01,Nebraska,1179000,788719,753122,35597
1984-04-01,Nevada,686000,495665,458380,37285
1984-04-01,Ohio,8035000,5099174,4604840,494334
1984-04-01,Oklahoma,2426000,1544893,1441946,102947
1984-04-01,Oregon,2021000,1335145,1210619,124526
1984-04-01,Pennsylvania,9193000,5482652,4985796,496856
1984-04-01,Tennessee,3532000,2218702,2016696,202006
1984-04-01,Texas,11481000,7745403,7264933,480470
1984-04-01,Utah,1049000,703065,656030,47035
1984-04-01,Vermont,395000,270190,256254,13936
1984-04-01,Virginia,4139000,2790124,2651015,139109
1984-04-01,Washington,3219000,2074046,1876094,197952
1984-04-01,Wisconsin,3552000,2403674,2226895,176779
1984-04-01,Wyoming,363000,254350,238835,15515
1984-05-01,Alabama,2935000,1785534,1580120,205414
1984-05-01,Alaska,335000,242552,218418,24134
1984-05-01,Arizona,2258000,1430901,1364918,65983
1984-05-01,Arkansas,1732000,1052515,962485,90030
1984-05-01,California,19101000,12566309,11586906,979403
1984-05-01,Colorado,2351000,1706336,1615378,90958
1984-05-01,Connecticut,2449000,1669297,1591971,77326
1984-05-01,Delaware,462000,307170,288147,19023
1984-05-01,Florida,8623000,5132545,4794495,338050
1984-05-01,Georgia,4226000,2765220,2599873,165347
1984-05-01,Hawaii,718000,476039,450301,25738
1984-05-01,Idaho,699000,462556,429904,32652
1984-05-01,Illinois,8611000,5609093,5099991,509102
1984-05-01,Indiana,4075000,2631885,2410796,221089
1984-05-01,Iowa,2162000,1424387,1325784,98603
1984-05-01,Kansas,1796000,1203324,1143513,59811
1984-05-01,Kentucky,2730000,1708139,1550500,157639
1984-05-01,Louisiana,3183000,1936392,1745906,190486
1984-05-01,Maine,864000,548374,514576,33798
1984-05-01,Maryland,3282000,2245085,2124137,120948
1984-05-01,Massachusetts,4508000,3044962,2896629,148333
1984-05-01,Michigan,6736000,4315430,3826763,488667
1984-05-01,Minnesota,3103000,2219933,2078887,141046
1984-05-01,Mississippi,1837000,1081171,967543,113628
1984-05-01,Missouri,3754000,2372042,2195419,176623
1984-05-01,Montana,601000,403348,373055,30293
1984-05-01,Nebraska,1180000,789713,754691,35022
1984-05-01,Nevada,688000,497792,460222,37570
1984-05-01,Ohio,8036000,5106407,4618896,487511
1984-05-01,Oklahoma,2425000,1546798,1443645,103153
1984-05-01,Oregon,2023000,1336504,1212449,124055
1984-05-01,Pennsylvania,9195000,5487678,4993710,493968
1984-05-01,Tennessee,3535000,2222180,2022720,199460
1984-05-01,Texas,11500000,7889976,7419143,470833
1984-05-01,Utah,1049000,705021,658854,46167
1984-05-01,Vermont,395000,270421,256999,13422
1984-05-01,Virginia,4146000,2800030,2659769,140261
1984-05-01,Washington,3223000,2076724,1881488,195236
1984-05-01,Wisconsin,3553000,2405961,2230323,175638
1984-05-01,Wyoming,362000,254417,239021,15396
1984-06-01,Alabama,2938000,1787806,1584542,203264
1984-06-01,Alaska,336000,243529,219481,24048
1984-06-01,Arizona,2265000,1435993,1371865,64128
1984-06-01,Arkansas,1734000,1050830,961336,89494
1984-06-01,California,19139000,12607944,11632800,975144
1984-06-01,Colorado,2354000,1710664,1617513,93151
1984-06-01,Connecticut,2450000,1673382,1596635,76747
1984-06-01,Delaware,462000,308082,288924,19158
1984-06-01,Florida,8644000,5150951,4814777,336174
1984-06-01,Georgia,4233000,2774796,2608972,165824
1984-06-01,Hawaii,719000,475657,450107,25550
1984-06-01,Idaho,700000,463569,430477,33092
1984-06-01,Illinois,8615000,5610589,5109336,501253
1984-06-01,Indiana,4077000,2634502,2416533,217969
1984-06-01,Iowa,2162000,1423774,1325456,98318
1984-06-01,Kansas,1797000,1205260,1145489,59771
1984-06-01,Kentucky,2730000,1707620,1551784,155836
1984-06-01,Louisiana,3185000,1940758,1747861,192897
1984-06-01,Maine,865000,549430,515954,33476
1984-06-01,Maryland,3285000,2251172,2129572,121600
1984-06-01,Massachusetts,4511000,3049478,2904736,144742
1984-06-01,Michigan,6739000,4323633,3838531,485102
1984-06-01,Minnesota,3105000,2220288,2081041,139247
1984-06-01,Mississippi,1838000,1084501,969916,114585
1984-06-01,Missouri,3757000,2372740,2201322,171418
1984-06-01,Montana,602000,404369,373781,30588
1984-06-01,Nebraska,1180000,790790,756019,34771
1984-06-01,Nevada,689000,499822,461807,38015
1984-06-01,Ohio,8036000,5113004,4631563,481441
1984-06-01,Oklahoma,2425000,1548304,1444447,103857
1984-06-01,Oregon,2024000,1337091,1213410,123681
1984-06-01,Pennsylvania,9196000,5491534,4999536,491998
1984-06-01,Tennessee,3538000,2226092,2028653,197439
1984-06-01,Texas,11519000,7936311,7471187,465124
1984-06-01,Utah,1048000,706843,661328,45515
1984-06-01,Vermont,396000,270532,257556,12976
1984-06-01,Virginia,4152000,2808927,2667605,141322
1984-06-01,Washington,3226000,2079097,1886165,192932
1984-06-01,Wisconsin,3555000,2406996,2231990,175006
1984-06-01,Wyoming,362000,254653,239169,15484
1984-07-01,Alabama,2940000,1788839,1587926,200913
1984-07-01,Alaska,337000,244329,220338,23991
1984-07-01,Arizona,2271000,1441250,1377529,63721
1984-07-01,Arkansas,1735000,1048542,959605,88937
1984-07-01,California,19178000,12643147,11671911,971236
1984-07-01,Colorado,2357000,1712944,1617674,95270
1984-07-01,Connecticut,2452000,1675765,1599364,76401
1984-07-01,Delaware,463000,308805,289559,19246
1984-07-01,Florida,8666000,5166657,4831767,334890
1984-07-01,Georgia,4241000,2782338,2615618,166720
1984-07-01,Hawaii,720000,474644,449247,25397
1984-07-01,Idaho,701000,464291,430811,33480
1984-07-01,Illinois,8618000,5610464,5114218,496246
1984-07-01,Indiana,4079000,2634538,2418580,215958
1984-07-01,Iowa,2162000,1422405,1324210,98195
1984-07-01,Kansas,1798000,1206336,1146707,59629
1984-07-01,Kentucky,2731000,1705895,1552309,153586
1984-07-01,Louisiana,3186000,1943521,1747615,195906
1984-07-01,Maine,866000,549953,516803,33150
1984-07-01,Maryland,3289000,2255306,2133711,121595
1984-07-01,Massachusetts,4515000,3051800,2910222,141578
1984-07-01,Michigan,6742000,4326932,3845466,481466
1984-07-01,Minnesota,3107000,2219207,2081877,137330
1984-07-01,Mississippi,1839000,1087548,971841,115707
1984-07-01,Missouri,3759000,2373379,2206025,167354
1984-07-01,Montana,602000,404881,374207,30674
1984-07-01,Nebraska,1181000,791660,756978,34682
1984-07-01,Nevada,691000,501602,463165,38437
1984-07-01,Ohio,8037000,5117460,4641583,475877
1984-07-01,Oklahoma,2425000,1548762,1444249,104513
1984-07-01,Oregon,2026000,1336956,1213559,123397
1984-07-01,Pennsylvania,9198000,5494500,5004359,490141
1984-07-01,Tennessee,3541000,2229953,2034822,195131
1984-07-01,Texas,11538000,7950160,7487337,462823
1984-07-01,Utah,1048000,708548,663477,45071
1984-07-01,Vermont,396000,270588,257963,12625
1984-07-01,Virginia,4158000,2816763,2674518,142245
1984-07-01,Washington,3230000,2080267,1889519,190748
1984-07-01,Wisconsin,3556000,2405654,2231787,173867
1984-07-01,Wyoming,362000,254974,239224,15750
1984-08-01,Alabama,2943000,1789158,1590801,198357
1984-08-01,Alaska,338000,245045,221105,23940
1984-08-01,Arizona,2278000,1446448,1381314,65134
1984-08-01,Arkansas,1736000,1046129,957763,88366
1984-08-01,California,19219000,12674302,11706943,967359
1984-08-01,Colorado,2360000,1713130,1616506,96624
1984-08-01,Connecticut,2454000,1676966,1600724,76242
1984-08-01,Delaware,464000,309428,290206,19222
1984-08-01,Florida,8687000,5181075,4847184,333891
1984-08-01,Georgia,4252000,2788512,2620713,167799
1984-08-01,Hawaii,721000,473402,448007,25395
1984-08-01,Idaho,701000,464661,430884,33777
1984-08-01,Illinois,8619000,5611409,5116431,494978
1984-08-01,Indiana,4080000,2634066,2419024,215042
1984-08-01,Iowa,2161000,1420651,1322206,98445
1984-08-01,Kansas,1797000,1206892,1147513,59379
1984-08-01,Kentucky,2732000,1703332,1552159,151173
1984-08-01,Louisiana,3187000,1944847,1745473,199374
1984-08-01,Maine,867000,550139,517432,32707
1984-08-01,Maryland,3293000,2257714,2136976,120738
1984-08-01,Massachusetts,4517000,3052255,2913529,138726
1984-08-01,Michigan,6746000,4326996,3848652,478344
1984-08-01,Minnesota,3108000,2217991,2082334,135657
1984-08-01,Mississippi,1842000,1090322,973725,116597
1984-08-01,Missouri,3760000,2374644,2209987,164657
1984-08-01,Montana,602000,404986,374430,30556
1984-08-01,Nebraska,1180000,792212,757591,34621
1984-08-01,Nevada,694000,503169,464391,38778
1984-08-01,Ohio,8040000,5120046,4648643,471403
1984-08-01,Oklahoma,2423000,1548313,1443483,104830
1984-08-01,Oregon,2026000,1336147,1213130,123017
1984-08-01,Pennsylvania,9198000,5496955,5009674,487281
1984-08-01,Tennessee,3546000,2233357,2041160,192197
1984-08-01,Texas,11557000,7953957,7489843,464114
1984-08-01,Utah,1049000,710363,665444,44919
1984-08-01,Vermont,397000,270727,258348,12379
1984-08-01,Virginia,4163000,2824186,2680981,143205
1984-08-01,Washington,3232000,2080289,1891690,188599
1984-08-01,Wisconsin,3557000,2402144,2230256,171888
1984-08-01,Wyoming,362000,255257,239169,16088
1984-09-01,Alabama,2945000,1789576,1594044,195532
1984-09-01,Alaska,338000,245698,221821,23877
1984-09-01,Arizona,2286000,1451558,1383219,68339
1984-09-01,Arkansas,1737000,1044008,956059,87949
1984-09-01,California,19261000,12705370,11741730,963640
1984-09-01,Colorado,2362000,1712043,1614750,97293
1984-09-01,Connecticut,2455000,1677825,1601582,76243
1984-09-01,Delaware,465000,310032,290933,19099
1984-09-01,Florida,8709000,5196282,4863195,333087
1984-09-01,Georgia,4263000,2794692,2625595,169097
1984-09-01,Hawaii,722000,472535,446962,25573
1984-09-01,Idaho,701000,464737,430762,33975
1984-09-01,Illinois,8621000,5615184,5117981,497203
1984-09-01,Indiana,4081000,2634935,2419660,215275
1984-09-01,Iowa,2160000,1418842,1319601,99241
1984-09-01,Kansas,1797000,1207690,1148446,59244
1984-09-01,Kentucky,2734000,1700706,1551565,149141
1984-09-01,Louisiana,3188000,1945580,1742295,203285
1984-09-01,Maine,868000,550333,518120,32213
1984-09-01,Maryland,3298000,2259361,2139914,119447
1984-09-01,Massachusetts,4518000,3051568,2915444,136124
1984-09-01,Michigan,6751000,4326772,3850944,475828
1984-09-01,Minnesota,3109000,2217458,2082957,134501
1984-09-01,Mississippi,1844000,1092956,976019,116937
1984-09-01,Missouri,3762000,2377380,2214083,163297
1984-09-01,Montana,602000,404861,374516,30345
1984-09-01,Nebraska,1179000,792609,757995,34614
1984-09-01,Nevada,697000,504590,465616,38974
1984-09-01,Ohio,8044000,5120598,4652232,468366
1984-09-01,Oklahoma,2421000,1547606,1442440,105166
1984-09-01,Oregon,2026000,1334494,1211848,122646
1984-09-01,Pennsylvania,9198000,5499183,5015810,483373
1984-09-01,Tennessee,3551000,2235746,2046663,189083
1984-09-01,Texas,11576000,7957503,7487566,469937
1984-09-01,Utah,1051000,712480,667432,45048
1984-09-01,Vermont,397000,271112,258860,12252
1984-09-01,Virginia,4167000,2831352,2687073,144279
1984-09-01,Washington,3234000,2079910,1893141,186769
1984-09-01,Wisconsin,3559000,2397902,2228313,169589
1984-09-01,Wyoming,361000,255409,238991,16418
1984-10-01,Alabama,2948000,1790785,1598410,192375
1984-10-01,Alaska,339000,246294,222492,23802
1984-10-01,Arizona,2293000,1456802,1384104,72698
1984-10-01,Arkansas,1738000,1042527,954787,87740
1984-10-01,California,19302000,12739684,11780495,959189
1984-10-01,Colorado,2365000,1710854,1612994,97860
1984-10-01,Connecticut,2457000,1679425,1603089,76336
1984-10-01,Delaware,465000,310664,291764,18900
1984-10-01,Florida,8730000,5213774,4881518,332256
1984-10-01,Georgia,4273000,2802372,2631814,170558
1984-10-01,Hawaii,723000,472388,446640,25748
1984-10-01,Idaho,701000,464670,430622,34048
1984-10-01,Illinois,8622000,5621985,5121727,500258
1984-10-01,Indiana,4082000,2639045,2422647,216398
1984-10-01,Iowa,2159000,1417231,1316805,100426
1984-10-01,Kansas,1796000,1209642,1150173,59469
1984-10-01,Kentucky,2735000,1699025,1551225,147800
1984-10-01,Louisiana,3189000,1946865,1739405,207460
1984-10-01,Maine,868000,550844,519072,31772
1984-10-01,Maryland,3302000,2261183,2143239,117944
1984-10-01,Massachusetts,4520000,3051010,2917298,133712
1984-10-01,Michigan,6755000,4328341,3855447,472894
1984-10-01,Minnesota,3110000,2218284,2084555,133729
1984-10-01,Mississippi,1847000,1095752,979091,116661
1984-10-01,Missouri,3763000,2382309,2219335,162974
1984-10-01,Montana,602000,404612,374497,30115
1984-10-01,Nebraska,1178000,793176,758443,34733
1984-10-01,Nevada,699000,505953,466983,38970
1984-10-01,Ohio,8047000,5119599,4653536,466063
1984-10-01,Oklahoma,2419000,1547724,1441744,105980
1984-10-01,Oregon,2025000,1332324,1209767,122557
1984-10-01,Pennsylvania,9198000,5502275,5023786,478489
1984-10-01,Tennessee,3556000,2236765,2050603,186162
1984-10-01,Texas,11595000,7965952,7485937,480015
1984-10-01,Utah,1052000,714937,669653,45284
1984-10-01,Vermont,398000,271800,259571,12229
1984-10-01,Virginia,4172000,2838249,2692620,145629
1984-10-01,Washington,3236000,2079879,1894415,185464
1984-10-01,Wisconsin,3560000,2394766,2226959,167807
1984-10-01,Wyoming,361000,255389,238728,16661
1984-11-01,Alabama,2950000,1793233,1604282,188951
1984-11-01,Alaska,339000,246909,223161,23748
1984-11-01,Arizona,2300000,1462302,1385092,77210
1984-11-01,Arkansas,1739000,1042109,954493,87616
1984-11-01,California,19344000,12779441,11825891,953550
1984-11-01,Colorado,2367000,1710713,1612230,98483
1984-11-01,Connecticut,2458000,1682466,1606074,76392
1984-11-01,Delaware,466000,311359,292683,18676
1984-11-01,Florida,8751000,5234392,4902847,331545
1984-11-01,Georgia,4284000,2812538,2640307,172231
1984-11-01,Hawaii,724000,473003,447275,25728
1984-11-01,Idaho,700000,464769,430669,34100
1984-11-01,Illinois,8623000,5631952,5130409,501543
1984-11-01,Indiana,4083000,2647577,2430158,217419
1984-11-01,Iowa,2157000,1416501,1314726,101775
1984-11-01,Kansas,1795000,1213186,1153182,60004
1984-11-01,Kentucky,2736000,1698867,1551898,146969
1984-11-01,Louisiana,3190000,1949608,1738176,211432
1984-11-01,Maine,869000,551828,520326,31502
1984-11-01,Maryland,3307000,2263833,2147550,116283
1984-11-01,Massachusetts,4521000,3051641,2920274,131367
1984-11-01,Michigan,6760000,4332999,3864101,468898
1984-11-01,Minnesota,3111000,2220555,2087310,133245
1984-11-01,Mississippi,1849000,1099243,983213,116030
1984-11-01,Missouri,3764000,2389699,2226543,163156
1984-11-01,Montana,603000,404434,374463,29971
1984-11-01,Nebraska,1177000,794292,759253,35039
1984-11-01,Nevada,702000,507454,468587,38867
1984-11-01,Ohio,8051000,5119000,4655368,463632
1984-11-01,Oklahoma,2417000,1549264,1442083,107181
1984-11-01,Oregon,2025000,1330236,1207575,122661
1984-11-01,Pennsylvania,9198000,5507378,5034974,472404
1984-11-01,Tennessee,3561000,2237478,2053922,183556
1984-11-01,Texas,11614000,7981200,7489162,492038
1984-11-01,Utah,1053000,717711,672253,45458
1984-11-01,Vermont,398000,272748,260472,12276
1984-11-01,Virginia,4176000,2845147,2697781,147366
1984-11-01,Washington,3238000,2080922,1896584,184338
1984-11-01,Wisconsin,3562000,2393922,2226669,167253
1984-11-01,Wyoming,360000,255214,238478,16736
1984-12-01,Alabama,2953000,1796526,1611019,185507
1984-12-01,Alaska,340000,247567,223844,23723
1984-12-01,Arizona,2307000,1467740,1386603,81137
1984-12-01,Arkansas,1740000,1042814,955345,87469
1984-12-01,California,19385000,12822733,11875139,947594
1984-12-01,Colorado,2370000,1712073,1613165,98908
1984-12-01,Connecticut,2460000,1686741,1610344,76397
1984-12-01,Delaware,467000,312045,293571,18474
1984-12-01,Florida,8773000,5257208,4926159,331049
1984-12-01,Georgia,4295000,2824745,2650275,174470
1984-12-01,Hawaii,725000,474145,448704,25441
1984-12-01,Idaho,700000,465253,430984,34269
1984-12-01,Illinois,8624000,5644198,5143234,500964
1984-12-01,Indiana,4084000,2659861,2442232,217629
1984-12-01,Iowa,2156000,1417073,1314040,103033
1984-12-01,Kansas,1795000,1217905,1157243,60662
1984-12-01,Kentucky,2737000,1699891,1553436,146455
1984-12-01,Louisiana,3191000,1953769,1739070,214699
1984-12-01,Maine,870000,553209,521740,31469
1984-12-01,Maryland,3311000,2267048,2152520,114528
1984-12-01,Massachusetts,4523000,3053651,2924427,129224
1984-12-01,Michigan,6764000,4340118,3876355,463763
1984-12-01,Minnesota,3112000,2223444,2090529,132915
1984-12-01,Mississippi,1852000,1103531,988118,115413
1984-12-01,Missouri,3766000,2399050,2235443,163607
1984-12-01,Montana,603000,404518,374486,30032
1984-12-01,Nebraska,1176000,796082,760519,35563
1984-12-01,Nevada,705000,509192,470370,38822
1984-12-01,Ohio,8054000,5120146,4659463,460683
1984-12-01,Oklahoma,2415000,1552039,1443554,108485
1984-12-01,Oregon,2025000,1328586,1206050,122536
1984-12-01,Pennsylvania,9198000,5514223,5048566,465657
1984-12-01,Tennessee,3566000,2239056,2057481,181575
1984-12-01,Texas,11633000,8001786,7497758,504028
1984-12-01,Utah,1054000,720666,675165,45501
1984-12-01,Vermont,399000,273841,261481,12360
1984-12-01,Virginia,4181000,2851716,2702387,149329
1984-12-01,Washington,3240000,2083439,1900407,183032
1984-12-01,Wisconsin,3563000,2395210,2227318,167892
1984-12-01,Wyoming,360000,254988,238329,16659
1985-01-01,Alabama,2955000,1799624,1617064,182560
1985-01-01,Alaska,340000,248179,224421,23758
1985-01-01,Arizona,2315000,1472220,1387874,84346
1985-01-01,Arkansas,1741000,1044414,957043,87371
1985-01-01,California,19426000,12863443,11919980,943463
1985-01-01,Colorado,2372000,1714353,1615225,99128
1985-01-01,Connecticut,2461000,1691149,1614645,76504
1985-01-01,Delaware,468000,312634,294347,18287
1985-01-01,Florida,8794000,5279170,4948179,330991
1985-01-01,Georgia,4306000,2837182,2659469,177713
1985-01-01,Hawaii,725000,475466,450463,25003
1985-01-01,Idaho,700000,465931,431325,34606
1985-01-01,Illinois,8626000,5655540,5155209,500331
1985-01-01,Indiana,4085000,2673647,2456308,217339
1985-01-01,Iowa,2155000,1418613,1314518,104095
1985-01-01,Kansas,1794000,1222773,1161386,61387
1985-01-01,Kentucky,2739000,1701031,1554602,146429
1985-01-01,Louisiana,3192000,1958439,1741240,217199
1985-01-01,Maine,871000,554635,522977,31658
1985-01-01,Maryland,3315000,2269896,2156981,112915
1985-01-01,Massachusetts,4524000,3056322,2928595,127727
1985-01-01,Michigan,6768000,4347581,3889268,458313
1985-01-01,Minnesota,3113000,2225704,2093135,132569
1985-01-01,Mississippi,1854000,1107918,992827,115091
1985-01-01,Missouri,3767000,2409014,2244536,164478
1985-01-01,Montana,603000,404799,374492,30307
1985-01-01,Nebraska,1176000,798288,761811,36477
1985-01-01,Nevada,708000,511049,472101,38948
1985-01-01,Ohio,8057000,5122410,4664836,457574
1985-01-01,Oklahoma,2413000,1554925,1445117,109808
1985-01-01,Oregon,2025000,1327550,1205613,121937
1985-01-01,Pennsylvania,9198000,5521081,5061175,459906
1985-01-01,Tennessee,3571000,2241610,2061163,180447
1985-01-01,Texas,11651000,8023844,7507955,515889
1985-01-01,Utah,1056000,723495,678070,45425
1985-01-01,Vermont,399000,274883,262418,12465
1985-01-01,Virginia,4185000,2857017,2705694,151323
1985-01-01,Washington,3242000,2087229,1905494,181735
1985-01-01,Wisconsin,3564000,2397329,2228055,169274
1985-01-01,Wyoming,360000,254783,238254,16529
1985-02-01,Alabama,2958000,1801567,1621366,180201
1985-02-01,Alaska,341000,248578,224662,23916
1985-02-01,Arizona,2322000,1475124,1387802,87322
1985-02-01,Arkansas,1743000,1046633,959109,87524
1985-02-01,California,19468000,12895830,11953332,942498
1985-02-01,Colorado,2375000,1716142,1616928,99214
1985-02-01,Connecticut,2463000,1694519,1617705,76814
1985-02-01,Delaware,468000,313164,295115,18049
1985-02-01,Florida,8815000,5296804,4965421,331383
1985-02-01,Georgia,4316000,2847888,2666132,181756
1985-02-01,Hawaii,726000,476698,452070,24628
1985-02-01,Idaho,700000,466541,431384,35157
1985-02-01,Illinois,8627000,5662345,5160860,501485
1985-02-01,Indiana,4086000,2685987,2468959,217028
1985-02-01,Iowa,2154000,1420407,1315391,105016
1985-02-01,Kansas,1793000,1226780,1164689,62091
1985-02-01,Kentucky,2740000,1701313,1554281,147032
1985-02-01,Louisiana,3193000,1962502,1743235,219267
1985-02-01,Maine,871000,555579,523635,31944
1985-02-01,Maryland,3320000,2271610,2160021,111589
1985-02-01,Massachusetts,4526000,3058246,2931122,127124
1985-02-01,Michigan,6773000,4352906,3899211,453695
1985-02-01,Minnesota,3114000,2226706,2094330,132376
1985-02-01,Mississippi,1857000,1111797,996603,115194
1985-02-01,Missouri,3768000,2417980,2252479,165501
1985-02-01,Montana,603000,405015,374366,30649
1985-02-01,Nebraska,1175000,800415,762712,37703
1985-02-01,Nevada,711000,512792,473542,39250
1985-02-01,Ohio,8061000,5124229,4668617,455612
1985-02-01,Oklahoma,2410000,1556780,1445717,111063
1985-02-01,Oregon,2024000,1326871,1205829,121042
1985-02-01,Pennsylvania,9199000,5526457,5070184,456273
1985-02-01,Tennessee,3577000,2244804,2064600,180204
1985-02-01,Texas,11670000,8043474,7515524,527950
1985-02-01,Utah,1057000,725933,680624,45309
1985-02-01,Vermont,400000,275769,263165,12604
1985-02-01,Virginia,4190000,2860710,2707252,153458
1985-02-01,Washington,3244000,2091531,1910938,180593
1985-02-01,Wisconsin,3566000,2398743,2227800,170943
1985-02-01,Wyoming,359000,254604,238106,16498
1985-03-01,Alabama,2960000,1801810,1623864,177946
1985-03-01,Alaska,341000,248676,224506,24170
1985-03-01,Arizona,2329000,1476564,1386295,90269
1985-03-01,Arkansas,1744000,1049121,961148,87973
1985-03-01,California,19509000,12916514,11973521,942993
1985-03-01,Colorado,2377000,1716430,1617066,99364
1985-03-01,Connecticut,2465000,1696246,1619103,77143
1985-03-01,Delaware,469000,313739,295997,17742
1985-03-01,Florida,8837000,5308320,4976887,331433
1985-03-01,Georgia,4327000,2855666,2670077,185589
1985-03-01,Hawaii,727000,477706,453248,24458
1985-03-01,Idaho,700000,466922,431139,35783
1985-03-01,Illinois,8628000,5663207,5158942,504265
1985-03-01,Indiana,4087000,2694937,2478356,216581
1985-03-01,Iowa,2153000,1421503,1315927,105576
1985-03-01,Kansas,1793000,1229169,1166623,62546
1985-03-01,Kentucky,2741000,1700224,1552297,147927
1985-03-01,Louisiana,3194000,1965215,1744147,221068
1985-03-01,Maine,872000,555683,523610,32073
1985-03-01,Maryland,3324000,2272030,2161715,110315
1985-03-01,Massachusetts,4527000,3058297,2931200,127097
1985-03-01,Michigan,6777000,4354609,3904646,449963
1985-03-01,Minnesota,3115000,2226659,2094350,132309
1985-03-01,Mississippi,1859000,1114805,999369,115436
1985-03-01,Missouri,3770000,2424606,2258689,165917
1985-03-01,Montana,603000,404987,374127,30860
1985-03-01,Nebraska,1174000,802048,763078,38970
1985-03-01,Nevada,714000,514146,474582,39564
1985-03-01,Ohio,8064000,5124310,4669438,454872
1985-03-01,Oklahoma,2408000,1556710,1445010,111700
1985-03-01,Oregon,2024000,1325860,1205914,119946
1985-03-01,Pennsylvania,9199000,5529612,5075495,454117
1985-03-01,Tennessee,3582000,2247870,2067466,180404
1985-03-01,Texas,11689000,8057774,7518458,539316
1985-03-01,Utah,1058000,727806,682655,45151
1985-03-01,Vermont,400000,276498,263730,12768
1985-03-01,Virginia,4195000,2862751,2707104,155647
1985-03-01,Washington,3246000,2095498,1916211,179287
1985-03-01,Wisconsin,3567000,2398533,2226280,172253
1985-03-01,Wyoming,359000,254416,237781,16635
1985-04-01,Alabama,2963000,1800578,1625007,175571
1985-04-01,Alaska,342000,248626,224191,24435
1985-04-01,Arizona,2336000,1477859,1384816,93043
1985-04-01,Arkansas,1745000,1051607,962929,88678
1985-04-01,California,19551000,12926628,11983223,943405
1985-04-01,Colorado,2380000,1715609,1615745,99864
1985-04-01,Connecticut,2466000,1696463,1619163,77300
1985-04-01,Delaware,470000,314438,297045,17393
1985-04-01,Florida,8858000,5314854,4984018,330836
1985-04-01,Georgia,4338000,2860937,2672560,188377
1985-04-01,Hawaii,728000,478468,453932,24536
1985-04-01,Idaho,700000,466997,430701,36296
1985-04-01,Illinois,8629000,5659258,5151135,508123
1985-04-01,Indiana,4088000,2700112,2484295,215817
1985-04-01,Iowa,2152000,1421708,1316017,105691
1985-04-01,Kansas,1792000,1229787,1167135,62652
1985-04-01,Kentucky,2742000,1698237,1549234,149003
1985-04-01,Louisiana,3195000,1966585,1743896,222689
1985-04-01,Maine,873000,554950,523060,31890
1985-04-01,Maryland,3329000,2271720,2162783,108937
1985-04-01,Massachusetts,4529000,3056292,2929007,127285
1985-04-01,Michigan,6782000,4353626,3906299,447327
1985-04-01,Minnesota,3116000,2226403,2094015,132388
1985-04-01,Mississippi,1862000,1116991,1001315,115676
1985-04-01,Missouri,3771000,2428601,2263197,165404
1985-04-01,Montana,603000,404725,373854,30871
1985-04-01,Nebraska,1173000,803013,762954,40059
1985-04-01,Nevada,716000,515042,475330,39712
1985-04-01,Ohio,8068000,5123271,4667913,455358
1985-04-01,Oklahoma,2406000,1554891,1443519,111372
1985-04-01,Oregon,2024000,1324378,1205675,118703
1985-04-01,Pennsylvania,9199000,5531223,5078672,452551
1985-04-01,Tennessee,3587000,2249989,2069408,180581
1985-04-01,Texas,11708000,8066167,7516526,549641
1985-04-01,Utah,1059000,729294,684302,44992
1985-04-01,Vermont,401000,277136,264202,12934
1985-04-01,Virginia,4199000,2863230,2705540,157690
1985-04-01,Washington,3248000,2098718,1921062,177656
1985-04-01,Wisconsin,3569000,2396583,2223779,172804
1985-04-01,Wyoming,358000,254261,237308,16953
1985-05-01,Alabama,2965000,1798990,1625773,173217
1985-05-01,Alaska,342000,248605,223978,24627
1985-05-01,Arizona,2344000,1479866,1384266,95600
1985-05-01,Arkansas,1746000,1053902,964407,89495
1985-05-01,California,19592000,12932221,11988652,943569
1985-05-01,Colorado,2382000,1714209,1613528,100681
1985-05-01,Connecticut,2468000,1695974,1618751,77223
1985-05-01,Delaware,471000,315303,298291,17012
1985-05-01,Florida,8879000,5319250,4989582,329668
1985-05-01,Georgia,4349000,2865075,2675343,189732
1985-05-01,Hawaii,729000,479141,454304,24837
1985-05-01,Idaho,699000,466776,430154,36622
1985-05-01,Illinois,8631000,5653192,5140381,512811
1985-05-01,Indiana,4089000,2702231,2487798,214433
1985-05-01,Iowa,2150000,1421510,1315936,105574
1985-05-01,Kansas,1791000,1229235,1166658,62577
1985-05-01,Kentucky,2744000,1696230,1545911,150319
1985-05-01,Louisiana,3196000,1967221,1743087,224134
1985-05-01,Maine,874000,553720,522277,31443
1985-05-01,Maryland,3333000,2271563,2164097,107466
1985-05-01,Massachusetts,4530000,3052991,2925485,127506
1985-05-01,Michigan,6786000,4352041,3906033,446008
1985-05-01,Minnesota,3117000,2227194,2094237,132957
1985-05-01,Mississippi,1864000,1118824,1002826,115998
1985-05-01,Missouri,3772000,2430944,2266598,164346
1985-05-01,Montana,604000,404325,373541,30784
1985-05-01,Nebraska,1172000,803322,762512,40810
1985-05-01,Nevada,719000,515586,475943,39643
1985-05-01,Ohio,8071000,5123031,4665684,457347
1985-05-01,Oklahoma,2404000,1552501,1442140,110361
1985-05-01,Oregon,2024000,1322697,1205510,117187
1985-05-01,Pennsylvania,9199000,5533021,5082044,450977
1985-05-01,Tennessee,3592000,2250777,2070392,180385
1985-05-01,Texas,11727000,8070857,7511252,559605
1985-05-01,Utah,1061000,730657,685755,44902
1985-05-01,Vermont,401000,277762,264694,13068
1985-05-01,Virginia,4204000,2862887,2703730,159157
1985-05-01,Washington,3250000,2101245,1925430,175815
1985-05-01,Wisconsin,3570000,2393524,2221113,172411
1985-05-01,Wyoming,358000,254113,236735,17378
1985-06-01,Alabama,2968000,1798404,1627270,171134
1985-06-01,Alaska,343000,248712,224011,24701
1985-06-01,Arizona,2351000,1482987,1385297,97690
1985-06-01,Arkansas,1747000,1055832,965602,90230
1985-06-01,California,19634000,12940405,11997098,943307
1985-06-01,Colorado,2385000,1712563,1610892,101671
1985-06-01,Connecticut,2469000,1696121,1619272,76849
1985-06-01,Delaware,471000,316348,299740,16608
1985-06-01,Florida,8901000,5324745,4996878,327867
1985-06-01,Georgia,4359000,2869460,2680011,189449
1985-06-01,Hawaii,730000,480021,454745,25276
1985-06-01,Idaho,699000,466389,429637,36752
1985-06-01,Illinois,8632000,5648239,5130266,517973
1985-06-01,Indiana,4090000,2702836,2490544,212292
1985-06-01,Iowa,2149000,1421488,1315916,105572
1985-06-01,Kansas,1791000,1228462,1165973,62489
1985-06-01,Kentucky,2745000,1695005,1543085,151920
1985-06-01,Louisiana,3197000,1967780,1742380,225400
1985-06-01,Maine,874000,552619,521709,30910
1985-06-01,Maryland,3338000,2272384,2166413,105971
1985-06-01,Massachusetts,4532000,3049627,2922069,127558
1985-06-01,Michigan,6791000,4352397,3907007,445390
1985-06-01,Minnesota,3118000,2229629,2095500,134129
1985-06-01,Mississippi,1867000,1120630,1004312,116318
1985-06-01,Missouri,3774000,2433287,2270199,163088
1985-06-01,Montana,604000,403920,373230,30690
1985-06-01,Nebraska,1171000,803377,762151,41226
1985-06-01,Nevada,722000,516039,476651,39388
1985-06-01,Ohio,8075000,5125612,4664920,460692
1985-06-01,Oklahoma,2402000,1550933,1441729,109204
1985-06-01,Oregon,2023000,1321422,1206097,115325
1985-06-01,Pennsylvania,9199000,5536034,5087222,448812
1985-06-01,Tennessee,3597000,2250461,2070792,179669
1985-06-01,Texas,11746000,8075558,7505901,569657
1985-06-01,Utah,1062000,732135,687303,44832
1985-06-01,Vermont,402000,278477,265327,13150
1985-06-01,Virginia,4208000,2862709,2703058,159651
1985-06-01,Washington,3252000,2103737,1929710,174027
1985-06-01,Wisconsin,3572000,2391062,2219545,171517
1985-06-01,Wyoming,357000,253965,236146,17819
1985-07-01,Alabama,2970000,1799526,1629958,169568
1985-07-01,Alaska,343000,248978,224265,24713
1985-07-01,Arizona,2358000,1487453,1388268,99185
1985-07-01,Arkansas,1748000,1057280,966457,90823
1985-07-01,California,19675000,12955986,12013707,942279
1985-07-01,Colorado,2387000,1710710,1607993,102717
1985-07-01,Connecticut,2471000,1698045,1621879,76166
1985-07-01,Delaware,472000,317460,301270,16190
1985-07-01,Florida,8922000,5333127,5007556,325571
1985-07-01,Georgia,4370000,2874844,2687122,187722
1985-07-01,Hawaii,731000,481312,455620,25692
1985-07-01,Idaho,699000,466108,429361,36747
1985-07-01,Illinois,8633000,5647292,5124267,523025
1985-07-01,Indiana,4091000,2703343,2493809,209534
1985-07-01,Iowa,2148000,1421908,1316113,105795
1985-07-01,Kansas,1790000,1228468,1165702,62766
1985-07-01,Kentucky,2746000,1695091,1541240,153851
1985-07-01,Louisiana,3198000,1969129,1742382,226747
1985-07-01,Maine,875000,552226,521763,30463
1985-07-01,Maryland,3342000,2274558,2170010,104548
1985-07-01,Massachusetts,4533000,3047336,2919954,127382
1985-07-01,Michigan,6795000,4356070,3912128,443942
1985-07-01,Minnesota,3119000,2233647,2097911,135736
1985-07-01,Mississippi,1869000,1122703,1005937,116766
1985-07-01,Missouri,3775000,2436946,2275107,161839
1985-07-01,Montana,604000,403637,372900,30737
1985-07-01,Nebraska,1170000,803777,762265,41512
1985-07-01,Nevada,725000,516661,477610,39051
1985-07-01,Ohio,8078000,5132039,4667202,464837
1985-07-01,Oklahoma,2400000,1551297,1442655,108642
1985-07-01,Oregon,2023000,1321361,1207955,113406
1985-07-01,Pennsylvania,9199000,5541052,5095129,445923
1985-07-01,Tennessee,3602000,2249878,2071165,178713
1985-07-01,Texas,11765000,8082709,7503257,579452
1985-07-01,Utah,1063000,733857,689114,44743
1985-07-01,Vermont,402000,279352,266181,13171
1985-07-01,Virginia,4213000,2863476,2704304,159172
1985-07-01,Washington,3254000,2106732,1934190,172542
1985-07-01,Wisconsin,3573000,2390565,2219633,170932
1985-07-01,Wyoming,357000,253803,235603,18200
1985-08-01,Alabama,2973000,1802236,1634061,168175
1985-08-01,Alaska,344000,249456,224773,24683
1985-08-01,Arizona,2364000,1493229,1393648,99581
1985-08-01,Arkansas,1749000,1058212,967224,90988
1985-08-01,California,19708000,12978993,12041877,937116
1985-08-01,Colorado,2390000,1709019,1605467,103552
1985-08-01,Connecticut,2472000,1701993,1626987,75006
1985-08-01,Delaware,473000,318431,302722,15709
1985-08-01,Florida,8943000,5345064,5022728,322336
1985-08-01,Georgia,4377000,2881404,2696892,184512
1985-08-01,Hawaii,732000,482911,457054,25857
1985-08-01,Idaho,700000,466118,429443,36675
1985-08-01,Illinois,8637000,5650549,5125848,524701
1985-08-01,Indiana,4093000,2704520,2498791,205729
1985-08-01,Iowa,2147000,1423017,1317132,105885
1985-08-01,Kansas,1792000,1229622,1166317,63305
1985-08-01,Kentucky,2747000,1696241,1540680,155561
1985-08-01,Louisiana,3200000,1971530,1743727,227803
1985-08-01,Maine,876000,552799,522636,30163
1985-08-01,Maryland,3346000,2278040,2175079,102961
1985-08-01,Massachusetts,4536000,3047172,2920547,126625
1985-08-01,Michigan,6800000,4361494,3922680,438814
1985-08-01,Minnesota,3123000,2238574,2101629,136945
1985-08-01,Mississippi,1869000,1125261,1007999,117262
1985-08-01,Missouri,3779000,2442244,2281947,160297
1985-08-01,Montana,604000,403529,372646,30883
1985-08-01,Nebraska,1171000,804859,763132,41727
1985-08-01,Nevada,726000,517570,478946,38624
1985-08-01,Ohio,8080000,5141580,4674457,467123
1985-08-01,Oklahoma,2402000,1553826,1445137,108689
1985-08-01,Oregon,2026000,1322925,1211428,111497
1985-08-01,Pennsylvania,9203000,5548859,5107164,441695
1985-08-01,Tennessee,3604000,2250388,2073028,177360
1985-08-01,Texas,11781000,8091972,7505810,586162
1985-08-01,Utah,1064000,735764,691310,44454
1985-08-01,Vermont,402000,280372,267282,13090
1985-08-01,Virginia,4220000,2865556,2707910,157646
1985-08-01,Washington,3261000,2110251,1939370,170881
1985-08-01,Wisconsin,3575000,2392320,2221693,170627
1985-08-01,Wyoming,357000,253626,235171,18455
1985-09-01,Alabama,2975000,1806241,1639287,166954
1985-09-01,Alaska,345000,250166,225510,24656
1985-09-01,Arizona,2370000,1499970,1401162,98808
1985-09-01,Arkansas,1750000,1058809,968138,90671
1985-09-01,California,19742000,13007219,12079990,927229
1985-09-01,Colorado,2392000,1707698,1603572,104126
1985-09-01,Connecticut,2474000,1707297,1633926,73371
1985-09-01,Delaware,473000,319124,303942,15182
1985-09-01,Florida,8964000,5360345,5041856,318489
1985-09-01,Georgia,4383000,2888696,2708414,180282
1985-09-01,Hawaii,733000,484585,458851,25734
1985-09-01,Idaho,701000,466437,429749,36688
1985-09-01,Illinois,8641000,5656711,5134715,521996
1985-09-01,Indiana,4096000,2707022,2506227,200795
1985-09-01,Iowa,2146000,1425015,1319409,105606
1985-09-01,Kansas,1795000,1231606,1167761,63845
1985-09-01,Kentucky,2749000,1697857,1541185,156672
1985-09-01,Louisiana,3203000,1974708,1746127,228581
1985-09-01,Maine,876000,554232,524239,29993
1985-09-01,Maryland,3351000,2282297,2181145,101152
1985-09-01,Massachusetts,4538000,3049414,2924167,125247
1985-09-01,Michigan,6806000,4366112,3936606,429506
1985-09-01,Minnesota,3127000,2243355,2105948,137407
1985-09-01,Mississippi,1869000,1128388,1010639,117749
1985-09-01,Missouri,3783000,2448742,2290249,158493
1985-09-01,Montana,603000,403624,372563,31061
1985-09-01,Nebraska,1172000,806532,764676,41856
1985-09-01,Nevada,727000,518707,480619,38088
1985-09-01,Ohio,8081000,5153659,4687505,466154
1985-09-01,Oklahoma,2404000,1557715,1448762,108953
1985-09-01,Oregon,2029000,1326237,1216268,109969
1985-09-01,Pennsylvania,9207000,5559219,5123010,436209
1985-09-01,Tennessee,3606000,2253167,2077270,175897
1985-09-01,Texas,11798000,8102385,7513079,589306
1985-09-01,Utah,1066000,737721,693788,43933
1985-09-01,Vermont,403000,281441,268537,12904
1985-09-01,Virginia,4228000,2868726,2713488,155238
1985-09-01,Washington,3267000,2114279,1945500,168779
1985-09-01,Wisconsin,3576000,2395636,2225324,170312
1985-09-01,Wyoming,358000,253478,234880,18598
1985-10-01,Alabama,2978000,1811150,1644727,166423
1985-10-01,Alaska,345000,251000,226269,24731
1985-10-01,Arizona,2375000,1507199,1409642,97557
1985-10-01,Arkansas,1751000,1059385,969190,90195
1985-10-01,California,19775000,13037902,12121770,916132
1985-10-01,Colorado,2395000,1706529,1601853,104676
1985-10-01,Connecticut,2475000,1712693,1641133,71560
1985-10-01,Delaware,474000,319540,304823,14717
1985-10-01,Florida,8985000,5378200,5062884,315316
1985-10-01,Georgia,4390000,2896140,2719942,176198
1985-10-01,Hawaii,734000,486172,460693,25479
1985-10-01,Idaho,701000,467012,430103,36909
1985-10-01,Illinois,8645000,5664471,5147179,517292
1985-10-01,Indiana,4098000,2711061,2515420,195641
1985-10-01,Iowa,2146000,1427818,1322680,105138
1985-10-01,Kansas,1797000,1233757,1169390,64367
1985-10-01,Kentucky,2750000,1699246,1541854,157392
1985-10-01,Louisiana,3205000,1978025,1748665,229360
1985-10-01,Maine,877000,556136,526232,29904
1985-10-01,Maryland,3355000,2286928,2187201,99727
1985-10-01,Massachusetts,4541000,3053235,2929544,123691
1985-10-01,Michigan,6811000,4368239,3950116,418123
1985-10-01,Minnesota,3131000,2246841,2109431,137410
1985-10-01,Mississippi,1869000,1131728,1013398,118330
1985-10-01,Missouri,3787000,2455523,2298683,156840
1985-10-01,Montana,603000,403963,372632,31331
1985-10-01,Nebraska,1172000,808448,766459,41989
1985-10-01,Nevada,727000,519937,482421,37516
1985-10-01,Ohio,8083000,5166697,4704518,462179
1985-10-01,Oklahoma,2406000,1561850,1452298,109552
1985-10-01,Oregon,2032000,1330716,1221448,109268
1985-10-01,Pennsylvania,9210000,5571154,5140330,430824
1985-10-01,Tennessee,3608000,2258442,2083180,175262
1985-10-01,Texas,11814000,8112668,7521052,591616
1985-10-01,Utah,1067000,739569,696200,43369
1985-10-01,Vermont,403000,282445,269794,12651
1985-10-01,Virginia,4235000,2872203,2719763,152440
1985-10-01,Washington,3274000,2119266,1952451,166815
1985-10-01,Wisconsin,3578000,2399474,2229629,169845
1985-10-01,Wyoming,358000,253315,234654,18661
1985-11-01,Alabama,2981000,1816377,1649453,166924
1985-11-01,Alaska,346000,251869,226868,25001
1985-11-01,Arizona,2381000,1514690,1418064,96626
1985-11-01,Arkansas,1753000,1060090,970202,89888
1985-11-01,California,19808000,13067807,12161186,906621
1985-11-01,Colorado,2397000,1705400,1599656,105744
1985-11-01,Connecticut,2477000,1717012,1647139,69873
1985-11-01,Delaware,475000,319724,305321,14403
1985-11-01,Florida,9006000,5397134,5083644,313490
1985-11-01,Georgia,4397000,2903347,2730228,173119
1985-11-01,Hawaii,736000,487551,462307,25244
1985-11-01,Idaho,702000,467647,430418,37229
1985-11-01,Illinois,8649000,5671201,5159319,511882
1985-11-01,Indiana,4101000,2715770,2524235,191535
1985-11-01,Iowa,2145000,1430763,1326155,104608
1985-11-01,Kansas,1799000,1235458,1170648,64810
1985-11-01,Kentucky,2751000,1699826,1541832,157994
1985-11-01,Louisiana,3208000,1980494,1750068,230426
1985-11-01,Maine,878000,558028,528171,29857
1985-11-01,Maryland,3359000,2291848,2192706,99142
1985-11-01,Massachusetts,4544000,3057421,2935069,122352
1985-11-01,Michigan,6816000,4367207,3960356,406851
1985-11-01,Minnesota,3135000,2248216,2111153,137063
1985-11-01,Mississippi,1868000,1134673,1015526,119147
1985-11-01,Missouri,3791000,2461491,2306079,155412
1985-11-01,Montana,603000,404377,372764,31613
1985-11-01,Nebraska,1173000,810200,768062,42138
1985-11-01,Nevada,728000,521086,484165,36921
1985-11-01,Ohio,8085000,5178174,4722387,455787
1985-11-01,Oklahoma,2409000,1565472,1454660,110812
1985-11-01,Oregon,2035000,1335342,1225753,109589
1985-11-01,Pennsylvania,9214000,5583450,5156742,426708
1985-11-01,Tennessee,3610000,2264730,2088842,175888
1985-11-01,Texas,11831000,8122447,7526209,596238
1985-11-01,Utah,1068000,741131,698242,42889
1985-11-01,Vermont,404000,283333,270921,12412
1985-11-01,Virginia,4243000,2875067,2725344,149723
1985-11-01,Washington,3280000,2125529,1959762,165767
1985-11-01,Wisconsin,3579000,2402795,2233656,169139
1985-11-01,Wyoming,358000,253209,234396,18813
1985-12-01,Alabama,2983000,1821688,1653092,168596
1985-12-01,Alaska,347000,252806,227281,25525
1985-12-01,Arizona,2387000,1522245,1425711,96534
1985-12-01,Arkansas,1754000,1061022,971101,89921
1985-12-01,California,19841000,13095486,12194718,900768
1985-12-01,Colorado,2400000,1704095,1596191,107904
1985-12-01,Connecticut,2478000,1719637,1651096,68541
1985-12-01,Delaware,475000,319816,305508,14308
1985-12-01,Florida,9027000,5416113,5102742,313371
1985-12-01,Georgia,4403000,2910482,2738976,171506
1985-12-01,Hawaii,737000,488532,463447,25085
1985-12-01,Idaho,703000,468137,430594,37543
1985-12-01,Illinois,8653000,5674821,5168785,506036
1985-12-01,Indiana,4103000,2719883,2530553,189330
1985-12-01,Iowa,2144000,1433173,1329094,104079
1985-12-01,Kansas,1802000,1236565,1171311,65254
1985-12-01,Kentucky,2752000,1699710,1541181,158529
1985-12-01,Louisiana,3210000,1981526,1749426,232100
1985-12-01,Maine,878000,559458,529610,29848
1985-12-01,Maryland,3363000,2297233,2197848,99385
1985-12-01,Massachusetts,4546000,3060739,2939164,121575
1985-12-01,Michigan,6821000,4364644,3966288,398356
1985-12-01,Minnesota,3139000,2247541,2111102,136439
1985-12-01,Mississippi,1868000,1137029,1016501,120528
1985-12-01,Missouri,3795000,2466060,2311800,154260
1985-12-01,Montana,602000,404636,372792,31844
1985-12-01,Nebraska,1174000,811491,769250,42241
1985-12-01,Nevada,729000,522057,485763,36294
1985-12-01,Ohio,8086000,5186491,4737881,448610
1985-12-01,Oklahoma,2411000,1568462,1455335,113127
1985-12-01,Oregon,2038000,1339591,1228690,110901
1985-12-01,Pennsylvania,9218000,5595300,5171186,424114
1985-12-01,Tennessee,3612000,2270533,2093034,177499
1985-12-01,Texas,11847000,8133399,7527321,606078
1985-12-01,Utah,1069000,742345,699746,42599
1985-12-01,Vermont,404000,284040,271779,12261
1985-12-01,Virginia,4250000,2877085,2729635,147450
1985-12-01,Washington,3287000,2133031,1967016,166015
1985-12-01,Wisconsin,3581000,2405055,2236587,168468
1985-12-01,Wyoming,358000,253166,234007,19159
1986-01-01,Alabama,2986000,1827550,1656221,171329
1986-01-01,Alaska,348000,253761,227481,26280
1986-01-01,Arizona,2393000,1530252,1432668,97584
1986-01-01,Arkansas,1755000,1062220,971894,90326
1986-01-01,California,19875000,13123458,12223689,899769
1986-01-01,Colorado,2402000,1702618,1591492,111126
1986-01-01,Connecticut,2479000,1720985,1653314,67671
1986-01-01,Delaware,476000,320083,305624,14459
1986-01-01,Florida,9048000,5436192,5120980,315212
1986-01-01,Georgia,4410000,2918617,2747072,171545
1986-01-01,Hawaii,738000,489068,464079,24989
1986-01-01,Idaho,704000,468603,430702,37901
1986-01-01,Illinois,8657000,5676186,5175608,500578
1986-01-01,Indiana,4105000,2723029,2533914,189115
1986-01-01,Iowa,2143000,1435094,1331436,103658
1986-01-01,Kansas,1804000,1237401,1171577,65824
1986-01-01,Kentucky,2754000,1699804,1540860,158944
1986-01-01,Louisiana,3212000,1981243,1746590,234653
1986-01-01,Maine,879000,560319,530439,29880
1986-01-01,Maryland,3368000,2303710,2203345,100365
1986-01-01,Massachusetts,4549000,3062352,2940817,121535
1986-01-01,Michigan,6827000,4363463,3968780,394683
1986-01-01,Minnesota,3142000,2245812,2110084,135728
1986-01-01,Mississippi,1868000,1139396,1016621,122775
1986-01-01,Missouri,3799000,2469921,2316094,153827
1986-01-01,Montana,602000,404712,372654,32058
1986-01-01,Nebraska,1175000,812267,770099,42168
1986-01-01,Nevada,730000,522929,487278,35651
1986-01-01,Ohio,8088000,5192444,4749480,442964
1986-01-01,Oklahoma,2413000,1571401,1454673,116728
1986-01-01,Oregon,2040000,1343638,1230720,112918
1986-01-01,Pennsylvania,9222000,5606682,5183928,422754
1986-01-01,Tennessee,3614000,2275368,2095639,179729
1986-01-01,Texas,11863000,8148538,7525466,623072
1986-01-01,Utah,1071000,743409,700792,42617
1986-01-01,Vermont,404000,284621,272386,12235
1986-01-01,Virginia,4257000,2879271,2733243,146028
1986-01-01,Washington,3293000,2141638,1974069,167569
1986-01-01,Wisconsin,3582000,2406828,2238584,168244
1986-01-01,Wyoming,359000,253143,233457,19686
1986-02-01,Alabama,2989000,1834254,1659603,174651
1986-02-01,Alaska,348000,254666,227520,27146
1986-02-01,Arizona,2399000,1539165,1439501,99664
1986-02-01,Arkansas,1756000,1063682,972755,90927
1986-02-01,California,19908000,13155800,12252758,903042
1986-02-01,Colorado,2405000,1701643,1586711,114932
1986-02-01,Connecticut,2481000,1722326,1655105,67221
1986-02-01,Delaware,477000,320695,305912,14783
1986-02-01,Florida,9070000,5459024,5140574,318450
1986-02-01,Georgia,4417000,2928766,2755808,172958
1986-02-01,Hawaii,739000,489378,464485,24893
1986-02-01,Idaho,704000,469251,430998,38253
1986-02-01,Illinois,8662000,5678217,5182025,496192
1986-02-01,Indiana,4108000,2725812,2535692,190120
1986-02-01,Iowa,2142000,1436818,1333521,103297
1986-02-01,Kansas,1806000,1238546,1171953,66593
1986-02-01,Kentucky,2755000,1700858,1541704,159154
1986-02-01,Louisiana,3215000,1980013,1742168,237845
1986-02-01,Maine,880000,560954,531025,29929
1986-02-01,Maryland,3372000,2311807,2210017,101790
1986-02-01,Massachusetts,4552000,3062660,2940505,122155
1986-02-01,Michigan,6832000,4366114,3970258,395856
1986-02-01,Minnesota,3146000,2244534,2109682,134852
1986-02-01,Mississippi,1868000,1142252,1016551,125701
1986-02-01,Missouri,3804000,2474409,2319854,154555
1986-02-01,Montana,602000,404708,372445,32263
1986-02-01,Nebraska,1176000,812618,770751,41867
1986-02-01,Nevada,731000,523921,488911,35010
1986-02-01,Ohio,8090000,5198075,4758310,439765
1986-02-01,Oklahoma,2415000,1574696,1453562,121134
1986-02-01,Oregon,2043000,1347823,1232946,114877
1986-02-01,Pennsylvania,9225000,5617046,5195522,421524
1986-02-01,Tennessee,3616000,2279169,2097093,182076
1986-02-01,Texas,11880000,8146129,7499770,646359
1986-02-01,Utah,1072000,744617,701675,42942
1986-02-01,Vermont,405000,285202,272897,12305
1986-02-01,Virginia,4265000,2882738,2737387,145351
1986-02-01,Washington,3300000,2151223,1981001,170222
1986-02-01,Wisconsin,3584000,2409087,2240641,168446
1986-02-01,Wyoming,359000,253209,232844,20365
1986-03-01,Alabama,2991000,1841290,1663497,177793
1986-03-01,Alaska,349000,255467,227485,27982
1986-03-01,Arizona,2405000,1548653,1446251,102402
1986-03-01,Arkansas,1757000,1065362,973945,91417
1986-03-01,California,19941000,13193983,12285798,908185
1986-03-01,Colorado,2408000,1701376,1582893,118483
1986-03-01,Connecticut,2482000,1724516,1657525,66991
1986-03-01,Delaware,477000,321617,306511,15106
1986-03-01,Florida,9091000,5484778,5162788,321990
1986-03-01,Georgia,4423000,2940949,2765913,175036
1986-03-01,Hawaii,740000,489744,465008,24736
1986-03-01,Idaho,705000,470173,431561,38612
1986-03-01,Illinois,8666000,5682224,5189537,492687
1986-03-01,Indiana,4110000,2728734,2537549,191185
1986-03-01,Iowa,2141000,1438616,1335691,102925
1986-03-01,Kansas,1809000,1240243,1172825,67418
1986-03-01,Kentucky,2756000,1702765,1543687,159078
1986-03-01,Louisiana,3217000,1977717,1736808,240909
1986-03-01,Maine,880000,561740,531755,29985
1986-03-01,Maryland,3376000,2321223,2217983,103240
1986-03-01,Massachusetts,4554000,3062538,2939444,123094
1986-03-01,Michigan,6837000,4372617,3973042,399575
1986-03-01,Minnesota,3150000,2244531,2111051,133480
1986-03-01,Mississippi,1868000,1145478,1016640,128838
1986-03-01,Missouri,3808000,2480265,2323980,156285
1986-03-01,Montana,601000,404611,372194,32417
1986-03-01,Nebraska,1177000,812619,771294,41325
1986-03-01,Nevada,732000,525255,490811,34444
1986-03-01,Ohio,8091000,5204326,4765709,438617
1986-03-01,Oklahoma,2417000,1578485,1452460,126025
1986-03-01,Oregon,2046000,1352345,1236120,116225
1986-03-01,Pennsylvania,9229000,5625676,5206623,419053
1986-03-01,Tennessee,3618000,2282350,2098663,183687
1986-03-01,Texas,11896000,8149366,7477271,672095
1986-03-01,Utah,1073000,746155,702652,43503
1986-03-01,Vermont,405000,285859,273450,12409
1986-03-01,Virginia,4272000,2887863,2742970,144893
1986-03-01,Washington,3307000,2161150,1987627,173523
1986-03-01,Wisconsin,3585000,2412375,2243604,168771
1986-03-01,Wyoming,359000,253318,232263,21055
1986-04-01,Alabama,2994000,1848011,1667939,180072
1986-04-01,Alaska,350000,256048,227376,28672
1986-04-01,Arizona,2410000,1557573,1452045,105528
1986-04-01,Arkansas,1758000,1067254,975610,91644
1986-04-01,California,19974000,13237362,12324785,912577
1986-04-01,Colorado,2410000,1701308,1579947,121361
1986-04-01,Connecticut,2484000,1727693,1660905,66788
1986-04-01,Delaware,478000,322724,307482,15242
1986-04-01,Florida,9112000,5512436,5187490,324946
1986-04-01,Georgia,4430000,2954307,2777338,176969
1986-04-01,Hawaii,741000,490378,465909,24469
1986-04-01,Idaho,706000,471376,432305,39071
1986-04-01,Illinois,8670000,5688350,5198587,489763
1986-04-01,Indiana,4113000,2732050,2540648,191402
1986-04-01,Iowa,2141000,1440380,1337915,102465
1986-04-01,Kansas,1811000,1242600,1174454,68146
1986-04-01,Kentucky,2757000,1705155,1546450,158705
1986-04-01,Louisiana,3220000,1974811,1731206,243605
1986-04-01,Maine,881000,562842,532768,30074
1986-04-01,Maryland,3380000,2331297,2226776,104521
1986-04-01,Massachusetts,4557000,3062699,2938660,124039
1986-04-01,Michigan,6842000,4381089,3978131,402958
1986-04-01,Minnesota,3154000,2246242,2114675,131567
1986-04-01,Mississippi,1868000,1148830,1017161,131669
1986-04-01,Missouri,3812000,2487632,2329115,158517
1986-04-01,Montana,601000,404390,371900,32490
1986-04-01,Nebraska,1177000,812466,771888,40578
1986-04-01,Nevada,732000,526988,492980,34008
1986-04-01,Ohio,8093000,5211093,4772079,439014
1986-04-01,Oklahoma,2419000,1582486,1451414,131072
1986-04-01,Oregon,2049000,1357222,1240543,116679
1986-04-01,Pennsylvania,9233000,5632515,5217700,414815
1986-04-01,Tennessee,3620000,2285637,2101474,184163
1986-04-01,Texas,11913000,8156094,7459814,696280
1986-04-01,Utah,1074000,747997,703770,44227
1986-04-01,Vermont,406000,286604,274107,12497
1986-04-01,Virginia,4280000,2894740,2750217,144523
1986-04-01,Washington,3313000,2170478,1993784,176694
1986-04-01,Wisconsin,3587000,2416778,2247870,168908
1986-04-01,Wyoming,359000,253302,231712,21590
1986-05-01,Alabama,2997000,1853587,1672576,181011
1986-05-01,Alaska,351000,256261,227139,29122
1986-05-01,Arizona,2416000,1565157,1456592,108565
1986-05-01,Arkansas,1760000,1069348,977788,91560
1986-05-01,California,20008000,13282235,12368747,913488
1986-05-01,Colorado,2413000,1701372,1577561,123811
1986-05-01,Connecticut,2485000,1731302,1664882,66420
1986-05-01,Delaware,479000,323779,308699,15080
1986-05-01,Florida,9133000,5540669,5213854,326815
1986-05-01,Georgia,4437000,2967500,2789394,178106
1986-05-01,Hawaii,743000,491253,467198,24055
1986-05-01,Idaho,707000,472614,433045,39569
1986-05-01,Illinois,8674000,5694922,5208839,486083
1986-05-01,Indiana,4115000,2735893,2545575,190318
1986-05-01,Iowa,2140000,1441741,1340189,101552
1986-05-01,Kansas,1813000,1245346,1176768,68578
1986-05-01,Kentucky,2759000,1707421,1549369,158052
1986-05-01,Louisiana,3222000,1972024,1726161,245863
1986-05-01,Maine,882000,564135,533973,30162
1986-05-01,Maryland,3385000,2341159,2235590,105569
1986-05-01,Massachusetts,4560000,3063493,2938850,124643
1986-05-01,Michigan,6848000,4389314,3985764,403550
1986-05-01,Minnesota,3158000,2249317,2120331,128986
1986-05-01,Mississippi,1867000,1151865,1018241,133624
1986-05-01,Missouri,3816000,2495969,2335228,160741
1986-05-01,Montana,601000,404120,371688,32432
1986-05-01,Nebraska,1178000,812332,772613,39719
1986-05-01,Nevada,733000,529017,495347,33670
1986-05-01,Ohio,8095000,5217189,4777575,439614
1986-05-01,Oklahoma,2422000,1585696,1450284,135412
1986-05-01,Oregon,2052000,1362101,1246173,115928
1986-05-01,Pennsylvania,9237000,5636390,5227981,408409
1986-05-01,Tennessee,3622000,2289145,2105473,183672
1986-05-01,Texas,11929000,8163166,7447615,715551
1986-05-01,Utah,1076000,749970,704974,44996
1986-05-01,Vermont,406000,287377,274842,12535
1986-05-01,Virginia,4287000,2902921,2758688,144233
1986-05-01,Washington,3320000,2178547,1999569,178978
1986-05-01,Wisconsin,3588000,2421933,2253425,168508
1986-05-01,Wyoming,360000,253027,231131,21896
1986-06-01,Alabama,2999000,1857645,1676854,180791
1986-06-01,Alaska,351000,256093,226811,29282
1986-06-01,Arizona,2422000,1571723,1460384,111339
1986-06-01,Arkansas,1761000,1071771,980382,91389
1986-06-01,California,20041000,13326888,12416031,910857
1986-06-01,Colorado,2415000,1702079,1575844,126235
1986-06-01,Connecticut,2487000,1734737,1668887,65850
1986-06-01,Delaware,479000,324592,309979,14613
1986-06-01,Florida,9154000,5569000,5240958,328042
1986-06-01,Georgia,4443000,2979890,2801437,178453
1986-06-01,Hawaii,744000,492244,468743,23501
1986-06-01,Idaho,707000,473689,433620,40069
1986-06-01,Illinois,8678000,5700154,5219387,480767
1986-06-01,Indiana,4118000,2740343,2552163,188180
1986-06-01,Iowa,2139000,1442748,1342761,99987
1986-06-01,Kansas,1816000,1248265,1179671,68594
1986-06-01,Kentucky,2760000,1709128,1551697,157431
1986-06-01,Louisiana,3225000,1970384,1722449,247935
1986-06-01,Maine,882000,565466,535228,30238
1986-06-01,Maryland,3389000,2350416,2243861,106555
1986-06-01,Massachusetts,4562000,3065119,2940343,124776
1986-06-01,Michigan,6853000,4396624,3995725,400899
1986-06-01,Minnesota,3162000,2253188,2127079,126109
1986-06-01,Mississippi,1867000,1154327,1019711,134616
1986-06-01,Missouri,3820000,2504629,2342035,162594
1986-06-01,Montana,600000,403929,371636,32293
1986-06-01,Nebraska,1179000,812440,773501,38939
1986-06-01,Nevada,734000,531263,497844,33419
1986-06-01,Ohio,8096000,5222188,4782921,439267
1986-06-01,Oklahoma,2424000,1587690,1449329,138361
1986-06-01,Oregon,2055000,1366412,1252366,114046
1986-06-01,Pennsylvania,9240000,5637256,5236869,400387
1986-06-01,Tennessee,3624000,2292909,2110061,182848
1986-06-01,Texas,11946000,8168629,7439417,729212
1986-06-01,Utah,1077000,752000,706204,45796
1986-06-01,Vermont,407000,288165,275633,12532
1986-06-01,Virginia,4295000,2912178,2767959,144219
1986-06-01,Washington,3326000,2185350,2005137,180213
1986-06-01,Wisconsin,3590000,2427447,2260035,167412
1986-06-01,Wyoming,360000,252482,230469,22013
1986-07-01,Alabama,3002000,1860219,1680422,179797
1986-07-01,Alaska,352000,255677,226498,29179
1986-07-01,Arizona,2428000,1577344,1463627,113717
1986-07-01,Arkansas,1762000,1074453,983087,91366
1986-07-01,California,20074000,13370510,12464295,906215
1986-07-01,Colorado,2418000,1703536,1574491,129045
1986-07-01,Connecticut,2488000,1737642,1672531,65111
1986-07-01,Delaware,480000,325177,311240,13937
1986-07-01,Florida,9175000,5597129,5268334,328795
1986-07-01,Georgia,4450000,2991212,2813045,178167
1986-07-01,Hawaii,745000,493302,470425,22877
1986-07-01,Idaho,708000,474379,433916,40463
1986-07-01,Illinois,8682000,5703187,5229465,473722
1986-07-01,Indiana,4120000,2745145,2559707,185438
1986-07-01,Iowa,2138000,1443717,1345778,97939
1986-07-01,Kansas,1818000,1251185,1183095,68090
1986-07-01,Kentucky,2761000,1709742,1552718,157024
1986-07-01,Louisiana,3227000,1970313,1720383,249930
1986-07-01,Maine,883000,566761,536463,30298
1986-07-01,Maryland,3393000,2359062,2251336,107726
1986-07-01,Massachusetts,4565000,3067561,2943206,124355
1986-07-01,Michigan,6858000,4403400,4007337,396063
1986-07-01,Minnesota,3166000,2256687,2133377,123310
1986-07-01,Mississippi,1867000,1155859,1021187,134672
1986-07-01,Missouri,3824000,2512751,2349197,163554
1986-07-01,Montana,600000,403874,371730,32144
1986-07-01,Nebraska,1180000,812943,774589,38354
1986-07-01,Nevada,735000,533549,500330,33219
1986-07-01,Ohio,8098000,5226195,4788847,437348
1986-07-01,Oklahoma,2426000,1588370,1448803,139567
1986-07-01,Oregon,2058000,1369430,1258316,111114
1986-07-01,Pennsylvania,9244000,5635466,5243779,391687
1986-07-01,Tennessee,3626000,2296564,2114351,182213
1986-07-01,Texas,11962000,8172001,7433205,738796
1986-07-01,Utah,1078000,753913,707292,46621
1986-07-01,Vermont,407000,288962,276448,12514
1986-07-01,Virginia,4302000,2922022,2777606,144416
1986-07-01,Washington,3333000,2191190,2010646,180544
1986-07-01,Wisconsin,3591000,2433136,2267505,165631
1986-07-01,Wyoming,360000,251716,229712,22004
1986-08-01,Alabama,3005000,1861412,1682856,178556
1986-08-01,Alaska,351000,255116,226191,28925
1986-08-01,Arizona,2436000,1581947,1466267,115680
1986-08-01,Arkansas,1763000,1077020,985371,91649
1986-08-01,California,20113000,13410882,12509310,901572
1986-08-01,Colorado,2420000,1705656,1573252,132404
1986-08-01,Connecticut,2490000,1739809,1675458,64351
1986-08-01,Delaware,481000,325664,312477,13187
1986-08-01,Florida,9197000,5623662,5294474,329188
1986-08-01,Georgia,4459000,3000847,2823316,177531
1986-08-01,Hawaii,747000,494377,472113,22264
1986-08-01,Idaho,708000,474568,433933,40635
1986-08-01,Illinois,8687000,5703859,5237735,466124
1986-08-01,Indiana,4123000,2749647,2566589,183058
1986-08-01,Iowa,2138000,1444598,1348788,95810
1986-08-01,Kansas,1819000,1253979,1186676,67303
1986-08-01,Kentucky,2762000,1709125,1552161,156964
1986-08-01,Louisiana,3224000,1971197,1719444,251753
1986-08-01,Maine,884000,567896,537590,30306
1986-08-01,Maryland,3398000,2366873,2257729,109144
1986-08-01,Massachusetts,4567000,3070162,2946628,123534
1986-08-01,Michigan,6865000,4410616,4020004,390612
1986-08-01,Minnesota,3169000,2258906,2137987,120919
1986-08-01,Mississippi,1868000,1156184,1022073,134111
1986-08-01,Missouri,3828000,2519658,2356054,163604
1986-08-01,Montana,600000,403933,371894,32039
1986-08-01,Nebraska,1180000,813736,775758,37978
1986-08-01,Nevada,738000,535747,502654,33093
1986-08-01,Ohio,8104000,5229833,4795482,434351
1986-08-01,Oklahoma,2424000,1587465,1448411,139054
1986-08-01,Oregon,2060000,1371134,1263596,107538
1986-08-01,Pennsylvania,9249000,5631113,5247871,383242
1986-08-01,Tennessee,3631000,2299457,2117534,181923
1986-08-01,Texas,11967000,8185040,7438263,746777
1986-08-01,Utah,1079000,755508,708051,47457
1986-08-01,Vermont,408000,289728,277209,12519
1986-08-01,Virginia,4310000,2931754,2787028,144726
1986-08-01,Washington,3339000,2196579,2016198,180381
1986-08-01,Wisconsin,3593000,2439012,2275479,163533
1986-08-01,Wyoming,359000,250843,228870,21973
1986-09-01,Alabama,3008000,1861591,1684084,177507
1986-09-01,Alaska,351000,254500,225880,28620
1986-09-01,Arizona,2443000,1585503,1468182,117321
1986-09-01,Arkansas,1765000,1079062,986946,92116
1986-09-01,California,20153000,13446724,12548948,897776
1986-09-01,Colorado,2422000,1707802,1571972,135830
1986-09-01,Connecticut,2491000,1741278,1677550,63728
1986-09-01,Delaware,482000,326198,313742,12456
1986-09-01,Florida,9219000,5647986,5318670,329316
1986-09-01,Georgia,4469000,3008738,2831891,176847
1986-09-01,Hawaii,748000,495397,473704,21693
1986-09-01,Idaho,709000,474338,433790,40548
1986-09-01,Illinois,8693000,5702810,5243864,458946
1986-09-01,Indiana,4127000,2752774,2570871,181903
1986-09-01,Iowa,2138000,1445459,1351655,93804
1986-09-01,Kansas,1820000,1256583,1189994,66589
1986-09-01,Kentucky,2763000,1707556,1550435,157121
1986-09-01,Louisiana,3222000,1972110,1719053,253057
1986-09-01,Maine,886000,568811,538580,30231
1986-09-01,Maryland,3403000,2373744,2263242,110502
1986-09-01,Massachusetts,4569000,3072271,2949750,122521
1986-09-01,Michigan,6872000,4419168,4033613,385555
1986-09-01,Minnesota,3171000,2260128,2140855,119273
1986-09-01,Mississippi,1869000,1155466,1022008,133458
1986-09-01,Missouri,3832000,2525171,2362055,163116
1986-09-01,Montana,600000,404073,372035,32038
1986-09-01,Nebraska,1180000,814637,776854,37783
1986-09-01,Nevada,740000,537861,504720,33141
1986-09-01,Ohio,8109000,5233942,4802813,431129
1986-09-01,Oklahoma,2422000,1584994,1447837,137157
1986-09-01,Oregon,2062000,1371981,1268437,103544
1986-09-01,Pennsylvania,9254000,5625144,5249840,375304
1986-09-01,Tennessee,3636000,2301500,2120013,181487
1986-09-01,Texas,11972000,8173170,7419112,754058
1986-09-01,Utah,1080000,756682,708376,48306
1986-09-01,Vermont,408000,290419,277859,12560
1986-09-01,Virginia,4318000,2941090,2796181,144909
1986-09-01,Washington,3344000,2201973,2021881,180092
1986-09-01,Wisconsin,3596000,2445093,2283511,161582
1986-09-01,Wyoming,358000,249986,227970,22016
1986-10-01,Alabama,3011000,1861374,1684820,176554
1986-10-01,Alaska,350000,253889,225581,28308
1986-10-01,Arizona,2451000,1588207,1469810,118397
1986-10-01,Arkansas,1766000,1080195,987725,92470
1986-10-01,California,20192000,13477934,12584328,893606
1986-10-01,Colorado,2423000,1709525,1570664,138861
1986-10-01,Connecticut,2493000,1742137,1678928,63209
1986-10-01,Delaware,483000,326865,315071,11794
1986-10-01,Florida,9242000,5670781,5341652,329129
1986-10-01,Georgia,4478000,3015428,2839195,176233
1986-10-01,Hawaii,750000,496410,475232,21178
1986-10-01,Idaho,709000,473803,433554,40249
1986-10-01,Illinois,8698000,5700687,5248416,452271
1986-10-01,Indiana,4130000,2753410,2571678,181732
1986-10-01,Iowa,2138000,1446917,1354962,91955
1986-10-01,Kansas,1822000,1258724,1192736,65988
1986-10-01,Kentucky,2765000,1705547,1548423,157124
1986-10-01,Louisiana,3219000,1972131,1718646,253485
1986-10-01,Maine,887000,569614,539588,30026
1986-10-01,Maryland,3408000,2379619,2268339,111280
1986-10-01,Massachusetts,4571000,3073505,2952186,121319
1986-10-01,Michigan,6878000,4429579,4048176,381403
1986-10-01,Minnesota,3174000,2261184,2142636,118548
1986-10-01,Mississippi,1870000,1154312,1021434,132878
1986-10-01,Missouri,3836000,2529333,2366905,162428
1986-10-01,Montana,599000,404218,372147,32071
1986-10-01,Nebraska,1180000,815445,777753,37692
1986-10-01,Nevada,743000,539910,506563,33347
1986-10-01,Ohio,8115000,5238855,4810820,428035
1986-10-01,Oklahoma,2419000,1581289,1447021,134268
1986-10-01,Oregon,2065000,1372548,1273231,99317
1986-10-01,Pennsylvania,9258000,5617941,5250581,367360
1986-10-01,Tennessee,3641000,2303288,2123029,180259
1986-10-01,Texas,11977000,8194607,7435506,759101
1986-10-01,Utah,1080000,757454,708360,49094
1986-10-01,Vermont,409000,291003,278393,12610
1986-10-01,Virginia,4327000,2949962,2805256,144706
1986-10-01,Washington,3350000,2207628,2027880,179748
1986-10-01,Wisconsin,3598000,2451364,2291278,160086
1986-10-01,Wyoming,357000,249294,227084,22210
1986-11-01,Alabama,3014000,1861124,1685756,175368
1986-11-01,Alaska,349000,253222,225220,28002
1986-11-01,Arizona,2458000,1590292,1471560,118732
1986-11-01,Arkansas,1768000,1080342,987769,92573
1986-11-01,California,20232000,13505030,12616408,888622
1986-11-01,Colorado,2425000,1710463,1569234,141229
1986-11-01,Connecticut,2494000,1742699,1679923,62776
1986-11-01,Delaware,484000,327713,316457,11256
1986-11-01,Florida,9264000,5692402,5363721,328681
1986-11-01,Georgia,4487000,3020879,2845214,175665
1986-11-01,Hawaii,751000,497537,476811,20726
1986-11-01,Idaho,709000,473141,433222,39919
1986-11-01,Illinois,8703000,5698653,5251353,447300
1986-11-01,Indiana,4134000,2751534,2569567,181967
1986-11-01,Iowa,2138000,1449116,1358765,90351
1986-11-01,Kansas,1823000,1260168,1194564,65604
1986-11-01,Kentucky,2766000,1703716,1546933,156783
1986-11-01,Louisiana,3216000,1970571,1717624,252947
1986-11-01,Maine,888000,570484,540853,29631
1986-11-01,Maryland,3413000,2384242,2273041,111201
1986-11-01,Massachusetts,4573000,3073694,2953651,120043
1986-11-01,Michigan,6885000,4441220,4062611,378609
1986-11-01,Minnesota,3177000,2262824,2144175,118649
1986-11-01,Mississippi,1871000,1153136,1020919,132217
1986-11-01,Missouri,3839000,2532602,2370302,162300
1986-11-01,Montana,599000,404282,372197,32085
1986-11-01,Nebraska,1180000,815731,778222,37509
1986-11-01,Nevada,745000,541845,508201,33644
1986-11-01,Ohio,8120000,5243746,4818469,425277
1986-11-01,Oklahoma,2417000,1576768,1445816,130952
1986-11-01,Oregon,2067000,1373358,1277997,95361
1986-11-01,Pennsylvania,9263000,5609899,5250362,359537
1986-11-01,Tennessee,3646000,2305174,2126851,178323
1986-11-01,Texas,11982000,8211332,7450494,760838
1986-11-01,Utah,1081000,757864,708070,49794
1986-11-01,Vermont,409000,291451,278834,12617
1986-11-01,Virginia,4335000,2958059,2814007,144052
1986-11-01,Washington,3355000,2213403,2034052,179351
1986-11-01,Wisconsin,3600000,2457528,2298548,158980
1986-11-01,Wyoming,356000,248724,226245,22479
1986-12-01,Alabama,3017000,1861334,1687738,173596
1986-12-01,Alaska,349000,252450,224778,27672
1986-12-01,Arizona,2466000,1592429,1474252,118177
1986-12-01,Arkansas,1769000,1080184,987836,92348
1986-12-01,California,20271000,13532050,12650246,881804
1986-12-01,Colorado,2427000,1710878,1568275,142603
1986-12-01,Connecticut,2496000,1743584,1681268,62316
1986-12-01,Delaware,485000,328771,317902,10869
1986-12-01,Florida,9286000,5714434,5386564,327870
1986-12-01,Georgia,4496000,3025365,2850769,174596
1986-12-01,Hawaii,753000,499085,478712,20373
1986-12-01,Idaho,709000,472662,433041,39621
1986-12-01,Illinois,8708000,5699403,5254569,444834
1986-12-01,Indiana,4137000,2749087,2567166,181921
1986-12-01,Iowa,2138000,1452012,1363068,88944
1986-12-01,Kansas,1824000,1261022,1195707,65315
1986-12-01,Kentucky,2767000,1702696,1546755,155941
1986-12-01,Louisiana,3214000,1967640,1716444,251196
1986-12-01,Maine,889000,571727,542715,29012
1986-12-01,Maryland,3418000,2388058,2277780,110278
1986-12-01,Massachusetts,4575000,3073925,2955314,118611
1986-12-01,Michigan,6892000,4453597,4076733,376864
1986-12-01,Minnesota,3179000,2265802,2146632,119170
1986-12-01,Mississippi,1872000,1152245,1021120,131125
1986-12-01,Missouri,3843000,2536054,2372903,163151
1986-12-01,Montana,599000,404327,372337,31990
1986-12-01,Nebraska,1180000,815401,778286,37115
1986-12-01,Nevada,748000,543785,509792,33993
1986-12-01,Ohio,8126000,5248829,4826664,422165
1986-12-01,Oklahoma,2415000,1572339,1444751,127588
1986-12-01,Oregon,2069000,1374717,1282763,91954
1986-12-01,Pennsylvania,9268000,5603762,5251885,351877
1986-12-01,Tennessee,3651000,2307689,2131700,175989
1986-12-01,Texas,11987000,8223804,7465616,758188
1986-12-01,Utah,1082000,758124,707754,50370
1986-12-01,Vermont,410000,291855,279309,12546
1986-12-01,Virginia,4343000,2965781,2822754,143027
1986-12-01,Washington,3361000,2219475,2040756,178719
1986-12-01,Wisconsin,3602000,2463668,2305955,157713
1986-12-01,Wyoming,355000,248187,225536,22651
1987-01-01,Alabama,3021000,1861861,1690980,170881
1987-01-01,Alaska,348000,251717,224368,27349
1987-01-01,Arizona,2473000,1594908,1478208,116700
1987-01-01,Arkansas,1771000,1080414,988598,91816
1987-01-01,California,20311000,13560957,12689035,871922
1987-01-01,Colorado,2429000,1710894,1568030,142864
1987-01-01,Connecticut,2498000,1744756,1683097,61659
1987-01-01,Delaware,486000,329830,319225,10605
1987-01-01,Florida,9308000,5737103,5410799,326304
1987-01-01,Georgia,4506000,3028961,2856439,172522
1987-01-01,Hawaii,754000,501132,480983,20149
1987-01-01,Idaho,710000,472425,433154,39271
1987-01-01,Illinois,8714000,5704599,5259915,444684
1987-01-01,Indiana,4141000,2747720,2566452,181268
1987-01-01,Iowa,2138000,1454941,1367296,87645
1987-01-01,Kansas,1825000,1261457,1196573,64884
1987-01-01,Kentucky,2768000,1702452,1547920,154532
1987-01-01,Louisiana,3211000,1963911,1715624,248287
1987-01-01,Maine,891000,573470,545161,28309
1987-01-01,Maryland,3423000,2391172,2282500,108672
1987-01-01,Massachusetts,4577000,3075217,2958401,116816
1987-01-01,Michigan,6899000,4465828,4090017,375811
1987-01-01,Minnesota,3182000,2270111,2150333,119778
1987-01-01,Mississippi,1873000,1151570,1022265,129305
1987-01-01,Missouri,3847000,2539953,2375472,164481
1987-01-01,Montana,599000,404256,372541,31715
1987-01-01,Nebraska,1181000,814665,778069,36596
1987-01-01,Nevada,750000,545769,511445,34324
1987-01-01,Ohio,8132000,5253817,4835881,417936
1987-01-01,Oklahoma,2413000,1568422,1443991,124431
1987-01-01,Oregon,2071000,1376463,1287273,89190
1987-01-01,Pennsylvania,9273000,5601833,5257372,344461
1987-01-01,Tennessee,3656000,2311050,2137496,173554
1987-01-01,Texas,11992000,8232849,7482045,750804
1987-01-01,Utah,1083000,758297,707567,50730
1987-01-01,Vermont,410000,292245,279856,12389
1987-01-01,Virginia,4351000,2972774,2831285,141489
1987-01-01,Washington,3367000,2225660,2048163,177497
1987-01-01,Wisconsin,3605000,2469596,2313562,156034
1987-01-01,Wyoming,354000,247599,224979,22620
1987-02-01,Alabama,3024000,1862425,1695213,167212
1987-02-01,Alaska,347000,251062,224049,27013
1987-02-01,Arizona,2481000,1597440,1483020,114420
1987-02-01,Arkansas,1772000,1081362,990342,91020
1987-02-01,California,20350000,13590735,12732450,858285
1987-02-01,Colorado,2430000,1709720,1567759,141961
1987-02-01,Connecticut,2499000,1745618,1684916,60702
1987-02-01,Delaware,486000,330689,320258,10431
1987-02-01,Florida,9330000,5759958,5435926,324032
1987-02-01,Georgia,4515000,3031724,2862096,169628
1987-02-01,Hawaii,756000,503459,483458,20001
1987-02-01,Idaho,710000,472282,433450,38832
1987-02-01,Illinois,8719000,5713883,5268244,445639
1987-02-01,Indiana,4144000,2747454,2567384,180070
1987-02-01,Iowa,2137000,1457252,1370779,86473
1987-02-01,Kansas,1826000,1261601,1197370,64231
1987-02-01,Kentucky,2769000,1702600,1550126,152474
1987-02-01,Louisiana,3208000,1960071,1715560,244511
1987-02-01,Maine,892000,575437,547858,27579
1987-02-01,Maryland,3427000,2393311,2286530,106781
1987-02-01,Massachusetts,4578000,3077991,2963412,114579
1987-02-01,Michigan,6906000,4477002,4101173,375829
1987-02-01,Minnesota,3185000,2274688,2154615,120073
1987-02-01,Mississippi,1873000,1150890,1024191,126699
1987-02-01,Missouri,3851000,2544061,2378262,165799
1987-02-01,Montana,598000,403901,372613,31288
1987-02-01,Nebraska,1181000,813781,777744,36037
1987-02-01,Nevada,753000,547689,513123,34566
1987-02-01,Ohio,8137000,5257262,4845181,412081
1987-02-01,Oklahoma,2410000,1565013,1443237,121776
1987-02-01,Oregon,2073000,1378405,1291389,87016
1987-02-01,Pennsylvania,9277000,5604968,5267204,337764
1987-02-01,Tennessee,3660000,2315094,2144145,170949
1987-02-01,Texas,11996000,8238817,7498891,739926
1987-02-01,Utah,1083000,758236,707431,50805
1987-02-01,Vermont,411000,292575,280415,12160
1987-02-01,Virginia,4359000,2978558,2839386,139172
1987-02-01,Washington,3372000,2231424,2056082,175342
1987-02-01,Wisconsin,3607000,2474813,2321022,153791
1987-02-01,Wyoming,353000,246754,224478,22276
1987-03-01,Alabama,3027000,1863312,1700251,163061
1987-03-01,Alaska,347000,250418,223778,26640
1987-03-01,Arizona,2488000,1600407,1488808,111599
1987-03-01,Arkansas,1773000,1083254,993055,90199
1987-03-01,California,20389000,13622652,12780431,842221
1987-03-01,Colorado,2432000,1707372,1567455,139917
1987-03-01,Connecticut,2501000,1746388,1686926,59462
1987-03-01,Delaware,487000,331289,320978,10311
1987-03-01,Florida,9352000,5783385,5461674,321711
1987-03-01,Georgia,4524000,3034405,2867682,166723
1987-03-01,Hawaii,757000,505835,485942,19893
1987-03-01,Idaho,710000,472209,433902,38307
1987-03-01,Illinois,8724000,5727189,5280767,446422
1987-03-01,Indiana,4147000,2747853,2569253,178600
1987-03-01,Iowa,2137000,1458743,1373324,85419
1987-03-01,Kansas,1827000,1261890,1198479,63411
1987-03-01,Kentucky,2770000,1702987,1553108,149879
1987-03-01,Louisiana,3206000,1957182,1716609,240573
1987-03-01,Maine,893000,577561,550716,26845
1987-03-01,Maryland,3432000,2394803,2289745,105058
1987-03-01,Massachusetts,4580000,3082660,2970674,111986
1987-03-01,Michigan,6913000,4487861,4110164,377697
1987-03-01,Minnesota,3187000,2278848,2158820,120028
1987-03-01,Mississippi,1874000,1150431,1026730,123701
1987-03-01,Missouri,3855000,2548564,2381639,166925
1987-03-01,Montana,598000,403327,372519,30808
1987-03-01,Nebraska,1181000,813172,777588,35584
1987-03-01,Nevada,755000,549580,514871,34709
1987-03-01,Ohio,8143000,5259257,4854104,405153
1987-03-01,Oklahoma,2408000,1562109,1442807,119302
1987-03-01,Oregon,2075000,1380573,1295346,85227
1987-03-01,Pennsylvania,9282000,5613276,5280834,332442
1987-03-01,Tennessee,3665000,2319272,2151028,168244
1987-03-01,Texas,12001000,8244929,7516203,728726
1987-03-01,Utah,1084000,757976,707389,50587
1987-03-01,Vermont,411000,292917,281016,11901
1987-03-01,Virginia,4367000,2983813,2847521,136292
1987-03-01,Washington,3378000,2236821,2064526,172295
1987-03-01,Wisconsin,3609000,2479426,2328319,151107
1987-03-01,Wyoming,352000,245633,223970,21663
1987-04-01,Alabama,3030000,1864450,1705678,158772
1987-04-01,Alaska,346000,249740,223518,26222
1987-04-01,Arizona,2496000,1603708,1495318,108390
1987-04-01,Arkansas,1775000,1085865,996366,89499
1987-04-01,California,20429000,13656227,12831117,825110
1987-04-01,Colorado,2434000,1704273,1567506,136767
1987-04-01,Connecticut,2502000,1747341,1689385,57956
1987-04-01,Delaware,488000,331602,321402,10200
1987-04-01,Florida,9375000,5806771,5487381,319390
1987-04-01,Georgia,4533000,3037576,2873009,164567
1987-04-01,Hawaii,759000,507965,488196,19769
1987-04-01,Idaho,710000,472117,434464,37653
1987-04-01,Illinois,8729000,5743104,5297834,445270
1987-04-01,Indiana,4151000,2748547,2571749,176798
1987-04-01,Iowa,2137000,1459354,1374943,84411
1987-04-01,Kansas,1829000,1262588,1200074,62514
1987-04-01,Kentucky,2772000,1702918,1556132,146786
1987-04-01,Louisiana,3203000,1955201,1718544,236657
1987-04-01,Maine,894000,580005,553817,26188
1987-04-01,Maryland,3437000,2396157,2292512,103645
1987-04-01,Massachusetts,4582000,3088816,2979767,109049
1987-04-01,Michigan,6920000,4498776,4118083,380693
1987-04-01,Minnesota,3190000,2281912,2162206,119706
1987-04-01,Mississippi,1875000,1150229,1029572,120657
1987-04-01,Missouri,3859000,2552910,2385713,167197
1987-04-01,Montana,598000,402572,372222,30350
1987-04-01,Nebraska,1181000,813009,777693,35316
1987-04-01,Nevada,758000,551472,516714,34758
1987-04-01,Ohio,8148000,5259836,4862942,396894
1987-04-01,Oklahoma,2406000,1559174,1442799,116375
1987-04-01,Oregon,2078000,1382880,1299107,83773
1987-04-01,Pennsylvania,9287000,5624773,5296344,328429
1987-04-01,Tennessee,3670000,2322879,2157426,165453
1987-04-01,Texas,12006000,8252958,7533930,719028
1987-04-01,Utah,1085000,757483,707458,50025
1987-04-01,Vermont,412000,293357,281725,11632
1987-04-01,Virginia,4376000,2988968,2856013,132955
1987-04-01,Washington,3383000,2242207,2073435,168772
1987-04-01,Wisconsin,3611000,2483562,2335430,148132
1987-04-01,Wyoming,351000,244406,223491,20915
1987-05-01,Alabama,3033000,1865599,1710928,154671
1987-05-01,Alaska,345000,249173,223395,25778
1987-05-01,Arizona,2503000,1606934,1501817,105117
1987-05-01,Arkansas,1776000,1088735,999784,88951
1987-05-01,California,20468000,13689639,12881285,808354
1987-05-01,Colorado,2436000,1700911,1568235,132676
1987-05-01,Connecticut,2504000,1748395,1692112,56283
1987-05-01,Delaware,489000,331719,321659,10060
1987-05-01,Florida,9397000,5829773,5512775,316998
1987-05-01,Georgia,4543000,3041820,2878138,163682
1987-05-01,Hawaii,760000,509721,490143,19578
1987-05-01,Idaho,711000,472031,435104,36927
1987-05-01,Illinois,8735000,5759979,5318782,441197
1987-05-01,Indiana,4154000,2749152,2574524,174628
1987-05-01,Iowa,2137000,1459503,1375993,83510
1987-05-01,Kansas,1830000,1263595,1201999,61596
1987-05-01,Kentucky,2773000,1701955,1558618,143337
1987-05-01,Louisiana,3200000,1953465,1720652,232813
1987-05-01,Maine,896000,582799,557099,25700
1987-05-01,Maryland,3442000,2397941,2295399,102542
1987-05-01,Massachusetts,4584000,3095561,2989650,105911
1987-05-01,Michigan,6926000,4508662,4125852,382810
1987-05-01,Minnesota,3193000,2283526,2164492,119034
1987-05-01,Mississippi,1876000,1150208,1032334,117874
1987-05-01,Missouri,3862000,2556388,2390219,166169
1987-05-01,Montana,598000,401698,371719,29979
1987-05-01,Nebraska,1181000,813163,777989,35174
1987-05-01,Nevada,760000,553349,518611,34738
1987-05-01,Ohio,8154000,5259374,4872323,387051
1987-05-01,Oklahoma,2404000,1556111,1442924,113187
1987-05-01,Oregon,2080000,1385585,1302572,83013
1987-05-01,Pennsylvania,9292000,5638211,5312732,325479
1987-05-01,Tennessee,3675000,2325841,2163677,162164
1987-05-01,Texas,12011000,8262047,7550980,711067
1987-05-01,Utah,1086000,756714,707592,49122
1987-05-01,Vermont,412000,293941,282564,11377
1987-05-01,Virginia,4384000,2993915,2864694,129221
1987-05-01,Washington,3389000,2248153,2082750,165403
1987-05-01,Wisconsin,3614000,2487287,2342238,145049
1987-05-01,Wyoming,350000,243256,223118,20138
1987-06-01,Alabama,3036000,1866710,1715585,151125
1987-06-01,Alaska,345000,248844,223476,25368
1987-06-01,Arizona,2511000,1609758,1507498,102260
1987-06-01,Arkansas,1778000,1091567,1003003,88564
1987-06-01,California,20508000,13722122,12928159,793963
1987-06-01,Colorado,2437000,1697968,1569745,128223
1987-06-01,Connecticut,2505000,1749265,1694598,54667
1987-06-01,Delaware,490000,331877,321974,9903
1987-06-01,Florida,9419000,5851925,5537085,314840
1987-06-01,Georgia,4552000,3047464,2883162,164302
1987-06-01,Hawaii,762000,511291,491955,19336
1987-06-01,Idaho,711000,472026,435830,36196
1987-06-01,Illinois,8740000,5775959,5341045,434914
1987-06-01,Indiana,4158000,2749082,2576908,172174
1987-06-01,Iowa,2137000,1459620,1376773,82847
1987-06-01,Kansas,1831000,1264664,1203854,60810
1987-06-01,Kentucky,2774000,1700427,1560463,139964
1987-06-01,Louisiana,3198000,1951695,1722312,229383
1987-06-01,Maine,897000,585746,560327,25419
1987-06-01,Maryland,3447000,2400589,2298741,101848
1987-06-01,Massachusetts,4586000,3102214,2999265,102949
1987-06-01,Michigan,6933000,4515954,4133076,382878
1987-06-01,Minnesota,3195000,2284398,2166206,118192
1987-06-01,Mississippi,1877000,1150396,1034814,115582
1987-06-01,Missouri,3866000,2558861,2394611,164250
1987-06-01,Montana,597000,400867,371097,29770
1987-06-01,Nebraska,1181000,813360,778330,35030
1987-06-01,Nevada,763000,555215,520509,34706
1987-06-01,Ohio,8159000,5259016,4882491,376525
1987-06-01,Oklahoma,2401000,1552753,1442599,110154
1987-06-01,Oregon,2082000,1389239,1306149,83090
1987-06-01,Pennsylvania,9296000,5652880,5329338,323542
1987-06-01,Tennessee,3680000,2328379,2170167,158212
1987-06-01,Texas,12016000,8271596,7566800,704796
1987-06-01,Utah,1086000,755742,707739,48003
1987-06-01,Vermont,413000,294644,283495,11149
1987-06-01,Virginia,4392000,2998438,2873161,125277
1987-06-01,Washington,3394000,2254986,2092302,162684
1987-06-01,Wisconsin,3616000,2490651,2348365,142286
1987-06-01,Wyoming,349000,242323,222888,19435
1987-07-01,Alabama,3039000,1867798,1719387,148411
1987-07-01,Alaska,344000,248711,223693,25018
1987-07-01,Arizona,2518000,1612661,1512418,100243
1987-07-01,Arkansas,1779000,1094319,1006045,88274
1987-07-01,California,20547000,13754143,12971311,782832
1987-07-01,Colorado,2439000,1696212,1572250,123962
1987-07-01,Connecticut,2507000,1749668,1696385,53283
1987-07-01,Delaware,491000,332288,322526,9762
1987-07-01,Florida,9441000,5873442,5559973,313469
1987-07-01,Georgia,4561000,3054686,2888396,166290
1987-07-01,Hawaii,763000,512840,493791,19049
1987-07-01,Idaho,711000,472131,436554,35577
1987-07-01,Illinois,8745000,5787959,5360292,427667
1987-07-01,Indiana,4161000,2748146,2578771,169375
1987-07-01,Iowa,2137000,1460207,1377925,82282
1987-07-01,Kansas,1832000,1265408,1205266,60142
1987-07-01,Kentucky,2775000,1699114,1562062,137052
1987-07-01,Louisiana,3195000,1949699,1723105,226594
1987-07-01,Maine,898000,588526,563235,25291
1987-07-01,Maryland,3452000,2404270,2302779,101491
1987-07-01,Massachusetts,4588000,3108231,3007705,100526
1987-07-01,Michigan,6940000,4519954,4139167,380787
1987-07-01,Minnesota,3198000,2285904,2168535,117369
1987-07-01,Mississippi,1878000,1150831,1037026,113805
1987-07-01,Missouri,3870000,2560374,2398390,161984
1987-07-01,Montana,597000,400231,370516,29715
1987-07-01,Nebraska,1181000,813307,778563,34744
1987-07-01,Nevada,765000,557177,522453,34724
1987-07-01,Ohio,8165000,5260145,4893885,366260
1987-07-01,Oklahoma,2399000,1549089,1441555,107534
1987-07-01,Oregon,2084000,1394150,1310251,83899
1987-07-01,Pennsylvania,9301000,5667973,5345799,322174
1987-07-01,Tennessee,3685000,2331256,2177466,153790
1987-07-01,Texas,12021000,8281141,7581950,699191
1987-07-01,Utah,1087000,754845,707984,46861
1987-07-01,Vermont,413000,295394,284460,10934
1987-07-01,Virginia,4400000,3003196,2881685,121511
1987-07-01,Washington,3400000,2262938,2101981,160957
1987-07-01,Wisconsin,3618000,2493914,2353678,140236
1987-07-01,Wyoming,348000,241675,222798,18877
1987-08-01,Alabama,3041000,1869136,1722541,146595
1987-08-01,Alaska,344000,248729,224024,24705
1987-08-01,Arizona,2523000,1616244,1516906,99338
1987-08-01,Arkansas,1780000,1096948,1008830,88118
1987-08-01,California,20585000,13787737,13012350,775387
1987-08-01,Colorado,2440000,1696062,1575417,120645
1987-08-01,Connecticut,2508000,1749575,1697317,52258
1987-08-01,Delaware,492000,333074,323360,9714
1987-08-01,Florida,9460000,5894910,5581836,313074
1987-08-01,Georgia,4568000,3063549,2894260,169289
1987-08-01,Hawaii,764000,514462,495759,18703
1987-08-01,Idaho,711000,472265,437150,35115
1987-08-01,Illinois,8749000,5794369,5373503,420866
1987-08-01,Indiana,4164000,2746963,2580892,166071
1987-08-01,Iowa,2138000,1461625,1380108,81517
1987-08-01,Kansas,1833000,1265768,1206238,59530
1987-08-01,Kentucky,2776000,1698891,1563985,134906
1987-08-01,Louisiana,3193000,1947697,1723056,224641
1987-08-01,Maine,900000,590886,565649,25237
1987-08-01,Maryland,3457000,2409339,2307758,101581
1987-08-01,Massachusetts,4590000,3113354,3014432,98922
1987-08-01,Michigan,6943000,4521202,4143215,377987
1987-08-01,Minnesota,3202000,2288642,2172183,116459
1987-08-01,Mississippi,1879000,1151509,1039177,112332
1987-08-01,Missouri,3873000,2561084,2401562,159522
1987-08-01,Montana,597000,399903,370146,29757
1987-08-01,Nebraska,1182000,812947,778678,34269
1987-08-01,Nevada,768000,559252,524478,34774
1987-08-01,Ohio,8171000,5263148,4906322,356826
1987-08-01,Oklahoma,2398000,1545656,1439941,105715
1987-08-01,Oregon,2087000,1399704,1314487,85217
1987-08-01,Pennsylvania,9305000,5683262,5361832,321430
1987-08-01,Tennessee,3688000,2334925,2185439,149486
1987-08-01,Texas,12025000,8289920,7596549,693371
1987-08-01,Utah,1088000,754241,708381,45860
1987-08-01,Vermont,414000,296122,285402,10720
1987-08-01,Virginia,4407000,3008940,2890445,118495
1987-08-01,Washington,3407000,2271623,2111358,160265
1987-08-01,Wisconsin,3621000,2497005,2358200,138805
1987-08-01,Wyoming,348000,241292,222817,18475
1987-09-01,Alabama,3042000,1870854,1725552,145302
1987-09-01,Alaska,345000,248894,224498,24396
1987-09-01,Arizona,2528000,1620584,1521300,99284
1987-09-01,Arkansas,1780000,1099409,1011360,88049
1987-09-01,California,20622000,13824385,13053851,770534
1987-09-01,Colorado,2440000,1697915,1579136,118779
1987-09-01,Connecticut,2509000,1749143,1697601,51542
1987-09-01,Delaware,493000,334270,324473,9797
1987-09-01,Florida,9479000,5916541,5603570,312971
1987-09-01,Georgia,4574000,3073580,2901124,172456
1987-09-01,Hawaii,765000,516161,497862,18299
1987-09-01,Idaho,712000,472346,437674,34672
1987-09-01,Illinois,8753000,5796463,5381069,415394
1987-09-01,Indiana,4166000,2746582,2584563,162019
1987-09-01,Iowa,2139000,1463701,1383380,80321
1987-09-01,Kansas,1835000,1266056,1207182,58874
1987-09-01,Kentucky,2778000,1700257,1566731,133526
1987-09-01,Louisiana,3190000,1946021,1722770,223251
1987-09-01,Maine,901000,592647,567563,25084
1987-09-01,Maryland,3463000,2415890,2313718,102172
1987-09-01,Massachusetts,4593000,3117764,3019657,98107
1987-09-01,Michigan,6945000,4521123,4145336,375787
1987-09-01,Minnesota,3206000,2292054,2177113,114941
1987-09-01,Mississippi,1879000,1152229,1041477,110752
1987-09-01,Missouri,3875000,2561417,2404829,156588
1987-09-01,Montana,597000,399976,370217,29759
1987-09-01,Nebraska,1183000,812448,778904,33544
1987-09-01,Nevada,771000,561388,526654,34734
1987-09-01,Ohio,8177000,5267709,4919371,348338
1987-09-01,Oklahoma,2396000,1543094,1438341,104753
1987-09-01,Oregon,2091000,1404937,1318407,86530
1987-09-01,Pennsylvania,9309000,5698628,5377648,320980
1987-09-01,Tennessee,3691000,2338965,2193225,145740
1987-09-01,Texas,12029000,8297572,7610887,686685
1987-09-01,Utah,1089000,754058,709018,45040
1987-09-01,Vermont,415000,296785,286288,10497
1987-09-01,Virginia,4415000,3016182,2899628,116554
1987-09-01,Washington,3414000,2280146,2120167,159979
1987-09-01,Wisconsin,3624000,2499922,2362633,137289
1987-09-01,Wyoming,348000,241075,222947,18128
1987-10-01,Alabama,3044000,1872460,1728348,144112
1987-10-01,Alaska,345000,249191,225115,24076
1987-10-01,Arizona,2532000,1625126,1525353,99773
1987-10-01,Arkansas,1781000,1101660,1013659,88001
1987-10-01,California,20660000,13862797,13095769,767028
1987-10-01,Colorado,2441000,1701447,1583195,118252
1987-10-01,Connecticut,2510000,1748279,1697253,51026
1987-10-01,Delaware,493000,335772,325775,9997
1987-10-01,Florida,9498000,5937690,5624797,312893
1987-10-01,Georgia,4581000,3083670,2908551,175119
1987-10-01,Hawaii,766000,517677,499798,17879
1987-10-01,Idaho,712000,472340,438171,34169
1987-10-01,Illinois,8757000,5796182,5383986,412196
1987-10-01,Indiana,4169000,2747419,2589717,157702
1987-10-01,Iowa,2140000,1465663,1387022,78641
1987-10-01,Kansas,1836000,1266629,1208379,58250
1987-10-01,Kentucky,2779000,1702856,1570018,132838
1987-10-01,Louisiana,3188000,1944770,1722666,222104
1987-10-01,Maine,903000,593605,568898,24707
1987-10-01,Maryland,3468000,2423132,2320022,103110
1987-10-01,Massachusetts,4595000,3121899,3023962,97937
1987-10-01,Michigan,6948000,4520858,4145979,374879
1987-10-01,Minnesota,3210000,2295389,2182783,112606
1987-10-01,Mississippi,1880000,1152637,1043770,108867
1987-10-01,Missouri,3878000,2561699,2408585,153114
1987-10-01,Montana,597000,400415,370795,29620
1987-10-01,Nebraska,1183000,811981,779358,32623
1987-10-01,Nevada,774000,563471,528952,34519
1987-10-01,Ohio,8183000,5272992,4931217,341775
1987-10-01,Oklahoma,2395000,1541260,1437055,104205
1987-10-01,Oregon,2094000,1409233,1321918,87315
1987-10-01,Pennsylvania,9312000,5713246,5392744,320502
1987-10-01,Tennessee,3694000,2342518,2199702,142816
1987-10-01,Texas,12032000,8304516,7624375,680141
1987-10-01,Utah,1089000,754156,709841,44315
1987-10-01,Vermont,415000,297269,287001,10268
1987-10-01,Virginia,4422000,3024933,2909376,115557
1987-10-01,Washington,3420000,2287560,2128133,159427
1987-10-01,Wisconsin,3626000,2502608,2367558,135050
1987-10-01,Wyoming,347000,240873,223134,17739
1987-11-01,Alabama,3046000,1873514,1730817,142697
1987-11-01,Alaska,345000,249525,225806,23719
1987-11-01,Arizona,2537000,1629374,1528901,100473
1987-11-01,Arkansas,1781000,1103624,1015821,87803
1987-11-01,California,20698000,13901345,13138322,763023
1987-11-01,Colorado,2441000,1705602,1587248,118354
1987-11-01,Connecticut,2511000,1746930,1696387,50543
1987-11-01,Delaware,494000,337388,327160,10228
1987-11-01,Florida,9517000,5958265,5645574,312691
1987-11-01,Georgia,4587000,3093550,2916483,177067
1987-11-01,Hawaii,768000,518715,501247,17468
1987-11-01,Idaho,713000,472250,438718,33532
1987-11-01,Illinois,8761000,5795151,5384050,411101
1987-11-01,Indiana,4172000,2749297,2595740,153557
1987-11-01,Iowa,2141000,1467559,1390969,76590
1987-11-01,Kansas,1837000,1267652,1209947,57705
1987-11-01,Kentucky,2780000,1705862,1573336,132526
1987-11-01,Louisiana,3186000,1943837,1723158,220679
1987-11-01,Maine,904000,593757,569721,24036
1987-11-01,Maryland,3473000,2430099,2326048,104051
1987-11-01,Massachusetts,4597000,3126506,3028401,98105
1987-11-01,Michigan,6950000,4521729,4146497,375232
1987-11-01,Minnesota,3214000,2298209,2188604,109605
1987-11-01,Mississippi,1881000,1152463,1045938,106525
1987-11-01,Missouri,3880000,2562206,2413050,149156
1987-11-01,Montana,597000,401119,371817,29302
1987-11-01,Nebraska,1184000,811817,780121,31696
1987-11-01,Nevada,777000,565462,531382,34080
1987-11-01,Ohio,8190000,5279138,4941177,337961
1987-11-01,Oklahoma,2394000,1539831,1436261,103570
1987-11-01,Oregon,2097000,1412433,1325362,87071
1987-11-01,Pennsylvania,9316000,5725802,5406694,319108
1987-11-01,Tennessee,3698000,2345003,2204497,140506
1987-11-01,Texas,12036000,8311325,7637612,673713
1987-11-01,Utah,1090000,754382,710847,43535
1987-11-01,Vermont,416000,297494,287484,10010
1987-11-01,Virginia,4429000,3034719,2919704,115015
1987-11-01,Washington,3427000,2293361,2135276,158085
1987-11-01,Wisconsin,3629000,2505477,2373602,131875
1987-11-01,Wyoming,347000,240625,223336,17289
1987-12-01,Alabama,3047000,1873624,1732573,141051
1987-12-01,Alaska,345000,249745,226380,23365
1987-12-01,Arizona,2542000,1632802,1531408,101394
1987-12-01,Arkansas,1782000,1104956,1017470,87486
1987-12-01,California,20735000,13937069,13178776,758293
1987-12-01,Colorado,2442000,1709038,1590617,118421
1987-12-01,Connecticut,2512000,1745153,1695133,50020
1987-12-01,Delaware,495000,338875,328493,10382
1987-12-01,Florida,9536000,5977310,5664702,312608
1987-12-01,Georgia,4594000,3103158,2924367,178791
1987-12-01,Hawaii,769000,519058,501962,17096
1987-12-01,Idaho,713000,472113,439327,32786
1987-12-01,Illinois,8765000,5794156,5382790,411366
1987-12-01,Indiana,4174000,2751460,2601513,149947
1987-12-01,Iowa,2142000,1469609,1395084,74525
1987-12-01,Kansas,1838000,1268904,1211519,57385
1987-12-01,Kentucky,2781000,1708369,1575988,132381
1987-12-01,Louisiana,3183000,1942816,1723849,218967
1987-12-01,Maine,906000,593294,570178,23116
1987-12-01,Maryland,3479000,2435720,2330909,104811
1987-12-01,Massachusetts,4599000,3131161,3032733,98428
1987-12-01,Michigan,6953000,4523889,4147992,375897
1987-12-01,Minnesota,3218000,2300103,2193641,106462
1987-12-01,Mississippi,1881000,1151503,1047648,103855
1987-12-01,Missouri,3883000,2563073,2417713,145360
1987-12-01,Montana,597000,401816,372955,28861
1987-12-01,Nebraska,1185000,811996,781056,30940
1987-12-01,Nevada,780000,567270,533835,33435
1987-12-01,Ohio,8196000,5285401,4948607,336794
1987-12-01,Oklahoma,2392000,1538088,1435520,102568
1987-12-01,Oregon,2101000,1414594,1328553,86041
1987-12-01,Pennsylvania,9320000,5734022,5417517,316505
1987-12-01,Tennessee,3701000,2345661,2207045,138616
1987-12-01,Texas,12040000,8316703,7649467,667236
1987-12-01,Utah,1091000,754469,711885,42584
1987-12-01,Vermont,417000,297448,287743,9705
1987-12-01,Virginia,4436000,3044392,2929687,114705
1987-12-01,Washington,3434000,2297322,2141437,155885
1987-12-01,Wisconsin,3632000,2508772,2380809,127963
1987-12-01,Wyoming,347000,240294,223465,16829
1988-01-01,Alabama,3049000,1872638,1733412,139226
1988-01-01,Alaska,346000,249709,226692,23017
1988-01-01,Arizona,2547000,1635414,1532912,102502
1988-01-01,Arkansas,1782000,1105455,1018381,87074
1988-01-01,California,20773000,13967800,13214733,753067
1988-01-01,Colorado,2442000,1710846,1593001,117845
1988-01-01,Connecticut,2513000,1743456,1693997,49459
1988-01-01,Delaware,496000,340179,329783,10396
1988-01-01,Florida,9555000,5993923,5681440,312483
1988-01-01,Georgia,4600000,3112005,2931704,180301
1988-01-01,Hawaii,770000,518680,501945,16735
1988-01-01,Idaho,713000,472097,440060,32037
1988-01-01,Illinois,8769000,5793013,5381626,411387
1988-01-01,Indiana,4177000,2753453,2606593,146860
1988-01-01,Iowa,2143000,1472126,1399385,72741
1988-01-01,Kansas,1840000,1270010,1212712,57298
1988-01-01,Kentucky,2783000,1709737,1577705,132032
1988-01-01,Louisiana,3181000,1941012,1724160,216852
1988-01-01,Maine,907000,592596,570509,22087
1988-01-01,Maryland,3484000,2439566,2334434,105132
1988-01-01,Massachusetts,4602000,3135420,3036651,98769
1988-01-01,Michigan,6955000,4526112,4151395,374717
1988-01-01,Minnesota,3221000,2300902,2197402,103500
1988-01-01,Mississippi,1882000,1149584,1048539,101045
1988-01-01,Missouri,3885000,2564640,2422017,142623
1988-01-01,Montana,597000,402389,374016,28373
1988-01-01,Nebraska,1186000,812353,782057,30296
1988-01-01,Nevada,783000,568920,536242,32678
1988-01-01,Ohio,8202000,5290468,4953695,336773
1988-01-01,Oklahoma,2391000,1535540,1434593,100947
1988-01-01,Oregon,2104000,1416034,1331232,84802
1988-01-01,Pennsylvania,9324000,5736452,5423849,312603
1988-01-01,Tennessee,3704000,2343762,2206809,136953
1988-01-01,Texas,12044000,8319802,7659565,660237
1988-01-01,Utah,1092000,754310,712886,41424
1988-01-01,Vermont,418000,297253,287901,9352
1988-01-01,Virginia,4444000,3053240,2938657,114583
1988-01-01,Washington,3441000,2299925,2146754,153171
1988-01-01,Wisconsin,3635000,2512496,2388963,123533
1988-01-01,Wyoming,347000,239862,223498,16364
1988-02-01,Alabama,3051000,1870796,1733404,137392
1988-02-01,Alaska,346000,249529,226844,22685
1988-02-01,Arizona,2552000,1637822,1534142,103680
1988-02-01,Arkansas,1783000,1105452,1018869,86583
1988-02-01,California,20811000,13995002,13246962,748040
1988-02-01,Colorado,2443000,1711516,1595091,116425
1988-02-01,Connecticut,2514000,1742398,1693466,48932
1988-02-01,Delaware,497000,341399,331145,10254
1988-02-01,Florida,9575000,6008310,5696320,311990
1988-02-01,Georgia,4607000,3119904,2938763,181141
1988-02-01,Hawaii,771000,517862,501469,16393
1988-02-01,Idaho,714000,472431,441096,31335
1988-02-01,Illinois,8773000,5791918,5382020,409898
1988-02-01,Indiana,4180000,2756051,2611645,144406
1988-02-01,Iowa,2145000,1475373,1403970,71403
1988-02-01,Kansas,1841000,1270803,1213503,57300
1988-02-01,Kentucky,2784000,1709812,1578473,131339
1988-02-01,Louisiana,3179000,1938307,1723983,214324
1988-02-01,Maine,909000,592256,571035,21221
1988-02-01,Maryland,3489000,2442240,2337429,104811
1988-02-01,Massachusetts,4604000,3139245,3040160,99085
1988-02-01,Michigan,6958000,4527757,4158075,369682
1988-02-01,Minnesota,3225000,2301354,2200319,101035
1988-02-01,Mississippi,1883000,1146927,1048468,98459
1988-02-01,Missouri,3888000,2567454,2425977,141477
1988-02-01,Montana,596000,402877,374950,27927
1988-02-01,Nebraska,1186000,812916,783147,29769
1988-02-01,Nevada,786000,570614,538682,31932
1988-02-01,Ohio,8208000,5294712,4958839,335873
1988-02-01,Oklahoma,2390000,1532294,1433458,98836
1988-02-01,Oregon,2107000,1417277,1333472,83805
1988-02-01,Pennsylvania,9327000,5734594,5426918,307676
1988-02-01,Tennessee,3707000,2339988,2204414,135574
1988-02-01,Texas,12048000,8321766,7669767,651999
1988-02-01,Utah,1093000,754135,713997,40138
1988-02-01,Vermont,419000,297138,288143,8995
1988-02-01,Virginia,4451000,3061256,2946408,114848
1988-02-01,Washington,3447000,2302558,2152012,150546
1988-02-01,Wisconsin,3638000,2517149,2397999,119150
1988-02-01,Wyoming,346000,239429,223520,15909
1988-03-01,Alabama,3052000,1868482,1732653,135829
1988-03-01,Alaska,346000,249409,226975,22434
1988-03-01,Arizona,2557000,1640390,1535384,105006
1988-03-01,Arkansas,1783000,1105362,1019221,86141
1988-03-01,California,20848000,14020683,13275848,744835
1988-03-01,Colorado,2444000,1711387,1596837,114550
1988-03-01,Connecticut,2515000,1741933,1693317,48616
1988-03-01,Delaware,498000,342677,332662,10015
1988-03-01,Florida,9594000,6020751,5709584,311167
1988-03-01,Georgia,4614000,3126957,2945881,181076
1988-03-01,Hawaii,772000,517010,500899,16111
1988-03-01,Idaho,714000,473202,442486,30716
1988-03-01,Illinois,8777000,5792117,5385090,407027
1988-03-01,Indiana,4182000,2759980,2617082,142898
1988-03-01,Iowa,2146000,1478885,1408250,70635
1988-03-01,Kansas,1842000,1271324,1213970,57354
1988-03-01,Kentucky,2785000,1708911,1578351,130560
1988-03-01,Louisiana,3176000,1934930,1723155,211775
1988-03-01,Maine,910000,592552,571744,20808
1988-03-01,Maryland,3495000,2444576,2340466,104110
1988-03-01,Massachusetts,4606000,3142130,3042588,99542
1988-03-01,Michigan,6961000,4528450,4167405,361045
1988-03-01,Minnesota,3229000,2302289,2202830,99459
1988-03-01,Mississippi,1883000,1143858,1047474,96384
1988-03-01,Missouri,3890000,2571635,2429597,142038
1988-03-01,Montana,596000,403168,375552,27616
1988-03-01,Nebraska,1187000,813645,784295,29350
1988-03-01,Nevada,789000,572424,541109,31315
1988-03-01,Ohio,8214000,5298625,4965690,332935
1988-03-01,Oklahoma,2388000,1528432,1431553,96879
1988-03-01,Oregon,2111000,1418655,1335389,83266
1988-03-01,Pennsylvania,9331000,5731704,5428994,302710
1988-03-01,Tennessee,3710000,2335887,2201189,134698
1988-03-01,Texas,12052000,8322994,7680433,642561
1988-03-01,Utah,1094000,754133,715198,38935
1988-03-01,Vermont,420000,297215,288518,8697
1988-03-01,Virginia,4458000,3068031,2952408,115623
1988-03-01,Washington,3454000,2306115,2157603,148512
1988-03-01,Wisconsin,3641000,2522986,2407475,115511
1988-03-01,Wyoming,346000,239085,223561,15524
1988-04-01,Alabama,3054000,1866560,1731673,134887
1988-04-01,Alaska,346000,249424,227146,22278
1988-04-01,Arizona,2561000,1643843,1537393,106450
1988-04-01,Arkansas,1784000,1105577,1019698,85879
1988-04-01,California,20886000,14047660,13303414,744246
1988-04-01,Colorado,2444000,1710811,1598066,112745
1988-04-01,Connecticut,2516000,1742067,1693413,48654
1988-04-01,Delaware,498000,344157,334330,9827
1988-04-01,Florida,9613000,6032519,5721978,310541
1988-04-01,Georgia,4620000,3133726,2953521,180205
1988-04-01,Hawaii,773000,516584,500676,15908
1988-04-01,Idaho,715000,474515,444285,30230
1988-04-01,Illinois,8781000,5794922,5391704,403218
1988-04-01,Indiana,4185000,2765407,2622938,142469
1988-04-01,Iowa,2147000,1482369,1412046,70323
1988-04-01,Kansas,1843000,1271768,1214340,57428
1988-04-01,Kentucky,2786000,1708180,1578228,129952
1988-04-01,Louisiana,3174000,1931580,1721936,209644
1988-04-01,Maine,912000,593327,572461,20866
1988-04-01,Maryland,3500000,2447346,2343807,103539
1988-04-01,Massachusetts,4608000,3144383,3044045,100338
1988-04-01,Michigan,6963000,4528907,4177700,351207
1988-04-01,Minnesota,3233000,2304276,2205462,98814
1988-04-01,Mississippi,1884000,1141008,1045896,95112
1988-04-01,Missouri,3893000,2577187,2433027,144160
1988-04-01,Montana,596000,403332,375865,27467
1988-04-01,Nebraska,1188000,814537,785509,29028
1988-04-01,Nevada,792000,574434,543512,30922
1988-04-01,Ohio,8220000,5303399,4974742,328657
1988-04-01,Oklahoma,2387000,1524579,1428890,95689
1988-04-01,Oregon,2114000,1420537,1337340,83197
1988-04-01,Pennsylvania,9335000,5731779,5433152,298627
1988-04-01,Tennessee,3713000,2332728,2198355,134373
1988-04-01,Texas,12055000,8324953,7692115,632838
1988-04-01,Utah,1094000,754569,716514,38055
1988-04-01,Vermont,420000,297525,289020,8505
1988-04-01,Virginia,4465000,3073790,2956813,116977
1988-04-01,Washington,3461000,2311402,2163902,147500
1988-04-01,Wisconsin,3643000,2529936,2416976,112960
1988-04-01,Wyoming,346000,238869,223609,15260
1988-05-01,Alabama,3056000,1866008,1731433,134575
1988-05-01,Alaska,347000,249598,227430,22168
1988-05-01,Arizona,2566000,1649010,1541180,107830
1988-05-01,Arkansas,1784000,1106158,1020357,85801
1988-05-01,California,20924000,14077761,13332188,745573
1988-05-01,Colorado,2445000,1710155,1598892,111263
1988-05-01,Connecticut,2517000,1743025,1694026,48999
1988-05-01,Delaware,499000,345849,336039,9810
1988-05-01,Florida,9632000,6044759,5734359,310400
1988-05-01,Georgia,4627000,3140371,2961667,178704
1988-05-01,Hawaii,775000,516762,500983,15779
1988-05-01,Idaho,715000,476283,446396,29887
1988-05-01,Illinois,8785000,5800391,5401781,398610
1988-05-01,Indiana,4188000,2772427,2629489,142938
1988-05-01,Iowa,2148000,1485554,1415416,70138
1988-05-01,Kansas,1845000,1272414,1214998,57416
1988-05-01,Kentucky,2788000,1708701,1579136,129565
1988-05-01,Louisiana,3172000,1928779,1720853,207926
1988-05-01,Maine,913000,594551,573236,21315
1988-05-01,Maryland,3505000,2450964,2347574,103390
1988-05-01,Massachusetts,4611000,3146797,3045360,101437
1988-05-01,Michigan,6966000,4530290,4187648,342642
1988-05-01,Minnesota,3237000,2307409,2208460,98949
1988-05-01,Mississippi,1885000,1139179,1044383,94796
1988-05-01,Missouri,3895000,2583590,2436653,146937
1988-05-01,Montana,596000,403470,376061,27409
1988-05-01,Nebraska,1189000,815575,786819,28756
1988-05-01,Nevada,795000,576670,545953,30717
1988-05-01,Ohio,8227000,5309650,4985496,324154
1988-05-01,Oklahoma,2386000,1521487,1426221,95266
1988-05-01,Oregon,2117000,1422911,1339667,83244
1988-05-01,Pennsylvania,9339000,5736864,5440867,295997
1988-05-01,Tennessee,3717000,2330751,2196189,134562
1988-05-01,Texas,12059000,8329523,7705531,623992
1988-05-01,Utah,1095000,755611,718049,37562
1988-05-01,Vermont,421000,298058,289609,8449
1988-05-01,Virginia,4473000,3079182,2960289,118893
1988-05-01,Washington,3468000,2318521,2171177,147344
1988-05-01,Wisconsin,3646000,2537758,2426272,111486
1988-05-01,Wyoming,346000,238780,223644,15136
1988-06-01,Alabama,3057000,1867290,1732527,134763
1988-06-01,Alaska,347000,249929,227862,22067
1988-06-01,Arizona,2571000,1655749,1546838,108911
1988-06-01,Arkansas,1785000,1106887,1021123,85764
1988-06-01,California,20961000,14111124,13363692,747432
1988-06-01,Colorado,2445000,1709268,1599123,110145
1988-06-01,Connecticut,2518000,1744735,1695224,49511
1988-06-01,Delaware,500000,347569,337589,9980
1988-06-01,Florida,9651000,6058755,5747937,310818
1988-06-01,Georgia,4633000,3146734,2969886,176848
1988-06-01,Hawaii,776000,517320,501608,15712
1988-06-01,Idaho,716000,478238,448597,29641
1988-06-01,Illinois,8789000,5809638,5415772,393866
1988-06-01,Indiana,4190000,2781326,2637374,143952
1988-06-01,Iowa,2149000,1488348,1418539,69809
1988-06-01,Kansas,1846000,1273530,1216220,57310
1988-06-01,Kentucky,2789000,1710758,1581544,129214
1988-06-01,Louisiana,3169000,1926396,1720212,206184
1988-06-01,Maine,915000,596312,574325,21987
1988-06-01,Maryland,3511000,2455393,2351752,103641
1988-06-01,Massachusetts,4613000,3149646,3046929,102717
1988-06-01,Michigan,6968000,4534164,4197381,336783
1988-06-01,Minnesota,3241000,2311114,2211656,99458
1988-06-01,Mississippi,1885000,1138896,1043558,95338
1988-06-01,Missouri,3898000,2589898,2440758,149140
1988-06-01,Montana,596000,403689,376384,27305
1988-06-01,Nebraska,1189000,816676,788207,28469
1988-06-01,Nevada,798000,579009,548433,30576
1988-06-01,Ohio,8233000,5316940,4996880,320060
1988-06-01,Oklahoma,2384000,1519697,1424291,95406
1988-06-01,Oregon,2121000,1425659,1342584,83075
1988-06-01,Pennsylvania,9342000,5746515,5451597,294918
1988-06-01,Tennessee,3720000,2329995,2194898,135097
1988-06-01,Texas,12063000,8337076,7720552,616524
1988-06-01,Utah,1096000,757164,719803,37361
1988-06-01,Vermont,422000,298726,290187,8539
1988-06-01,Virginia,4480000,3084561,2963402,121159
1988-06-01,Washington,3474000,2327017,2179491,147526
1988-06-01,Wisconsin,3649000,2545950,2435362,110588
1988-06-01,Wyoming,345000,238791,223659,15132
1988-07-01,Alabama,3059000,1870241,1734921,135320
1988-07-01,Alaska,347000,250513,228541,21972
1988-07-01,Arizona,2576000,1663625,1554091,109534
1988-07-01,Arkansas,1785000,1107623,1021981,85642
1988-07-01,California,20999000,14146708,13397748,748960
1988-07-01,Colorado,2446000,1708087,1598855,109232
1988-07-01,Connecticut,2519000,1746771,1696669,50102
1988-07-01,Delaware,501000,349074,338787,10287
1988-07-01,Florida,9670000,6075287,5763308,311979
1988-07-01,Georgia,4640000,3152774,2977668,175106
1988-07-01,Hawaii,777000,517958,502236,15722
1988-07-01,Idaho,716000,480234,450838,29396
1988-07-01,Illinois,8793000,5824376,5434411,389965
1988-07-01,Indiana,4193000,2791990,2646735,145255
1988-07-01,Iowa,2150000,1490793,1421543,69250
1988-07-01,Kansas,1847000,1275171,1217915,57256
1988-07-01,Kentucky,2790000,1713923,1585151,128772
1988-07-01,Louisiana,3167000,1924362,1720213,204149
1988-07-01,Maine,916000,598492,575824,22668
1988-07-01,Maryland,3516000,2460354,2356208,104146
1988-07-01,Massachusetts,4615000,3153019,3048898,104121
1988-07-01,Michigan,6971000,4541559,4207374,334185
1988-07-01,Minnesota,3245000,2314726,2214877,99849
1988-07-01,Mississippi,1886000,1140206,1043703,96503
1988-07-01,Missouri,3900000,2595614,2445227,150387
1988-07-01,Montana,596000,404099,377054,27045
1988-07-01,Nebraska,1190000,817699,789543,28156
1988-07-01,Nevada,801000,581285,550934,30351
1988-07-01,Ohio,8239000,5324442,5007357,317085
1988-07-01,Oklahoma,2383000,1519561,1423572,95989
1988-07-01,Oregon,2124000,1428946,1346460,82486
1988-07-01,Pennsylvania,9346000,5758664,5463871,294793
1988-07-01,Tennessee,3723000,2330044,2194304,135740
1988-07-01,Texas,12067000,8346901,7736271,610630
1988-07-01,Utah,1097000,759008,721764,37244
1988-07-01,Vermont,423000,299390,290641,8749
1988-07-01,Virginia,4487000,3089543,2966231,123312
1988-07-01,Washington,3481000,2336137,2188802,147335
1988-07-01,Wisconsin,3652000,2553964,2444152,109812
1988-07-01,Wyoming,345000,238864,223655,15209
1988-08-01,Alabama,3060000,1874400,1738124,136276
1988-08-01,Alaska,347000,251295,229426,21869
1988-08-01,Arizona,2580000,1671986,1562297,109689
1988-08-01,Arkansas,1786000,1108522,1023154,85368
1988-08-01,California,21039000,14183783,13433877,749906
1988-08-01,Colorado,2447000,1706192,1598071,108121
1988-08-01,Connecticut,2519000,1748586,1697856,50730
1988-08-01,Delaware,502000,350253,339616,10637
1988-08-01,Florida,9689000,6094344,5779950,314394
1988-08-01,Georgia,4645000,3158682,2984733,173949
1988-08-01,Hawaii,778000,518578,502738,15840
1988-08-01,Idaho,717000,482146,453026,29120
1988-08-01,Illinois,8796000,5844158,5456760,387398
1988-08-01,Indiana,4195000,2803595,2657083,146512
1988-08-01,Iowa,2150000,1493307,1424665,68642
1988-08-01,Kansas,1848000,1277083,1219767,57316
1988-08-01,Kentucky,2791000,1717316,1589273,128043
1988-08-01,Louisiana,3166000,1922628,1720794,201834
1988-08-01,Maine,917000,600768,577609,23159
1988-08-01,Maryland,3520000,2465226,2360808,104418
1988-08-01,Massachusetts,4615000,3157099,3051463,105636
1988-08-01,Michigan,6972000,4552128,4217933,334195
1988-08-01,Minnesota,3247000,2318216,2218000,100216
1988-08-01,Mississippi,1887000,1142738,1044730,98008
1988-08-01,Missouri,3901000,2600682,2449729,150953
1988-08-01,Montana,596000,404649,378007,26642
1988-08-01,Nebraska,1190000,818522,790716,27806
1988-08-01,Nevada,804000,583438,553420,30018
1988-08-01,Ohio,8241000,5332602,5016905,315697
1988-08-01,Oklahoma,2383000,1520753,1424211,96542
1988-08-01,Oregon,2127000,1433303,1351812,81491
1988-08-01,Pennsylvania,9348000,5771235,5476555,294680
1988-08-01,Tennessee,3726000,2330569,2194178,136391
1988-08-01,Texas,12080000,8358965,7752107,606858
1988-08-01,Utah,1098000,760976,723908,37068
1988-08-01,Vermont,424000,299957,290936,9021
1988-08-01,Virginia,4492000,3093823,2969031,124792
1988-08-01,Washington,3487000,2345314,2198882,146432
1988-08-01,Wisconsin,3654000,2561626,2452581,109045
1988-08-01,Wyoming,345000,238937,223631,15306
1988-09-01,Alabama,3061000,1879024,1741612,137412
1988-09-01,Alaska,348000,252087,230369,21718
1988-09-01,Arizona,2583000,1680165,1570895,109270
1988-09-01,Arkansas,1786000,1109761,1024828,84933
1988-09-01,California,21079000,14221295,13471753,749542
1988-09-01,Colorado,2449000,1703488,1596865,106623
1988-09-01,Connecticut,2518000,1750061,1698713,51348
1988-09-01,Delaware,503000,351140,340222,10918
1988-09-01,Florida,9708000,6114922,5796572,318350
1988-09-01,Georgia,4650000,3164521,2991044,173477
1988-09-01,Hawaii,779000,519173,503171,16002
1988-09-01,Idaho,718000,483922,455066,28856
1988-09-01,Illinois,8800000,5867034,5481590,385444
1988-09-01,Indiana,4197000,2815059,2667875,147184
1988-09-01,Iowa,2151000,1496322,1428219,68103
1988-09-01,Kansas,1848000,1278876,1221446,57430
1988-09-01,Kentucky,2791000,1720362,1593550,126812
1988-09-01,Louisiana,3165000,1920916,1721625,199291
1988-09-01,Maine,918000,602794,579500,23294
1988-09-01,Maryland,3523000,2469388,2365533,103855
1988-09-01,Massachusetts,4616000,3161930,3054748,107182
1988-09-01,Michigan,6973000,4564186,4229523,334663
1988-09-01,Minnesota,3249000,2321724,2221100,100624
1988-09-01,Mississippi,1887000,1145857,1046489,99368
1988-09-01,Missouri,3902000,2605041,2453903,151138
1988-09-01,Montana,596000,405180,379024,26156
1988-09-01,Nebraska,1191000,818940,791585,27355
1988-09-01,Nevada,808000,585521,555881,29640
1988-09-01,Ohio,8243000,5342334,5027289,315045
1988-09-01,Oklahoma,2384000,1522631,1425995,96636
1988-09-01,Oregon,2130000,1438831,1358466,80365
1988-09-01,Pennsylvania,9350000,5782752,5489204,293548
1988-09-01,Tennessee,3728000,2331856,2195197,136659
1988-09-01,Texas,12093000,8372425,7767712,604713
1988-09-01,Utah,1099000,762998,726254,36744
1988-09-01,Vermont,424000,300435,291155,9280
1988-09-01,Virginia,4497000,3097389,2972115,125274
1988-09-01,Washington,3494000,2354391,2209311,145080
1988-09-01,Wisconsin,3655000,2568988,2460629,108359
1988-09-01,Wyoming,345000,238972,223594,15378
1988-10-01,Alabama,3062000,1883380,1745275,138105
1988-10-01,Alaska,348000,252662,231235,21427
1988-10-01,Arizona,2587000,1687274,1579328,107946
1988-10-01,Arkansas,1787000,1111288,1027017,84271
1988-10-01,California,21119000,14257687,13511723,745964
1988-10-01,Colorado,2450000,1700219,1595574,104645
1988-10-01,Connecticut,2518000,1751502,1699638,51864
1988-10-01,Delaware,503000,351831,340801,11030
1988-10-01,Florida,9727000,6134982,5812344,322638
1988-10-01,Georgia,4655000,3169997,2996866,173131
1988-10-01,Hawaii,780000,519809,503766,16043
1988-10-01,Idaho,718000,485522,456978,28544
1988-10-01,Illinois,8803000,5891251,5508962,382289
1988-10-01,Indiana,4199000,2825208,2678992,146216
1988-10-01,Iowa,2151000,1499779,1432299,67480
1988-10-01,Kansas,1849000,1280245,1222841,57404
1988-10-01,Kentucky,2792000,1722851,1598075,124776
1988-10-01,Louisiana,3164000,1918722,1722578,196144
1988-10-01,Maine,919000,604314,581380,22934
1988-10-01,Maryland,3527000,2472769,2370628,102141
1988-10-01,Massachusetts,4616000,3166924,3058448,108476
1988-10-01,Michigan,6974000,4575011,4241855,333156
1988-10-01,Minnesota,3251000,2324678,2224177,100501
1988-10-01,Mississippi,1888000,1148775,1048802,99973
1988-10-01,Missouri,3903000,2608862,2457795,151067
1988-10-01,Montana,596000,405492,379876,25616
1988-10-01,Nebraska,1191000,818876,792144,26732
1988-10-01,Nevada,811000,587521,558297,29224
1988-10-01,Ohio,8245000,5353991,5041177,312814
1988-10-01,Oklahoma,2384000,1524409,1428305,96104
1988-10-01,Oregon,2133000,1445019,1365649,79370
1988-10-01,Pennsylvania,9351000,5792679,5502214,290465
1988-10-01,Tennessee,3731000,2333709,2197831,135878
1988-10-01,Texas,12106000,8385011,7783217,601794
1988-10-01,Utah,1100000,765060,728795,36265
1988-10-01,Vermont,425000,300932,291477,9455
1988-10-01,Virginia,4502000,3100000,2975416,124584
1988-10-01,Washington,3500000,2362972,2219607,143365
1988-10-01,Wisconsin,3657000,2575719,2468212,107507
1988-10-01,Wyoming,345000,238952,223575,15377
1988-11-01,Alabama,3064000,1886984,1748902,138082
1988-11-01,Alaska,348000,252998,232041,20957
1988-11-01,Arizona,2591000,1692780,1587076,105704
1988-11-01,Arkansas,1787000,1113069,1029600,83469
1988-11-01,California,21159000,14292441,13552984,739457
1988-11-01,Colorado,2451000,1696923,1594600,102323
1988-11-01,Connecticut,2518000,1753191,1700858,52333
1988-11-01,Delaware,504000,352490,341535,10955
1988-11-01,Florida,9747000,6153178,5826739,326439
1988-11-01,Georgia,4661000,3174815,3002200,172615
1988-11-01,Hawaii,781000,520538,504696,15842
1988-11-01,Idaho,719000,486917,458764,28153
1988-11-01,Illinois,8807000,5915629,5538628,377001
1988-11-01,Indiana,4201000,2833444,2690261,143183
1988-11-01,Iowa,2151000,1503035,1436378,66657
1988-11-01,Kansas,1849000,1281072,1224005,57067
1988-11-01,Kentucky,2792000,1724797,1602758,122039
1988-11-01,Louisiana,3163000,1916068,1723774,192294
1988-11-01,Maine,920000,605227,583084,22143
1988-11-01,Maryland,3530000,2475719,2376087,99632
1988-11-01,Massachusetts,4616000,3171461,3061892,109569
1988-11-01,Michigan,6976000,4582763,4254278,328485
1988-11-01,Minnesota,3253000,2326765,2227013,99752
1988-11-01,Mississippi,1889000,1151050,1051322,99728
1988-11-01,Missouri,3904000,2612271,2461518,150753
1988-11-01,Montana,596000,405515,380424,25091
1988-11-01,Nebraska,1191000,818501,792492,26009
1988-11-01,Nevada,815000,589420,560608,28812
1988-11-01,Ohio,8247000,5366645,5058986,307659
1988-11-01,Oklahoma,2384000,1525457,1430481,94976
1988-11-01,Oregon,2136000,1451382,1372573,78809
1988-11-01,Pennsylvania,9353000,5801803,5515997,285806
1988-11-01,Tennessee,3733000,2336138,2202281,133857
1988-11-01,Texas,12119000,8395939,7798516,597423
1988-11-01,Utah,1101000,767219,731446,35773
1988-11-01,Vermont,425000,301555,291992,9563
1988-11-01,Virginia,4507000,3102195,2979155,123040
1988-11-01,Washington,3507000,2371171,2229482,141689
1988-11-01,Wisconsin,3658000,2581604,2475041,106563
1988-11-01,Wyoming,345000,238869,223600,15269
1988-12-01,Alabama,3065000,1889429,1752163,137266
1988-12-01,Alaska,348000,253180,232884,20296
1988-12-01,Arizona,2594000,1696837,1594249,102588
1988-12-01,Arkansas,1788000,1114945,1032322,82623
1988-12-01,California,21199000,14324937,13593580,731357
1988-12-01,Colorado,2452000,1694153,1594226,99927
1988-12-01,Connecticut,2517000,1755055,1702200,52855
1988-12-01,Delaware,505000,353229,342475,10754
1988-12-01,Florida,9766000,6168308,5838786,329522
1988-12-01,Georgia,4666000,3178610,3006807,171803
1988-12-01,Hawaii,782000,521386,506025,15361
1988-12-01,Idaho,720000,488080,460354,27726
1988-12-01,Illinois,8810000,5938284,5568427,369857
1988-12-01,Indiana,4203000,2839361,2700804,138557
1988-12-01,Iowa,2152000,1505250,1439606,65644
1988-12-01,Kansas,1850000,1281304,1225000,56304
1988-12-01,Kentucky,2793000,1726045,1607039,119006
1988-12-01,Louisiana,3162000,1913043,1725301,187742
1988-12-01,Maine,921000,605614,584409,21205
1988-12-01,Maryland,3534000,2478550,2381555,96995
1988-12-01,Massachusetts,4616000,3175218,3064570,110648
1988-12-01,Michigan,6977000,4586562,4265488,321074
1988-12-01,Minnesota,3255000,2328119,2229353,98766
1988-12-01,Mississippi,1889000,1152532,1053725,98807
1988-12-01,Missouri,3905000,2614851,2465032,149819
1988-12-01,Montana,596000,405328,380673,24655
1988-12-01,Nebraska,1192000,817917,792668,25249
1988-12-01,Nevada,818000,591235,562792,28443
1988-12-01,Ohio,8249000,5377992,5077815,300177
1988-12-01,Oklahoma,2384000,1525435,1432009,93426
1988-12-01,Oregon,2139000,1457273,1378581,78692
1988-12-01,Pennsylvania,9355000,5810596,5529839,280757
1988-12-01,Tennessee,3736000,2338864,2208144,130720
1988-12-01,Texas,12132000,8404314,7812770,591544
1988-12-01,Utah,1102000,769583,734158,35425
1988-12-01,Vermont,426000,302301,292652,9649
1988-12-01,Virginia,4512000,3104715,2983622,121093
1988-12-01,Washington,3513000,2379258,2238750,140508
1988-12-01,Wisconsin,3660000,2586411,2480464,105947
1988-12-01,Wyoming,345000,238744,223681,15063
1989-01-01,Alabama,3066000,1891022,1755003,136019
1989-01-01,Alaska,349000,253357,233861,19496
1989-01-01,Arizona,2598000,1699795,1600875,98920
1989-01-01,Arkansas,1788000,1116875,1035014,81861
1989-01-01,California,21238000,14356113,13632369,723744
1989-01-01,Colorado,2454000,1692383,1594520,97863
1989-01-01,Connecticut,2517000,1756918,1703366,53552
1989-01-01,Delaware,506000,354064,343512,10552
1989-01-01,Florida,9785000,6180938,5848615,332323
1989-01-01,Georgia,4671000,3182025,3010920,171105
1989-01-01,Hawaii,783000,522450,507785,14665
1989-01-01,Idaho,721000,488993,461673,27320
1989-01-01,Illinois,8813000,5958858,5596611,362247
1989-01-01,Indiana,4205000,2843716,2710363,133353
1989-01-01,Iowa,2152000,1506117,1441574,64543
1989-01-01,Kansas,1850000,1281114,1225840,55274
1989-01-01,Kentucky,2793000,1726989,1610788,116201
1989-01-01,Louisiana,3161000,1910152,1727541,182611
1989-01-01,Maine,922000,605774,585333,20441
1989-01-01,Maryland,3537000,2481695,2386786,94909
1989-01-01,Massachusetts,4617000,3178108,3066113,111995
1989-01-01,Michigan,6978000,4587543,4274317,313226
1989-01-01,Minnesota,3257000,2329392,2231408,97984
1989-01-01,Mississippi,1890000,1153629,1056095,97534
1989-01-01,Missouri,3905000,2616503,2468280,148223
1989-01-01,Montana,596000,405081,380727,24354
1989-01-01,Nebraska,1192000,817197,792625,24572
1989-01-01,Nevada,821000,593002,564854,28148
1989-01-01,Ohio,8250000,5387514,5095039,292475
1989-01-01,Oklahoma,2385000,1524651,1432884,91767
1989-01-01,Oregon,2142000,1462273,1383486,78787
1989-01-01,Pennsylvania,9357000,5819921,5543393,276528
1989-01-01,Tennessee,3738000,2341852,2215009,126843
1989-01-01,Texas,12144000,8409874,7825605,584269
1989-01-01,Utah,1103000,772214,736891,35323
1989-01-01,Vermont,426000,303105,293355,9750
1989-01-01,Virginia,4517000,3108323,2988944,119379
1989-01-01,Washington,3519000,2387905,2247839,140066
1989-01-01,Wisconsin,3661000,2590307,2484320,105987
1989-01-01,Wyoming,345000,238642,223803,14839
1989-02-01,Alabama,3067000,1892378,1757381,134997
1989-02-01,Alaska,349000,253659,234931,18728
1989-02-01,Arizona,2602000,1702033,1606490,95543
1989-02-01,Arkansas,1789000,1118612,1037209,81403
1989-02-01,California,21278000,14386737,13666952,719785
1989-02-01,Colorado,2455000,1691828,1595309,96519
1989-02-01,Connecticut,2517000,1758627,1704046,54581
1989-02-01,Delaware,506000,354880,344357,10523
1989-02-01,Florida,9804000,6192387,5856699,335688
1989-02-01,Georgia,4676000,3185672,3014529,171143
1989-02-01,Hawaii,785000,523698,509780,13918
1989-02-01,Idaho,722000,489604,462582,27022
1989-02-01,Illinois,8817000,5976591,5620673,355918
1989-02-01,Indiana,4207000,2847585,2718598,128987
1989-02-01,Iowa,2152000,1505551,1441972,63579
1989-02-01,Kansas,1851000,1280632,1226337,54295
1989-02-01,Kentucky,2794000,1728290,1614090,114200
1989-02-01,Louisiana,3160000,1907557,1730204,177353
1989-02-01,Maine,923000,606009,585801,20208
1989-02-01,Maryland,3541000,2485435,2391452,93983
1989-02-01,Massachusetts,4617000,3180071,3066064,114007
1989-02-01,Michigan,6979000,4587099,4279202,307897
1989-02-01,Minnesota,3259000,2330890,2233040,97850
1989-02-01,Mississippi,1891000,1154893,1058609,96284
1989-02-01,Missouri,3906000,2617447,2470956,146491
1989-02-01,Montana,596000,404995,380772,24223
1989-02-01,Nebraska,1192000,816379,792254,24125
1989-02-01,Nevada,825000,594693,566706,27987
1989-02-01,Ohio,8252000,5394658,5107383,287275
1989-02-01,Oklahoma,2385000,1523694,1433324,90370
1989-02-01,Oregon,2146000,1466204,1387149,79055
1989-02-01,Pennsylvania,9358000,5829195,5554746,274449
1989-02-01,Tennessee,3741000,2344833,2221779,123054
1989-02-01,Texas,12157000,8413285,7835551,577734
1989-02-01,Utah,1105000,774962,739474,35488
1989-02-01,Vermont,427000,303840,293941,9899
1989-02-01,Virginia,4523000,3113388,2994836,118552
1989-02-01,Washington,3526000,2397426,2256863,140563
1989-02-01,Wisconsin,3663000,2593313,2486313,107000
1989-02-01,Wyoming,344000,238572,223887,14685
1989-03-01,Alabama,3068000,1893970,1759554,134416
1989-03-01,Alaska,349000,254223,236133,18090
1989-03-01,Arizona,2605000,1704235,1611303,92932
1989-03-01,Arkansas,1789000,1119912,1038803,81109
1989-03-01,California,21318000,14417513,13697894,719619
1989-03-01,Colorado,2456000,1692882,1597117,95765
1989-03-01,Connecticut,2516000,1760292,1704345,55947
1989-03-01,Delaware,507000,355656,344914,10742
1989-03-01,Florida,9823000,6204360,5865039,339321
1989-03-01,Georgia,4681000,3189788,3017976,171812
1989-03-01,Hawaii,786000,525073,511856,13217
1989-03-01,Idaho,723000,489883,463044,26839
1989-03-01,Illinois,8820000,5989473,5638351,351122
1989-03-01,Indiana,4209000,2851806,2725571,126235
1989-03-01,Iowa,2153000,1504388,1441386,63002
1989-03-01,Kansas,1852000,1279952,1226503,53449
1989-03-01,Kentucky,2795000,1730323,1617377,112946
1989-03-01,Louisiana,3159000,1904882,1733146,171736
1989-03-01,Maine,924000,606634,585982,20652
1989-03-01,Maryland,3544000,2489823,2395756,94067
1989-03-01,Massachusetts,4617000,3181981,3065188,116793
1989-03-01,Michigan,6980000,4586574,4280656,305918
1989-03-01,Minnesota,3261000,2332812,2234441,98371
1989-03-01,Mississippi,1891000,1156594,1061539,95055
1989-03-01,Missouri,3907000,2618120,2473317,144803
1989-03-01,Montana,596000,405328,381124,24204
1989-03-01,Nebraska,1193000,815630,791727,23903
1989-03-01,Nevada,828000,596348,568455,27893
1989-03-01,Ohio,8254000,5399353,5114179,285174
1989-03-01,Oklahoma,2385000,1523368,1434114,89254
1989-03-01,Oregon,2149000,1469227,1389860,79367
1989-03-01,Pennsylvania,9360000,5836722,5562158,274564
1989-03-01,Tennessee,3744000,2347725,2227705,120020
1989-03-01,Texas,12170000,8417010,7843835,573175
1989-03-01,Utah,1106000,777746,741986,35760
1989-03-01,Vermont,428000,304441,294326,10115
1989-03-01,Virginia,4528000,3119900,3001310,118590
1989-03-01,Washington,3532000,2408187,2266387,141800
1989-03-01,Wisconsin,3664000,2595502,2486755,108747
1989-03-01,Wyoming,344000,238542,223921,14621
1989-04-01,Alabama,3069000,1895717,1761463,134254
1989-04-01,Alaska,349000,255196,237522,17674
1989-04-01,Arizona,2609000,1706577,1615174,91403
1989-04-01,Arkansas,1790000,1120815,1040060,80755
1989-04-01,California,21358000,14448840,13726087,722753
1989-04-01,Colorado,2457000,1695652,1600308,95344
1989-04-01,Connecticut,2516000,1761838,1704209,57629
1989-04-01,Delaware,508000,356430,345300,11130
1989-04-01,Florida,9842000,6217727,5874959,342768
1989-04-01,Georgia,4686000,3194262,3021497,172765
1989-04-01,Hawaii,787000,526501,513817,12684
1989-04-01,Idaho,723000,489833,463101,26732
1989-04-01,Illinois,8824000,5997211,5648894,348317
1989-04-01,Indiana,4211000,2856232,2730739,125493
1989-04-01,Iowa,2153000,1503246,1440221,63025
1989-04-01,Kansas,1852000,1279161,1226380,52781
1989-04-01,Kentucky,2795000,1732902,1620543,112359
1989-04-01,Louisiana,3158000,1901726,1736212,165514
1989-04-01,Maine,925000,607909,586200,21709
1989-04-01,Maryland,3548000,2494564,2399920,94644
1989-04-01,Massachusetts,4617000,3183970,3063602,120368
1989-04-01,Michigan,6981000,4587304,4279912,307392
1989-04-01,Minnesota,3263000,2335221,2235852,99369
1989-04-01,Mississippi,1892000,1158654,1064804,93850
1989-04-01,Missouri,3908000,2619137,2475628,143509
1989-04-01,Montana,596000,406078,381839,24239
1989-04-01,Nebraska,1193000,815072,791251,23821
1989-04-01,Nevada,832000,597962,570166,27796
1989-04-01,Ohio,8256000,5402078,5116608,285470
1989-04-01,Oklahoma,2385000,1524016,1435514,88502
1989-04-01,Oregon,2152000,1471422,1391974,79448
1989-04-01,Pennsylvania,9362000,5841330,5564859,276471
1989-04-01,Tennessee,3746000,2351329,2233210,118119
1989-04-01,Texas,12183000,8422596,7851985,570611
1989-04-01,Utah,1107000,780445,744462,35983
1989-04-01,Vermont,428000,304852,294447,10405
1989-04-01,Virginia,4533000,3127076,3007940,119136
1989-04-01,Washington,3539000,2420132,2276813,143319
1989-04-01,Wisconsin,3666000,2596902,2486091,110811
1989-04-01,Wyoming,344000,238539,223901,14638
1989-05-01,Alabama,3071000,1897363,1762934,134429
1989-05-01,Alaska,350000,256450,238903,17547
1989-05-01,Arizona,2613000,1708660,1617923,90737
1989-05-01,Arkansas,1790000,1121600,1041341,80259
1989-05-01,California,21398000,14481655,13752764,728891
1989-05-01,Colorado,2459000,1699846,1604618,95228
1989-05-01,Connecticut,2516000,1763219,1703563,59656
1989-05-01,Delaware,509000,357204,345598,11606
1989-05-01,Florida,9862000,6232259,5886150,346109
1989-05-01,Georgia,4692000,3199052,3025249,173803
1989-05-01,Hawaii,788000,527910,515504,12406
1989-05-01,Idaho,724000,489641,462958,26683
1989-05-01,Illinois,8827000,6001708,5653094,348614
1989-05-01,Indiana,4213000,2859952,2733020,126932
1989-05-01,Iowa,2153000,1502281,1438640,63641
1989-05-01,Kansas,1853000,1278549,1226046,52503
1989-05-01,Kentucky,2796000,1735582,1623357,112225
1989-05-01,Louisiana,3157000,1897694,1738950,158744
1989-05-01,Maine,926000,609733,586581,23152
1989-05-01,Maryland,3551000,2499396,2404031,95365
1989-05-01,Massachusetts,4618000,3185281,3060514,124767
1989-05-01,Michigan,6983000,4590951,4278022,312929
1989-05-01,Minnesota,3265000,2337883,2237270,100613
1989-05-01,Mississippi,1893000,1160754,1068098,92656
1989-05-01,Missouri,3909000,2620936,2477957,142979
1989-05-01,Montana,596000,407070,382761,24309
1989-05-01,Nebraska,1193000,814777,790966,23811
1989-05-01,Nevada,835000,599593,571843,27750
1989-05-01,Ohio,8258000,5404198,5116175,288023
1989-05-01,Oklahoma,2386000,1525169,1437084,88085
1989-05-01,Oregon,2155000,1472655,1393465,79190
1989-05-01,Pennsylvania,9364000,5842841,5563329,279512
1989-05-01,Tennessee,3749000,2356358,2238804,117554
1989-05-01,Texas,12196000,8430701,7861047,569654
1989-05-01,Utah,1108000,783026,746876,36150
1989-05-01,Vermont,429000,305057,294306,10751
1989-05-01,Virginia,4538000,3134119,3014108,120011
1989-05-01,Washington,3545000,2432650,2287756,144894
1989-05-01,Wisconsin,3667000,2597550,2484765,112785
1989-05-01,Wyoming,344000,238570,223858,14712
1989-06-01,Alabama,3072000,1898894,1764236,134658
1989-06-01,Alaska,350000,257816,240164,17652
1989-06-01,Arizona,2616000,1710315,1620037,90278
1989-06-01,Arkansas,1791000,1122517,1042874,79643
1989-06-01,California,21438000,14516703,13780211,736492
1989-06-01,Colorado,2460000,1705328,1609980,95348
1989-06-01,Connecticut,2515000,1764733,1702738,61995
1989-06-01,Delaware,509000,357963,345888,12075
1989-06-01,Florida,9881000,6247292,5897818,349474
1989-06-01,Georgia,4697000,3204288,3029467,174821
1989-06-01,Hawaii,789000,529313,516976,12337
1989-06-01,Idaho,725000,489572,462853,26719
1989-06-01,Illinois,8831000,6004324,5652213,352111
1989-06-01,Indiana,4215000,2862016,2731832,130184
1989-06-01,Iowa,2154000,1501717,1437050,64667
1989-06-01,Kansas,1853000,1278249,1225646,52603
1989-06-01,Kentucky,2796000,1738263,1626195,112068
1989-06-01,Louisiana,3156000,1892844,1741096,151748
1989-06-01,Maine,927000,611720,587048,24672
1989-06-01,Maryland,3555000,2504323,2408397,95926
1989-06-01,Massachusetts,4618000,3185761,3055851,129910
1989-06-01,Michigan,6984000,4597980,4275970,322010
1989-06-01,Minnesota,3267000,2340342,2238646,101696
1989-06-01,Mississippi,1893000,1162671,1071139,91532
1989-06-01,Missouri,3910000,2623738,2480413,143325
1989-06-01,Montana,596000,408033,383628,24405
1989-06-01,Nebraska,1194000,814725,790941,23784
1989-06-01,Nevada,839000,601382,573559,27823
1989-06-01,Ohio,8260000,5407380,5114446,292934
1989-06-01,Oklahoma,2386000,1526345,1438531,87814
1989-06-01,Oregon,2158000,1472737,1393868,78869
1989-06-01,Pennsylvania,9365000,5842026,5559332,282694
1989-06-01,Tennessee,3751000,2362412,2244212,118200
1989-06-01,Texas,12209000,8441607,7871656,569951
1989-06-01,Utah,1109000,785609,749314,36295
1989-06-01,Vermont,429000,305106,293996,11110
1989-06-01,Virginia,4543000,3140900,3019752,121148
1989-06-01,Washington,3552000,2445164,2298565,146599
1989-06-01,Wisconsin,3669000,2597587,2483272,114315
1989-06-01,Wyoming,344000,238631,223837,14794
1989-07-01,Alabama,3073000,1900380,1765871,134509
1989-07-01,Alaska,350000,258990,241115,17875
1989-07-01,Arizona,2620000,1710951,1621630,89321
1989-07-01,Arkansas,1791000,1123648,1044615,79033
1989-07-01,California,21478000,14552475,13808739,743736
1989-07-01,Colorado,2461000,1711472,1615715,95757
1989-07-01,Connecticut,2515000,1766654,1702141,64513
1989-07-01,Delaware,510000,358698,346288,12410
1989-07-01,Florida,9900000,6261944,5909044,352900
1989-07-01,Georgia,4702000,3209493,3033962,175531
1989-07-01,Hawaii,790000,530730,518340,12390
1989-07-01,Idaho,726000,489653,462829,26824
1989-07-01,Illinois,8834000,6005909,5647699,358210
1989-07-01,Indiana,4217000,2861316,2727012,134304
1989-07-01,Iowa,2154000,1501549,1435785,65764
1989-07-01,Kansas,1854000,1278277,1225377,52900
1989-07-01,Kentucky,2797000,1741075,1629567,111508
1989-07-01,Louisiana,3155000,1887264,1742497,144767
1989-07-01,Maine,928000,613571,587581,25990
1989-07-01,Maryland,3558000,2509106,2413137,95969
1989-07-01,Massachusetts,4618000,3185620,3050104,135516
1989-07-01,Michigan,6985000,4607312,4274666,332646
1989-07-01,Minnesota,3269000,2341988,2239457,102531
1989-07-01,Mississippi,1894000,1164403,1073910,90493
1989-07-01,Missouri,3911000,2627234,2483037,144197
1989-07-01,Montana,596000,408715,384220,24495
1989-07-01,Nebraska,1194000,814892,791196,23696
1989-07-01,Nevada,842000,603308,575274,28034
1989-07-01,Ohio,8262000,5412077,5112592,299485
1989-07-01,Oklahoma,2386000,1527039,1439553,87486
1989-07-01,Oregon,2161000,1471420,1392713,78707
1989-07-01,Pennsylvania,9367000,5839951,5554070,285881
1989-07-01,Tennessee,3754000,2368353,2248828,119525
1989-07-01,Texas,12222000,8453832,7882961,570871
1989-07-01,Utah,1110000,788140,751705,36435
1989-07-01,Vermont,430000,305061,293629,11432
1989-07-01,Virginia,4548000,3147268,3024800,122468
1989-07-01,Washington,3558000,2457083,2308721,148362
1989-07-01,Wisconsin,3670000,2596740,2481922,114818
1989-07-01,Wyoming,344000,238692,223844,14848
1989-08-01,Alabama,3075000,1901655,1768107,133548
1989-08-01,Alaska,350000,259877,241725,18152
1989-08-01,Arizona,2624000,1710855,1623324,87531
1989-08-01,Arkansas,1791000,1124928,1046532,78396
1989-08-01,California,21518000,14588015,13838434,749581
1989-08-01,Colorado,2462000,1717822,1621585,96237
1989-08-01,Connecticut,2515000,1769482,1702455,67027
1989-08-01,Delaware,510000,359348,346780,12568
1989-08-01,Florida,9919000,6276539,5920511,356028
1989-08-01,Georgia,4708000,3214465,3038927,175538
1989-08-01,Hawaii,791000,532061,519549,12512
1989-08-01,Idaho,727000,490077,463140,26937
1989-08-01,Illinois,8837000,6006883,5641126,365757
1989-08-01,Indiana,4219000,2857658,2719427,138231
1989-08-01,Iowa,2154000,1501373,1434899,66474
1989-08-01,Kansas,1854000,1278594,1225408,53186
1989-08-01,Kentucky,2798000,1744147,1633675,110472
1989-08-01,Louisiana,3154000,1881067,1743257,137810
1989-08-01,Maine,929000,615300,588368,26932
1989-08-01,Maryland,3562000,2514057,2418281,95776
1989-08-01,Massachusetts,4618000,3185458,3044244,141214
1989-08-01,Michigan,6987000,4617923,4275156,342767
1989-08-01,Minnesota,3272000,2342902,2239818,103084
1989-08-01,Mississippi,1894000,1166173,1076586,89587
1989-08-01,Missouri,3912000,2630922,2485813,145109
1989-08-01,Montana,596000,409072,384574,24498
1989-08-01,Nebraska,1194000,815198,791685,23513
1989-08-01,Nevada,846000,605359,577058,28301
1989-08-01,Ohio,8264000,5416784,5109690,307094
1989-08-01,Oklahoma,2387000,1527171,1439813,87358
1989-08-01,Oregon,2164000,1469005,1390563,78442
1989-08-01,Pennsylvania,9369000,5837170,5548051,289119
1989-08-01,Tennessee,3756000,2373278,2252571,120707
1989-08-01,Texas,12235000,8465016,7895263,569753
1989-08-01,Utah,1112000,790682,754106,36576
1989-08-01,Vermont,431000,305000,293329,11671
1989-08-01,Virginia,4553000,3153218,3029329,123889
1989-08-01,Washington,3564000,2467738,2318297,149441
1989-08-01,Wisconsin,3671000,2595168,2480841,114327
1989-08-01,Wyoming,344000,238716,223910,14806
1989-09-01,Alabama,3076000,1902626,1770729,131897
1989-09-01,Alaska,351000,260673,242227,18446
1989-09-01,Arizona,2627000,1711858,1626433,85425
1989-09-01,Arkansas,1792000,1126203,1048509,77694
1989-09-01,California,21560000,14623371,13869342,754029
1989-09-01,Colorado,2463000,1723702,1627455,96247
1989-09-01,Connecticut,2515000,1773444,1704019,69425
1989-09-01,Delaware,511000,359811,347205,12606
1989-09-01,Florida,9939000,6292856,5934072,358784
1989-09-01,Georgia,4713000,3219865,3045079,174786
1989-09-01,Hawaii,793000,533259,520559,12700
1989-09-01,Idaho,728000,490919,463935,26984
1989-09-01,Illinois,8841000,6005885,5632711,373174
1989-09-01,Indiana,4222000,2852195,2710940,141255
1989-09-01,Iowa,2155000,1500904,1434381,66523
1989-09-01,Kansas,1855000,1279009,1225778,53231
1989-09-01,Kentucky,2798000,1747043,1637970,109073
1989-09-01,Louisiana,3153000,1874724,1743681,131043
1989-09-01,Maine,930000,616988,589495,27493
1989-09-01,Maryland,3566000,2519867,2424047,95820
1989-09-01,Massachusetts,4618000,3186361,3039550,146811
1989-09-01,Michigan,6988000,4628364,4276901,351463
1989-09-01,Minnesota,3274000,2344214,2240630,103584
1989-09-01,Mississippi,1895000,1168157,1079117,89040
1989-09-01,Missouri,3913000,2634426,2488556,145870
1989-09-01,Montana,597000,409118,384734,24384
1989-09-01,Nebraska,1195000,815554,792346,23208
1989-09-01,Nevada,849000,607523,579028,28495
1989-09-01,Ohio,8266000,5419176,5104283,314893
1989-09-01,Oklahoma,2387000,1526903,1439255,87648
1989-09-01,Oregon,2168000,1466670,1388654,78016
1989-09-01,Pennsylvania,9372000,5833777,5541384,292393
1989-09-01,Tennessee,3759000,2376437,2255175,121262
1989-09-01,Texas,12249000,8475013,7909572,565441
1989-09-01,Utah,1113000,793322,756635,36687
1989-09-01,Vermont,431000,304991,293184,11807
1989-09-01,Virginia,4558000,3159097,3033928,125169
1989-09-01,Washington,3571000,2476741,2327766,148975
1989-09-01,Wisconsin,3673000,2593356,2480080,113276
1989-09-01,Wyoming,344000,238657,224041,14616
1989-10-01,Alabama,3078000,1903733,1773474,130259
1989-10-01,Alaska,351000,261619,242917,18702
1989-10-01,Arizona,2631000,1715972,1632075,83897
1989-10-01,Arkansas,1793000,1127487,1050468,77019
1989-10-01,California,21602000,14660438,13902840,757598
1989-10-01,Colorado,2465000,1728862,1633331,95531
1989-10-01,Connecticut,2515000,1778549,1706883,71666
1989-10-01,Delaware,512000,360097,347501,12596
1989-10-01,Florida,9959000,6313591,5951987,361604
1989-10-01,Georgia,4719000,3226803,3053358,173445
1989-10-01,Hawaii,794000,534473,521513,12960
1989-10-01,Idaho,729000,492042,465120,26922
1989-10-01,Illinois,8845000,6001167,5622589,378578
1989-10-01,Indiana,4224000,2846888,2703868,143020
1989-10-01,Iowa,2156000,1500410,1434412,65998
1989-10-01,Kansas,1856000,1279594,1226638,52956
1989-10-01,Kentucky,2799000,1749662,1642295,107367
1989-10-01,Louisiana,3153000,1869153,1744225,124928
1989-10-01,Maine,931000,618760,590961,27799
1989-10-01,Maryland,3570000,2526962,2431036,95926
1989-10-01,Massachusetts,4619000,3189820,3037532,152288
1989-10-01,Michigan,6990000,4636961,4279218,357743
1989-10-01,Minnesota,3276000,2347591,2243082,104509
1989-10-01,Mississippi,1896000,1170412,1081501,88911
1989-10-01,Missouri,3914000,2637840,2491399,146441
1989-10-01,Montana,597000,409046,384871,24175
1989-10-01,Nebraska,1195000,815991,793251,22740
1989-10-01,Nevada,853000,609887,581315,28572
1989-10-01,Ohio,8269000,5418399,5096946,321453
1989-10-01,Oklahoma,2388000,1524568,1438685,85883
1989-10-01,Oregon,2171000,1465606,1388055,77551
1989-10-01,Pennsylvania,9374000,5831227,5535682,295545
1989-10-01,Tennessee,3762000,2378099,2257080,121019
1989-10-01,Texas,12263000,8486028,7927096,558932
1989-10-01,Utah,1114000,796190,759456,36734
1989-10-01,Vermont,432000,305138,293246,11892
1989-10-01,Virginia,4564000,3165957,3039980,125977
1989-10-01,Washington,3577000,2484793,2337860,146933
1989-10-01,Wisconsin,3675000,2591952,2479924,112028
1989-10-01,Wyoming,344000,238530,224248,14282
1989-11-01,Alabama,3079000,1905242,1776188,129054
1989-11-01,Alaska,351000,262826,243918,18908
1989-11-01,Arizona,2635000,1723855,1640218,83637
1989-11-01,Arkansas,1793000,1128613,1052155,76458
1989-11-01,California,21642000,14698650,13937435,761215
1989-11-01,Colorado,2466000,1733611,1639323,94288
1989-11-01,Connecticut,2515000,1784598,1710802,73796
1989-11-01,Delaware,513000,360210,347620,12590
1989-11-01,Florida,9979000,6339241,5974359,364882
1989-11-01,Georgia,4724000,3235452,3063764,171688
1989-11-01,Hawaii,795000,535902,522604,13298
1989-11-01,Idaho,730000,493231,466458,26773
1989-11-01,Illinois,8849000,5992024,5611251,380773
1989-11-01,Indiana,4226000,2842480,2698713,143767
1989-11-01,Iowa,2156000,1499985,1434826,65159
1989-11-01,Kansas,1856000,1280421,1227924,52497
1989-11-01,Kentucky,2800000,1751956,1646454,105502
1989-11-01,Louisiana,3152000,1864719,1744886,119833
1989-11-01,Maine,932000,620672,592699,27973
1989-11-01,Maryland,3573000,2534991,2439240,95751
1989-11-01,Massachusetts,4619000,3196202,3038410,157792
1989-11-01,Michigan,6991000,4641427,4280811,360616
1989-11-01,Minnesota,3278000,2353418,2247556,105862
1989-11-01,Mississippi,1897000,1172875,1083855,89020
1989-11-01,Missouri,3915000,2641183,2494316,146867
1989-11-01,Montana,597000,409017,385126,23891
1989-11-01,Nebraska,1195000,816500,794368,22132
1989-11-01,Nevada,856000,612464,583921,28543
1989-11-01,Ohio,8271000,5414391,5089176,325215
1989-11-01,Oklahoma,2388000,1523020,1438658,84362
1989-11-01,Oregon,2174000,1466084,1389195,76889
1989-11-01,Pennsylvania,9376000,5829657,5531446,298211
1989-11-01,Tennessee,3764000,2378960,2258899,120061
1989-11-01,Texas,12276000,8498491,7947231,551260
1989-11-01,Utah,1115000,799257,762581,36676
1989-11-01,Vermont,433000,305471,293504,11967
1989-11-01,Virginia,4569000,3173889,3047749,126140
1989-11-01,Washington,3584000,2492278,2348633,143645
1989-11-01,Wisconsin,3677000,2591183,2480340,110843
1989-11-01,Wyoming,344000,238378,224512,13866
1989-12-01,Alabama,3080000,1907341,1778818,128523
1989-12-01,Alaska,351000,264244,245147,19097
1989-12-01,Arizona,2638000,1734832,1649714,85118
1989-12-01,Arkansas,1794000,1129488,1053413,76075
1989-12-01,California,21680000,14737257,13970785,766472
1989-12-01,Colorado,2467000,1738508,1645628,92880
1989-12-01,Connecticut,2514000,1791371,1715402,75969
1989-12-01,Delaware,513000,360192,347569,12623
1989-12-01,Florida,9997000,6369137,6000382,368755
1989-12-01,Georgia,4729000,3245559,3075652,169907
1989-12-01,Hawaii,796000,537755,524037,13718
1989-12-01,Idaho,730000,494171,467578,26593
1989-12-01,Illinois,8851000,5979489,5599825,379664
1989-12-01,Indiana,4228000,2838748,2694784,143964
1989-12-01,Iowa,2156000,1499813,1435501,64312
1989-12-01,Kansas,1856000,1281647,1229616,52031
1989-12-01,Kentucky,2800000,1753897,1650206,103691
1989-12-01,Louisiana,3150000,1861462,1745656,115806
1989-12-01,Maine,933000,622737,594655,28082
1989-12-01,Maryland,3577000,2543411,2448181,95230
1989-12-01,Massachusetts,4619000,3205451,3041795,163656
1989-12-01,Michigan,6992000,4641207,4280846,360361
1989-12-01,Minnesota,3280000,2361045,2253765,107280
1989-12-01,Mississippi,1897000,1175408,1086317,89091
1989-12-01,Missouri,3916000,2644674,2497494,147180
1989-12-01,Montana,597000,409137,385544,23593
1989-12-01,Nebraska,1195000,817254,795751,21503
1989-12-01,Nevada,859000,615166,586696,28470
1989-12-01,Ohio,8272000,5408992,5083408,325584
1989-12-01,Oklahoma,2388000,1522342,1439268,83074
1989-12-01,Oregon,2177000,1468318,1392294,76024
1989-12-01,Pennsylvania,9377000,5829118,5528896,300222
1989-12-01,Tennessee,3767000,2380666,2261439,119227
1989-12-01,Texas,12288000,8513571,7969062,544509
1989-12-01,Utah,1116000,802383,765847,36536
1989-12-01,Vermont,433000,306007,293907,12100
1989-12-01,Virginia,4574000,3182454,3056600,125854
1989-12-01,Washington,3590000,2499456,2359568,139888
1989-12-01,Wisconsin,3678000,2591039,2481325,109714
1989-12-01,Wyoming,343000,238217,224780,13437
1990-01-01,Alabama,3038768,1909599,1781120,128479
1990-01-01,Alaska,373447,265735,246470,19265
1990-01-01,Arizona,2760367,1747599,1659536,88063
1990-01-01,Arkansas,1764477,1129973,1054176,75797
1990-01-01,California,22570807,15008860,14235508,773352
1990-01-01,Colorado,2485722,1743987,1652439,91548
1990-01-01,Connecticut,2565499,1798461,1720309,78152
1990-01-01,Delaware,507890,360102,347450,12652
1990-01-01,Florida,10226482,6400373,6027651,372722
1990-01-01,Georgia,4828841,3256019,3087660,168359
1990-01-01,Hawaii,796692,540051,525886,14165
1990-01-01,Idaho,723300,494707,468290,26417
1990-01-01,Illinois,8626256,5964079,5588813,375266
1990-01-01,Indiana,4124937,2834492,2690690,143802
1990-01-01,Iowa,2077928,1460842,1397203,63639
1990-01-01,Kansas,1816636,1266936,1215349,51587
1990-01-01,Kentucky,2773133,1755235,1653028,102207
1990-01-01,Louisiana,3036885,1859188,1746514,112674
1990-01-01,Maine,932425,624966,596812,28154
1990-01-01,Maryland,3682846,2551416,2456861,94555
1990-01-01,Massachusetts,4698654,3216593,3046804,169789
1990-01-01,Michigan,6983323,4637317,4280060,357257
1990-01-01,Minnesota,3252901,2369206,2260850,108356
1990-01-01,Mississippi,1866450,1177427,1088697,88730
1990-01-01,Missouri,3836961,2605685,2458816,146869
1990-01-01,Montana,595182,409472,386126,23346
1990-01-01,Nebraska,1154685,818420,797556,20864
1990-01-01,Nevada,925103,642262,613848,28414
1990-01-01,Ohio,8167481,5404006,5081649,322357
1990-01-01,Oklahoma,2344080,1522315,1440437,81878
1990-01-01,Oregon,2183240,1472154,1396976,75178
1990-01-01,Pennsylvania,9160306,5828663,5527432,301231
1990-01-01,Tennessee,3732787,2384366,2265306,119060
1990-01-01,Texas,12560553,8531763,7991632,540131
1990-01-01,Utah,1137579,805442,769122,36320
1990-01-01,Vermont,425968,306678,294347,12331
1990-01-01,Virginia,4627910,3191089,3065731,125358
1990-01-01,Washington,3662087,2506313,2369921,136392
1990-01-01,Wisconsin,3667541,2591242,2482768,108474
1990-01-01,Wyoming,328885,238046,225026,13020
1990-02-01,Alabama,3045733,1911140,1782802,128338
1990-02-01,Alaska,372728,267112,247774,19338
1990-02-01,Arizona,2762292,1760380,1668977,91403
1990-02-01,Arkansas,1767783,1129960,1054480,75480
1990-02-01,California,22571608,15109627,14329179,780448
1990-02-01,Colorado,2484872,1749653,1659242,90411
1990-02-01,Connecticut,2567518,1805181,1725028,80153
1990-02-01,Delaware,508657,359934,347316,12618
1990-02-01,Florida,10228063,6428640,6052659,375981
1990-02-01,Georgia,4836665,3265666,3098473,167193
1990-02-01,Hawaii,799281,542568,528047,14521
1990-02-01,Idaho,723900,494843,468486,26357
1990-02-01,Illinois,8640004,5947575,5578886,368689
1990-02-01,Indiana,4137185,2828238,2685288,142950
1990-02-01,Iowa,2080050,1449267,1386100,63167
1990-02-01,Kansas,1818062,1264236,1213080,51156
1990-02-01,Kentucky,2778542,1755623,1654528,101095
1990-02-01,Louisiana,3044932,1857449,1747388,110061
1990-02-01,Maine,933974,627311,599069,28242
1990-02-01,Maryland,3683761,2558105,2464039,94066
1990-02-01,Massachusetts,4702832,3227108,3051394,175714
1990-02-01,Michigan,6989062,4631078,4279385,351693
1990-02-01,Minnesota,3256108,2376529,2267698,108831
1990-02-01,Mississippi,1872674,1178311,1090522,87789
1990-02-01,Missouri,3841940,2595723,2450290,145433
1990-02-01,Montana,595108,409913,386738,23175
1990-02-01,Nebraska,1156221,819866,799708,20158
1990-02-01,Nevada,926839,652283,623895,28388
1990-02-01,Ohio,8181026,5399878,5083752,316126
1990-02-01,Oklahoma,2344196,1522308,1441925,80383
1990-02-01,Oregon,2184235,1476657,1401983,74674
1990-02-01,Pennsylvania,9169848,5826827,5525736,301091
1990-02-01,Tennessee,3739096,2389486,2270073,119413
1990-02-01,Texas,12564976,8550665,8013387,537278
1990-02-01,Utah,1141565,808318,772284,36034
1990-02-01,Vermont,426722,307313,294685,12628
1990-02-01,Virginia,4632891,3198956,3074080,124876
1990-02-01,Washington,3662922,2512374,2378983,133391
1990-02-01,Wisconsin,3668543,2591342,2484287,107055
1990-02-01,Wyoming,328932,237854,225233,12621
1990-03-01,Alabama,3052698,1911528,1783545,127983
1990-03-01,Alaska,372009,268260,248922,19338
1990-03-01,Arizona,2764216,1771401,1677178,94223
1990-03-01,Arkansas,1771089,1129580,1054379,75201
1990-03-01,California,22572409,15151941,14363110,788831
1990-03-01,Colorado,2484023,1755031,1665204,89827
1990-03-01,Connecticut,2569537,1810832,1728838,81994
1990-03-01,Delaware,509424,359625,347069,12556
1990-03-01,Florida,10229645,6451272,6072162,379110
1990-03-01,Georgia,4844489,3274014,3107062,166952
1990-03-01,Hawaii,801869,544942,530232,14710
1990-03-01,Idaho,724500,494589,468091,26498
1990-03-01,Illinois,8653751,5933091,5570303,362788
1990-03-01,Indiana,4149433,2820000,2678289,141711
1990-03-01,Iowa,2082172,1446077,1383184,62893
1990-03-01,Kansas,1819488,1265253,1214265,50988
1990-03-01,Kentucky,2783951,1755183,1654728,100455
1990-03-01,Louisiana,3052979,1856384,1748271,108113
1990-03-01,Maine,935523,629526,601049,28477
1990-03-01,Maryland,3684675,2563241,2468739,94502
1990-03-01,Massachusetts,4707010,3234868,3053448,181420
1990-03-01,Michigan,6994801,4625015,4278969,346046
1990-03-01,Minnesota,3259315,2382267,2273454,108813
1990-03-01,Mississippi,1878898,1178069,1091404,86665
1990-03-01,Missouri,3846919,2593865,2450280,143585
1990-03-01,Montana,595034,410344,387227,23117
1990-03-01,Nebraska,1157757,821364,801834,19530
1990-03-01,Nevada,928575,657121,628630,28491
1990-03-01,Ohio,8194571,5397026,5087728,309298
1990-03-01,Oklahoma,2344311,1521883,1443179,78704
1990-03-01,Oregon,2185230,1481197,1406345,74852
1990-03-01,Pennsylvania,9179390,5822796,5522285,300511
1990-03-01,Tennessee,3745405,2394887,2274685,120202
1990-03-01,Texas,12569399,8567278,8031650,535628
1990-03-01,Utah,1145552,810912,775161,35751
1990-03-01,Vermont,427476,307752,294780,12972
1990-03-01,Virginia,4637872,3206094,3080893,125201
1990-03-01,Washington,3663757,2517368,2386249,131119
1990-03-01,Wisconsin,3669545,2591040,2485200,105840
1990-03-01,Wyoming,328979,237632,225369,12263
1990-04-01,Alabama,3060000,1910872,1783238,127634
1990-04-01,Alaska,371000,269066,249746,19320
1990-04-01,Arizona,2764000,1779887,1683981,95906
1990-04-01,Arkansas,1774000,1129115,1053985,75130
1990-04-01,California,22577000,15169764,14369259,800505
1990-04-01,Colorado,2482000,1760121,1670180,89941
1990-04-01,Connecticut,2571000,1815137,1731317,83820
1990-04-01,Delaware,510000,359162,346602,12560
1990-04-01,Florida,10226000,6467740,6084521,383219
1990-04-01,Georgia,4851000,3280853,3112776,168077
1990-04-01,Hawaii,804000,546897,532168,14729
1990-04-01,Idaho,725000,494015,467229,26786
1990-04-01,Illinois,8666000,5922268,5561919,360349
1990-04-01,Indiana,4161000,2811243,2670585,140658
1990-04-01,Iowa,2084000,1445850,1383037,62813
1990-04-01,Kansas,1821000,1267363,1216101,51262
1990-04-01,Kentucky,2789000,1754246,1653927,100319
1990-04-01,Louisiana,3061000,1856352,1748984,107368
1990-04-01,Maine,937000,631243,602244,28999
1990-04-01,Maryland,3686000,2567353,2470826,96527
1990-04-01,Massachusetts,4710000,3239596,3052416,187180
1990-04-01,Michigan,7001000,4621206,4278850,342356
1990-04-01,Minnesota,3262000,2386493,2277786,108707
1990-04-01,Mississippi,1885000,1176984,1091266,85718
1990-04-01,Missouri,3851000,2594346,2451873,142473
1990-04-01,Montana,595000,410684,387485,23199
1990-04-01,Nebraska,1159000,822684,803565,19119
1990-04-01,Nevada,929000,660429,631615,28814
1990-04-01,Ohio,8208000,5395822,5091687,304135
1990-04-01,Oklahoma,2344000,1521911,1443804,78107
1990-04-01,Oregon,2186000,1485662,1409757,75905
1990-04-01,Pennsylvania,9187000,5816695,5516154,300541
1990-04-01,Tennessee,3751000,2399121,2277676,121445
1990-04-01,Texas,12573000,8580702,8044789,535913
1990-04-01,Utah,1149000,813271,777735,35536
1990-04-01,Vermont,428000,307911,294566,13345
1990-04-01,Virginia,4643000,3213185,3086094,127091
1990-04-01,Washington,3664000,2521116,2391593,129523
1990-04-01,Wisconsin,3670000,2590637,2485281,105356
1990-04-01,Wyoming,329000,237408,225418,11990
1990-05-01,Alabama,3066010,1909814,1782230,127584
1990-05-01,Alaska,370957,269625,250305,19320
1990-05-01,Arizona,2770919,1786096,1689842,96254
1990-05-01,Arkansas,1778059,1128863,1053507,75356
1990-05-01,California,22568458,15174935,14358647,816288
1990-05-01,Colorado,2483888,1765072,1674520,90552
1990-05-01,Connecticut,2574315,1818180,1732461,85719
1990-05-01,Delaware,511380,358669,346021,12648
1990-05-01,Florida,10239776,6479527,6091103,388424
1990-05-01,Georgia,4862054,3286481,3116133,170348
1990-05-01,Hawaii,807656,548491,533864,14627
1990-05-01,Idaho,726001,493280,466173,27107
1990-05-01,Illinois,8683245,5916293,5554026,362267
1990-05-01,Indiana,4174837,2803954,2664269,139685
1990-05-01,Iowa,2086641,1447358,1384407,62951
1990-05-01,Kansas,1822059,1269686,1217800,51886
1990-05-01,Kentucky,2795249,1753364,1652737,100627
1990-05-01,Louisiana,3069106,1857810,1749667,108143
1990-05-01,Maine,938884,632319,602475,29844
1990-05-01,Maryland,3686123,2571006,2470966,100040
1990-05-01,Massachusetts,4716950,3242226,3049087,193139
1990-05-01,Michigan,7005499,4619803,4278991,340812
1990-05-01,Minnesota,3266425,2390069,2281018,109051
1990-05-01,Mississippi,1891509,1175679,1090503,85176
1990-05-01,Missouri,3857908,2596069,2453212,142857
1990-05-01,Montana,594831,402017,378614,23403
1990-05-01,Nebraska,1161219,823736,804753,18983
1990-05-01,Nevada,933628,663374,634029,29345
1990-05-01,Ohio,8221647,5396533,5095058,301475
1990-05-01,Oklahoma,2344944,1519141,1443799,75342
1990-05-01,Oregon,2187352,1490277,1412564,77713
1990-05-01,Pennsylvania,9201050,5810056,5507873,302183
1990-05-01,Tennessee,3758975,2401363,2278317,123046
1990-05-01,Texas,12579007,8591857,8054096,537761
1990-05-01,Utah,1154242,815519,780144,35375
1990-05-01,Vermont,429122,307794,294090,13704
1990-05-01,Virginia,4647638,3220693,3090050,130643
1990-05-01,Washington,3666216,2523694,2395523,128171
1990-05-01,Wisconsin,3672277,2590772,2484967,105805
1990-05-01,Wyoming,329107,237222,225386,11836
1990-06-01,Alabama,3073813,1908682,1780728,127954
1990-06-01,Alaska,369948,270080,250708,19372
1990-06-01,Arizona,2770703,1790436,1694771,95665
1990-06-01,Arkansas,1781471,1128936,1053069,75867
1990-06-01,California,22574549,15171675,14334908,836767
1990-06-01,Colorado,2481865,1769754,1678476,91278
1990-06-01,Connecticut,2575778,1819982,1732236,87746
1990-06-01,Delaware,511456,358191,345326,12865
1990-06-01,Florida,10236131,6488482,6093728,394754
1990-06-01,Georgia,4868065,3291179,3118023,173156
1990-06-01,Hawaii,809787,549857,535357,14500
1990-06-01,Idaho,726001,492540,465183,27357
1990-06-01,Illinois,8695493,5914656,5547357,367299
1990-06-01,Indiana,4186404,2799101,2660324,138777
1990-06-01,Iowa,2088969,1449812,1386567,63245
1990-06-01,Kansas,1824071,1271856,1219086,52770
1990-06-01,Kentucky,2800299,1752757,1651196,101561
1990-06-01,Louisiana,3077128,1860476,1750196,110280
1990-06-01,Maine,939861,632795,601737,31058
1990-06-01,Maryland,3686948,2574397,2469588,104809
1990-06-01,Massachusetts,4719940,3242971,3043566,199405
1990-06-01,Michigan,7012199,4618903,4277488,341415
1990-06-01,Minnesota,3269110,2393729,2283668,110061
1990-06-01,Mississippi,1897611,1174685,1089409,85276
1990-06-01,Missouri,3862489,2598867,2453654,145213
1990-06-01,Montana,594798,399533,375833,23700
1990-06-01,Nebraska,1162463,824469,805408,19061
1990-06-01,Nevada,934554,666226,636174,30052
1990-06-01,Ohio,8235576,5398285,5097028,301257
1990-06-01,Oklahoma,2345133,1519418,1442864,76554
1990-06-01,Oregon,2188623,1495168,1415296,79872
1990-06-01,Pennsylvania,9208660,5804038,5497872,306166
1990-06-01,Tennessee,3764570,2401543,2276773,124770
1990-06-01,Texas,12583608,8601024,8060932,540092
1990-06-01,Utah,1157691,817611,782367,35244
1990-06-01,Vermont,430146,307452,293407,14045
1990-06-01,Virginia,4652766,3228407,3092875,135532
1990-06-01,Washington,3666459,2524990,2398257,126733
1990-06-01,Wisconsin,3672733,2591898,2484575,107323
1990-06-01,Wyoming,329129,237054,225265,11789
1990-07-01,Alabama,3080615,1908004,1779120,128884
1990-07-01,Alaska,368940,270657,251160,19497
1990-07-01,Arizona,2770487,1793879,1699054,94825
1990-07-01,Arkansas,1783882,1129432,1052819,76613
1990-07-01,California,22577641,15165403,14302549,862854
1990-07-01,Colorado,2479843,1774428,1682747,91681
1990-07-01,Connecticut,2577242,1821020,1731003,90017
1990-07-01,Delaware,512532,357709,344418,13291
1990-07-01,Florida,10232487,6497192,6094509,402683
1990-07-01,Georgia,4875076,3295706,3119394,176312
1990-07-01,Hawaii,811918,551195,536806,14389
1990-07-01,Idaho,727001,492139,464592,27547
1990-07-01,Illinois,8707742,5916503,5543253,373250
1990-07-01,Indiana,4197972,2797792,2659425,138367
1990-07-01,Iowa,2090297,1452717,1388974,63743
1990-07-01,Kansas,1825083,1273842,1220016,53826
1990-07-01,Kentucky,2805348,1752642,1649421,103221
1990-07-01,Louisiana,3085149,1864122,1750597,113525
1990-07-01,Maine,941838,632853,600196,32657
1990-07-01,Maryland,3688773,2577752,2467184,110568
1990-07-01,Massachusetts,4722930,3242506,3036188,206318
1990-07-01,Michigan,7017898,4617093,4272813,344280
1990-07-01,Minnesota,3271795,2398333,2286713,111620
1990-07-01,Mississippi,1903713,1174601,1088314,86287
1990-07-01,Missouri,3866071,2603009,2453326,149683
1990-07-01,Montana,594764,398906,374814,24092
1990-07-01,Nebraska,1163706,824987,805785,19202
1990-07-01,Nevada,934479,669162,638230,30932
1990-07-01,Ohio,8248506,5401920,5098550,303370
1990-07-01,Oklahoma,2344322,1519352,1440974,78378
1990-07-01,Oregon,2188893,1500356,1418341,82015
1990-07-01,Pennsylvania,9216270,5800458,5487972,312486
1990-07-01,Tennessee,3770166,2400673,2274113,126560
1990-07-01,Texas,12586209,8611478,8067965,543513
1990-07-01,Utah,1161139,819709,784525,35184
1990-07-01,Vermont,430171,307048,292610,14438
1990-07-01,Virginia,4657894,3236563,3095088,141475
1990-07-01,Washington,3666702,2525341,2399909,125432
1990-07-01,Wisconsin,3673188,2594571,2484695,109876
1990-07-01,Wyoming,329150,236920,225119,11801
1990-08-01,Alabama,3083417,1908217,1777844,130373
1990-08-01,Alaska,370931,271404,251753,19651
1990-08-01,Arizona,2777270,1796824,1702721,94103
1990-08-01,Arkansas,1785294,1130231,1052617,77614
1990-08-01,California,22594732,15158685,14264802,893883
1990-08-01,Colorado,2485820,1779014,1687432,91582
1990-08-01,Connecticut,2576705,1821616,1729053,92563
1990-08-01,Delaware,513609,357185,343342,13843
1990-08-01,Florida,10254842,6506195,6094027,412168
1990-08-01,Georgia,4883087,3300026,3120389,179637
1990-08-01,Hawaii,813049,552708,538446,14262
1990-08-01,Idaho,729001,492218,464434,27784
1990-08-01,Illinois,8712991,5920570,5542191,378379
1990-08-01,Indiana,4201539,2799745,2660886,138859
1990-08-01,Iowa,2091625,1455634,1391150,64484
1990-08-01,Kansas,1825095,1275592,1220628,54964
1990-08-01,Kentucky,2807398,1752941,1647468,105473
1990-08-01,Louisiana,3086170,1868633,1751042,117591
1990-08-01,Maine,941815,632761,598199,34562
1990-08-01,Maryland,3691597,2580624,2464203,116421
1990-08-01,Massachusetts,4719921,3240732,3026667,214065
1990-08-01,Michigan,7022598,4613031,4264309,348722
1990-08-01,Minnesota,3274480,2403735,2290396,113339
1990-08-01,Mississippi,1904815,1175648,1087486,88162
1990-08-01,Missouri,3868652,2608341,2452604,155737
1990-08-01,Montana,595730,398874,374285,24589
1990-08-01,Nebraska,1163950,825514,806164,19350
1990-08-01,Nevada,940405,672174,640205,31969
1990-08-01,Ohio,8253435,5407835,5100984,306851
1990-08-01,Oklahoma,2346510,1519286,1438400,80886
1990-08-01,Oregon,2194164,1504997,1421061,83936
1990-08-01,Pennsylvania,9219880,5800373,5479850,320523
1990-08-01,Tennessee,3774761,2399623,2271008,128615
1990-08-01,Texas,12605811,8624978,8075798,549180
1990-08-01,Utah,1164587,821867,786618,35249
1990-08-01,Vermont,430195,306688,291785,14903
1990-08-01,Virginia,4663021,3245232,3097319,147913
1990-08-01,Washington,3674946,2525486,2400407,125079
1990-08-01,Wisconsin,3677644,2598565,2485528,113037
1990-08-01,Wyoming,329172,236837,224972,11865
1990-09-01,Alabama,3087219,1909249,1777113,132136
1990-09-01,Alaska,371922,272074,252279,19795
1990-09-01,Arizona,2785054,1798189,1704785,93404
1990-09-01,Arkansas,1787706,1131052,1052207,78845
1990-09-01,California,22614824,15150606,14221998,928608
1990-09-01,Colorado,2490798,1783283,1691993,91290
1990-09-01,Connecticut,2576168,1821793,1726473,95320
1990-09-01,Delaware,513685,361928,342185,19743
1990-09-01,Florida,10279197,6512651,6090336,422315
1990-09-01,Georgia,4893098,3303135,3120330,182805
1990-09-01,Hawaii,814180,554493,540392,14101
1990-09-01,Idaho,731001,492729,464535,28194
1990-09-01,Illinois,8719240,5925124,5543548,381576
1990-09-01,Indiana,4206106,2802742,2662142,140600
1990-09-01,Iowa,2092953,1457887,1392448,65439
1990-09-01,Kansas,1826106,1277140,1220879,56261
1990-09-01,Kentucky,2809448,1753446,1645165,108281
1990-09-01,Louisiana,3088192,1873507,1751550,121957
1990-09-01,Maine,942791,632988,596198,36790
1990-09-01,Maryland,3694422,2582620,2460650,121970
1990-09-01,Massachusetts,4717911,3236268,3013745,222523
1990-09-01,Michigan,7029298,4606563,4252163,354400
1990-09-01,Minnesota,3278166,2408689,2293699,114990
1990-09-01,Mississippi,1905917,1177675,1087153,90522
1990-09-01,Missouri,3871234,2614058,2451739,162319
1990-09-01,Montana,595696,399073,373922,25151
1990-09-01,Nebraska,1165194,826284,806717,19567
1990-09-01,Nevada,946331,675063,641962,33101
1990-09-01,Ohio,8258364,5414247,5102932,311315
1990-09-01,Oklahoma,2348699,1519182,1435252,83930
1990-09-01,Oregon,2199434,1507875,1422594,85281
1990-09-01,Pennsylvania,9225490,5803411,5473307,330104
1990-09-01,Tennessee,3779356,2399079,2267637,131442
1990-09-01,Texas,12627412,8639220,8082803,556417
1990-09-01,Utah,1169036,823958,788463,35495
1990-09-01,Vermont,431219,306401,290962,15439
1990-09-01,Virginia,4668149,3253567,3099067,154500
1990-09-01,Washington,3684189,2525856,2399533,126323
1990-09-01,Wisconsin,3682099,2602993,2486384,116609
1990-09-01,Wyoming,330193,236784,224810,11974
1990-10-01,Alabama,3090021,1910838,1776913,133925
1990-10-01,Alaska,372914,272516,252526,19990
1990-10-01,Arizona,2792838,1797525,1704892,92633
1990-10-01,Arkansas,1789118,1131679,1051456,80223
1990-10-01,California,22634915,15141585,14174446,967139
1990-10-01,Colorado,2496775,1786978,1695885,91093
1990-10-01,Connecticut,2576631,1821843,1723558,98285
1990-10-01,Delaware,514761,362964,341085,21879
1990-10-01,Florida,10303552,6513762,6081503,432259
1990-10-01,Georgia,4903109,3304687,3119005,185682
1990-10-01,Hawaii,815312,556475,542488,13987
1990-10-01,Idaho,734001,493791,464896,28895
1990-10-01,Illinois,8725489,5929209,5545918,383291
1990-10-01,Indiana,4210674,2805202,2660690,144512
1990-10-01,Iowa,2094281,1459038,1392418,66620
1990-10-01,Kansas,1827118,1278517,1220801,57716
1990-10-01,Kentucky,2812498,1754153,1642183,111970
1990-10-01,Louisiana,3089213,1878203,1752042,126161
1990-10-01,Maine,942768,634042,594571,39471
1990-10-01,Maryland,3698247,2584403,2456531,127872
1990-10-01,Massachusetts,4716901,3228460,2996817,231643
1990-10-01,Michigan,7034998,4600120,4237334,362786
1990-10-01,Minnesota,3281851,2412513,2295752,116761
1990-10-01,Mississippi,1907019,1180524,1087283,93241
1990-10-01,Missouri,3874816,2619386,2450873,168513
1990-10-01,Montana,596663,399423,373620,25803
1990-10-01,Nebraska,1166438,827368,807513,19855
1990-10-01,Nevada,952256,677803,643474,34329
1990-10-01,Ohio,8264294,5419522,5101590,317932
1990-10-01,Oklahoma,2349888,1518705,1431564,87141
1990-10-01,Oregon,2204705,1508734,1422847,85887
1990-10-01,Pennsylvania,9230100,5808158,5466529,341629
1990-10-01,Tennessee,3784951,2399490,2264011,135479
1990-10-01,Texas,12648014,8652417,8088034,564383
1990-10-01,Utah,1172484,826033,790028,36005
1990-10-01,Vermont,431244,306162,290165,15997
1990-10-01,Virginia,4674276,3261078,3099686,161392
1990-10-01,Washington,3693432,2526431,2397203,129228
1990-10-01,Wisconsin,3686555,2607728,2486402,121326
1990-10-01,Wyoming,330215,236717,224639,12078
1990-11-01,Alabama,3093823,1912839,1777357,135482
1990-11-01,Alaska,373905,272785,252536,20249
1990-11-01,Arizona,2799622,1795318,1703828,91490
1990-11-01,Arkansas,1791530,1132115,1050565,81550
1990-11-01,California,22653007,15133320,14126733,1006587
1990-11-01,Colorado,2501753,1789892,1698879,91013
1990-11-01,Connecticut,2576094,1822155,1720942,101213
1990-11-01,Delaware,515837,363023,340209,22814
1990-11-01,Florida,10326907,6509135,6068329,440806
1990-11-01,Georgia,4912120,3305333,3117601,187732
1990-11-01,Hawaii,817443,558485,544498,13987
1990-11-01,Idaho,736001,495445,465617,29828
1990-11-01,Illinois,8731738,5932864,5548725,384139
1990-11-01,Indiana,4215241,2806904,2656612,150292
1990-11-01,Iowa,2095609,1459429,1391649,67780
1990-11-01,Kansas,1828130,1279846,1220808,59038
1990-11-01,Kentucky,2814548,1755300,1638906,116394
1990-11-01,Louisiana,3090234,1882564,1752937,129627
1990-11-01,Maine,942745,636162,593526,42636
1990-11-01,Maryland,3701071,2587027,2452787,134240
1990-11-01,Massachusetts,4713891,3218213,2977442,240771
1990-11-01,Michigan,7039697,4596850,4222009,374841
1990-11-01,Minnesota,3285536,2415457,2296720,118737
1990-11-01,Mississippi,1908121,1183742,1087814,95928
1990-11-01,Missouri,3877397,2624074,2450690,173384
1990-11-01,Montana,597629,399920,373352,26568
1990-11-01,Nebraska,1167681,828828,808712,20116
1990-11-01,Nevada,958182,680562,644935,35627
1990-11-01,Ohio,8269223,5423676,5096945,326731
1990-11-01,Oklahoma,2352077,1517889,1428067,89822
1990-11-01,Oregon,2209975,1508366,1422212,86154
1990-11-01,Pennsylvania,9234710,5814060,5459489,354571
1990-11-01,Tennessee,3789546,2401035,2260493,140542
1990-11-01,Texas,12667615,8665404,8092841,572563
1990-11-01,Utah,1175933,828259,791548,36711
1990-11-01,Vermont,431268,305991,289453,16538
1990-11-01,Virginia,4678404,3268135,3099831,168304
1990-11-01,Washington,3701675,2527746,2394295,133451
1990-11-01,Wisconsin,3691010,2612870,2485601,127269
1990-11-01,Wyoming,330236,236629,224513,12116
1990-12-01,Alabama,3096625,1915065,1778346,136719
1990-12-01,Alaska,374897,273068,252530,20538
1990-12-01,Arizona,2807405,1792274,1702393,89881
1990-12-01,Arkansas,1792941,1132330,1049672,82658
1990-12-01,California,22669098,15126566,14082456,1044110
1990-12-01,Colorado,2507730,1791976,1700926,91050
1990-12-01,Connecticut,2575557,1822941,1718995,103946
1990-12-01,Delaware,515913,362932,339641,23291
1990-12-01,Florida,10349263,6500580,6052798,447782
1990-12-01,Georgia,4920130,3306010,3117320,188690
1990-12-01,Hawaii,818574,560139,546068,14071
1990-12-01,Idaho,738002,497540,466708,30832
1990-12-01,Illinois,8735987,5935407,5550669,384738
1990-12-01,Indiana,4218809,2808008,2651441,156567
1990-12-01,Iowa,2096937,1459681,1390990,68691
1990-12-01,Kansas,1829142,1281155,1221154,60001
1990-12-01,Kentucky,2815597,1757251,1636189,121062
1990-12-01,Louisiana,3091256,1886616,1754374,132242
1990-12-01,Maine,943722,639031,592911,46120
1990-12-01,Maryland,3703896,2591093,2450334,140759
1990-12-01,Massachusetts,4711881,3206849,2957488,249361
1990-12-01,Michigan,7044397,4597571,4207752,389819
1990-12-01,Minnesota,3289221,2417780,2296934,120846
1990-12-01,Mississippi,1909223,1186776,1088497,98279
1990-12-01,Missouri,3878979,2628097,2451436,176661
1990-12-01,Montana,597595,400460,373110,27350
1990-12-01,Nebraska,1167925,830607,810263,20344
1990-12-01,Nevada,964107,683460,646533,36927
1990-12-01,Ohio,8273153,5425835,5089671,336164
1990-12-01,Oklahoma,2353265,1516939,1425415,91524
1990-12-01,Oregon,2214246,1507421,1421020,86401
1990-12-01,Pennsylvania,9238320,5820519,5452711,367808
1990-12-01,Tennessee,3794141,2403021,2257357,145664
1990-12-01,Texas,12687216,8678172,8097912,580260
1990-12-01,Utah,1179381,830692,793245,37447
1990-12-01,Vermont,431292,305863,288837,17026
1990-12-01,Virginia,4683532,3275009,3100358,174651
1990-12-01,Washington,3709918,2530134,2391948,138186
1990-12-01,Wisconsin,3695466,2618005,2484064,133941
1990-12-01,Wyoming,331258,236536,224472,12064
1991-01-01,Alabama,3099427,1917535,1779517,138018
1991-01-01,Alaska,375888,273423,252522,20901
1991-01-01,Arizona,2814189,1789402,1700897,88505
1991-01-01,Arkansas,1794353,1132368,1048764,83604
1991-01-01,California,22684190,15121927,14041881,1080046
1991-01-01,Colorado,2512708,1793588,1702179,91409
1991-01-01,Connecticut,2575020,1824241,1717520,106721
1991-01-01,Delaware,516989,362868,339352,23516
1991-01-01,Florida,10371618,6491296,6036418,454878
1991-01-01,Georgia,4929141,3307396,3118417,188979
1991-01-01,Hawaii,819705,561226,546983,14243
1991-01-01,Idaho,740002,499758,468000,31758
1991-01-01,Illinois,8741236,5936684,5549549,387135
1991-01-01,Indiana,4222376,2808766,2646324,162442
1991-01-01,Iowa,2098265,1460375,1390903,69472
1991-01-01,Kansas,1829154,1282339,1221724,60615
1991-01-01,Kentucky,2817647,1759934,1634422,125512
1991-01-01,Louisiana,3092277,1890423,1755975,134448
1991-01-01,Maine,943699,641836,592306,49530
1991-01-01,Maryland,3705721,2596437,2449339,147098
1991-01-01,Massachusetts,4708871,3196148,2938421,257727
1991-01-01,Michigan,7049097,4601408,4194712,406696
1991-01-01,Minnesota,3291906,2419834,2296678,123156
1991-01-01,Mississippi,1910325,1189463,1088957,100506
1991-01-01,Missouri,3881560,2631542,2452633,178909
1991-01-01,Montana,598561,400870,372821,28049
1991-01-01,Nebraska,1169169,832478,811812,20666
1991-01-01,Nevada,970033,686491,648293,38198
1991-01-01,Ohio,8277082,5425137,5080073,345064
1991-01-01,Oklahoma,2355454,1515882,1423576,92306
1991-01-01,Oregon,2219516,1506643,1419756,86887
1991-01-01,Pennsylvania,9241930,5826866,5445933,380933
1991-01-01,Tennessee,3798736,2404969,2254660,150309
1991-01-01,Texas,12705818,8690383,8102754,587629
1991-01-01,Utah,1182829,833289,795116,38173
1991-01-01,Vermont,431317,305745,288284,17461
1991-01-01,Virginia,4687659,3281933,3101633,180300
1991-01-01,Washington,3718162,2533467,2390665,142802
1991-01-01,Wisconsin,3698921,2622474,2481785,140689
1991-01-01,Wyoming,331279,236455,224499,11956
1991-02-01,Alabama,3101229,1920462,1780932,139530
1991-02-01,Alaska,376879,273867,252497,21370
1991-02-01,Arizona,2820973,1788056,1700010,88046
1991-02-01,Arkansas,1795765,1132439,1048078,84361
1991-02-01,California,22696281,15120868,14007246,1113622
1991-02-01,Colorado,2517685,1795508,1703408,92100
1991-02-01,Connecticut,2573483,1826056,1716372,109684
1991-02-01,Delaware,518065,362873,339382,23491
1991-02-01,Florida,10392973,6485179,6022155,463024
1991-02-01,Georgia,4937152,3309722,3121165,188557
1991-02-01,Hawaii,820836,561901,547401,14500
1991-02-01,Idaho,742002,501922,469509,32413
1991-02-01,Illinois,8744485,5937007,5544901,392106
1991-02-01,Indiana,4224943,2809456,2642477,166979
1991-02-01,Iowa,2098593,1461977,1391902,70075
1991-02-01,Kansas,1829165,1283517,1222640,60877
1991-02-01,Kentucky,2818697,1762954,1633789,129165
1991-02-01,Louisiana,3092298,1894364,1757873,136491
1991-02-01,Maine,943676,643789,591524,52265
1991-02-01,Maryland,3708545,2602498,2450001,152497
1991-02-01,Massachusetts,4704861,3188397,2922463,265934
1991-02-01,Michigan,7052797,4606567,4183683,422884
1991-02-01,Minnesota,3294591,2422158,2296766,125392
1991-02-01,Mississippi,1910426,1191734,1089242,102492
1991-02-01,Missouri,3883142,2634639,2454264,180375
1991-02-01,Montana,599528,401099,372543,28556
1991-02-01,Nebraska,1169413,834301,813179,21122
1991-02-01,Nevada,974959,689632,650268,39364
1991-02-01,Ohio,8280011,5423518,5070874,352644
1991-02-01,Oklahoma,2355643,1514798,1422372,92426
1991-02-01,Oregon,2223787,1506964,1419380,87584
1991-02-01,Pennsylvania,9243540,5833224,5440423,392801
1991-02-01,Tennessee,3802331,2407238,2252883,154355
1991-02-01,Texas,12722419,8703445,8109131,594314
1991-02-01,Utah,1186278,836105,797235,38870
1991-02-01,Vermont,431341,305746,287856,17890
1991-02-01,Virginia,4691787,3289320,3104248,185072
1991-02-01,Washington,3725405,2537668,2390874,146794
1991-02-01,Wisconsin,3702377,2625986,2479743,146243
1991-02-01,Wyoming,331301,236440,224597,11843
1991-03-01,Alabama,3104031,1923032,1782147,140885
1991-03-01,Alaska,377871,274371,252507,21864
1991-03-01,Arizona,2827757,1788809,1700024,88785
1991-03-01,Arkansas,1797177,1132526,1047778,84748
1991-03-01,California,22708373,15120444,13978756,1141688
1991-03-01,Colorado,2522663,1797611,1704804,92807
1991-03-01,Connecticut,2572946,1827745,1715093,112652
1991-03-01,Delaware,518141,362794,339595,23199
1991-03-01,Florida,10413328,6483618,6011904,471714
1991-03-01,Georgia,4945163,3311830,3124983,186847
1991-03-01,Hawaii,821967,562317,547554,14763
1991-03-01,Idaho,744002,503927,471259,32668
1991-03-01,Illinois,8747734,5935436,5536746,398690
1991-03-01,Indiana,4228511,2809123,2640135,168988
1991-03-01,Iowa,2098922,1464221,1393907,70314
1991-03-01,Kansas,1830177,1284454,1223776,60678
1991-03-01,Kentucky,2820747,1765211,1633636,131575
1991-03-01,Louisiana,3092319,1898057,1759806,138251
1991-03-01,Maine,943652,644401,590615,53786
1991-03-01,Maryland,3710370,2607792,2451746,156046
1991-03-01,Massachusetts,4701851,3183590,2910214,273376
1991-03-01,Michigan,7055496,4608888,4174467,434421
1991-03-01,Minnesota,3297276,2424521,2297577,126944
1991-03-01,Mississippi,1911528,1192941,1089089,103852
1991-03-01,Missouri,3884723,2636635,2455924,180711
1991-03-01,Montana,599494,401132,372366,28766
1991-03-01,Nebraska,1170656,835801,814213,21588
1991-03-01,Nevada,980884,692630,652350,40280
1991-03-01,Ohio,8281941,5421606,5063841,357765
1991-03-01,Oklahoma,2356832,1513502,1421513,91989
1991-03-01,Oregon,2228057,1508331,1419952,88379
1991-03-01,Pennsylvania,9245150,5838195,5436534,401661
1991-03-01,Tennessee,3805926,2409408,2252014,157394
1991-03-01,Texas,12739020,8716436,8117400,599036
1991-03-01,Utah,1188726,838943,799491,39452
1991-03-01,Vermont,431366,305834,287580,18254
1991-03-01,Virginia,4695915,3296418,3107901,188517
1991-03-01,Washington,3733648,2542009,2392353,149656
1991-03-01,Wisconsin,3705832,2628026,2478770,149256
1991-03-01,Wyoming,332322,236475,224734,11741
1991-04-01,Alabama,3106833,1924595,1782930,141665
1991-04-01,Alaska,378862,274941,252646,22295
1991-04-01,Arizona,2834541,1791456,1700544,90912
1991-04-01,Arkansas,1798588,1132602,1047948,84654
1991-04-01,California,22723464,15118925,13956787,1162138
1991-04-01,Colorado,2527640,1799611,1706321,93290
1991-04-01,Connecticut,2572409,1828835,1713438,115397
1991-04-01,Delaware,519217,362444,339735,22709
1991-04-01,Florida,10435683,6487076,6006927,480149
1991-04-01,Georgia,4953174,3313068,3129497,183571
1991-04-01,Hawaii,823099,562738,547736,15002
1991-04-01,Idaho,747002,505761,473148,32613
1991-04-01,Illinois,8752983,5932103,5526693,405410
1991-04-01,Indiana,4232078,2807118,2639306,167812
1991-04-01,Iowa,2100250,1466780,1396635,70145
1991-04-01,Kansas,1830189,1284861,1224891,59970
1991-04-01,Kentucky,2821797,1765994,1633427,132567
1991-04-01,Louisiana,3093341,1900998,1761668,139330
1991-04-01,Maine,943629,643707,589790,53917
1991-04-01,Maryland,3713195,2611311,2454026,157285
1991-04-01,Massachusetts,4698841,3180770,2901306,279464
1991-04-01,Michigan,7060196,4605663,4166627,439036
1991-04-01,Minnesota,3299961,2426660,2299259,127401
1991-04-01,Mississippi,1912630,1192745,1088358,104387
1991-04-01,Missouri,3886305,2636928,2457225,179703
1991-04-01,Montana,600460,401091,372444,28647
1991-04-01,Nebraska,1170900,836962,814975,21987
1991-04-01,Nevada,985810,695226,654411,40815
1991-04-01,Ohio,8285870,5419238,5059329,359909
1991-04-01,Oklahoma,2359021,1512104,1420833,91271
1991-04-01,Oregon,2232328,1510184,1421058,89126
1991-04-01,Pennsylvania,9248760,5840798,5434434,406364
1991-04-01,Tennessee,3810521,2411501,2252282,159219
1991-04-01,Texas,12757622,8728584,8127517,601067
1991-04-01,Utah,1192175,841627,801759,39868
1991-04-01,Vermont,431390,305958,287470,18488
1991-04-01,Virginia,4700042,3302942,3112468,190474
1991-04-01,Washington,3740891,2546073,2394626,151447
1991-04-01,Wisconsin,3710288,2628334,2479120,149214
1991-04-01,Wyoming,332344,236518,224877,11641
1991-05-01,Alabama,3109635,1925021,1783310,141711
1991-05-01,Alaska,379853,275554,252909,22645
1991-05-01,Arizona,2841324,1795600,1701072,94528
1991-05-01,Arkansas,1800000,1132834,1048738,84096
1991-05-01,California,22738556,15117199,13941896,1175303
1991-05-01,Colorado,2532618,1801613,1708140,93473
1991-05-01,Connecticut,2571872,1829360,1711538,117822
1991-05-01,Delaware,520293,361824,339715,22109
1991-05-01,Florida,10457039,6495058,6006811,488247
1991-05-01,Georgia,4962185,3313411,3134286,179125
1991-05-01,Hawaii,824230,563359,548157,15202
1991-05-01,Idaho,749002,507497,475131,32366
1991-05-01,Illinois,8757232,5927514,5515850,411664
1991-05-01,Indiana,4235646,2803612,2639414,164198
1991-05-01,Iowa,2101578,1469242,1399625,69617
1991-05-01,Kansas,1831201,1284732,1225852,58880
1991-05-01,Kentucky,2823846,1765159,1632847,132312
1991-05-01,Louisiana,3093362,1903280,1763693,139587
1991-05-01,Maine,943606,642064,589241,52823
1991-05-01,Maryland,3715019,2613175,2456564,156611
1991-05-01,Massachusetts,4695831,3179644,2895653,283991
1991-05-01,Michigan,7064896,4598040,4160750,437290
1991-05-01,Minnesota,3303646,2428669,2302009,126660
1991-05-01,Mississippi,1912732,1191140,1087130,104010
1991-05-01,Missouri,3888886,2635908,2458158,177750
1991-05-01,Montana,600427,401173,372901,28272
1991-05-01,Nebraska,1172144,837936,815702,22234
1991-05-01,Nevada,991735,697417,656439,40978
1991-05-01,Ohio,8289799,5416730,5057505,359225
1991-05-01,Oklahoma,2360209,1511076,1420378,90698
1991-05-01,Oregon,2237598,1512480,1422608,89872
1991-05-01,Pennsylvania,9252370,5841281,5434505,406776
1991-05-01,Tennessee,3815116,2414258,2254159,160099
1991-05-01,Texas,12776223,8740730,8139156,601574
1991-05-01,Utah,1195623,844186,804047,40139
1991-05-01,Vermont,432414,306132,287553,18579
1991-05-01,Virginia,4705170,3309457,3118233,191224
1991-05-01,Washington,3749134,2550087,2397526,152561
1991-05-01,Wisconsin,3713743,2627396,2480780,146616
1991-05-01,Wyoming,332365,236561,225029,11532
1991-06-01,Alabama,3112438,1924639,1783477,141162
1991-06-01,Alaska,380845,276078,253159,22919
1991-06-01,Arizona,2848108,1800983,1701667,99316
1991-06-01,Arkansas,1801412,1133439,1050221,83218
1991-06-01,California,22756648,15116654,13933881,1182773
1991-06-01,Colorado,2537595,1803501,1709984,93517
1991-06-01,Connecticut,2571335,1829659,1709742,119917
1991-06-01,Delaware,520369,361178,339713,21465
1991-06-01,Florida,10480394,6505646,6009923,495723
1991-06-01,Georgia,4971196,3313061,3138864,174197
1991-06-01,Hawaii,826361,564193,548847,15346
1991-06-01,Idaho,751002,509206,477179,32027
1991-06-01,Illinois,8762480,5922582,5504263,418319
1991-06-01,Indiana,4239213,2799571,2640172,159399
1991-06-01,Iowa,2102906,1471200,1402348,68852
1991-06-01,Kansas,1831213,1284298,1226704,57594
1991-06-01,Kentucky,2825896,1762978,1631860,131118
1991-06-01,Louisiana,3094383,1905238,1766104,139134
1991-06-01,Maine,943583,640061,589171,50890
1991-06-01,Maryland,3717844,2614101,2459366,154735
1991-06-01,Massachusetts,4693821,3180055,2893087,286968
1991-06-01,Michigan,7069596,4589307,4158046,431261
1991-06-01,Minnesota,3306331,2430715,2305497,125218
1991-06-01,Mississippi,1913834,1188333,1085707,102626
1991-06-01,Missouri,3890468,2634334,2459139,175195
1991-06-01,Montana,601393,401463,373682,27781
1991-06-01,Nebraska,1173388,838836,816468,22368
1991-06-01,Nevada,997661,699341,658447,40894
1991-06-01,Ohio,8294729,5414446,5058473,355973
1991-06-01,Oklahoma,2361398,1510553,1420243,90310
1991-06-01,Oregon,2242869,1514913,1424161,90752
1991-06-01,Pennsylvania,9255980,5840939,5436748,404191
1991-06-01,Tennessee,3819711,2418086,2257568,160518
1991-06-01,Texas,12795824,8753963,8151807,602156
1991-06-01,Utah,1199072,846724,806416,40308
1991-06-01,Vermont,432439,306356,287849,18507
1991-06-01,Virginia,4709298,3316321,3125041,191280
1991-06-01,Washington,3758378,2554325,2400885,153440
1991-06-01,Wisconsin,3718199,2626293,2483596,142697
1991-06-01,Wyoming,333387,236606,225179,11427
1991-07-01,Alabama,3116240,1923943,1783529,140414
1991-07-01,Alaska,381836,276462,253312,23150
1991-07-01,Arizona,2855892,1807201,1702473,104728
1991-07-01,Arkansas,1803824,1134366,1052135,82231
1991-07-01,California,22772739,15118028,13930842,1187186
1991-07-01,Colorado,2543573,1804875,1711091,93784
1991-07-01,Connecticut,2570798,1829855,1708138,121717
1991-07-01,Delaware,521445,360770,339951,20819
1991-07-01,Florida,10502749,6515929,6013813,502116
1991-07-01,Georgia,4979207,3312566,3143241,169325
1991-07-01,Hawaii,827492,565159,549649,15510
1991-07-01,Idaho,753002,510881,479113,31768
1991-07-01,Illinois,8767729,5918182,5491052,427130
1991-07-01,Indiana,4243780,2795542,2640755,154787
1991-07-01,Iowa,2103234,1472315,1404249,68066
1991-07-01,Kansas,1832224,1283949,1227613,56336
1991-07-01,Kentucky,2826946,1759998,1630537,129461
1991-07-01,Louisiana,3095405,1906913,1768782,138131
1991-07-01,Maine,943560,638327,589596,48731
1991-07-01,Maryland,3720669,2615072,2462412,152660
1991-07-01,Massachusetts,4690811,3181084,2892555,288529
1991-07-01,Michigan,7074296,4582570,4158466,424104
1991-07-01,Minnesota,3310016,2432505,2308747,123758
1991-07-01,Mississippi,1914936,1184643,1084244,100399
1991-07-01,Missouri,3893050,2632736,2460526,172210
1991-07-01,Montana,602359,402007,374649,27358
1991-07-01,Nebraska,1173631,839706,817204,22502
1991-07-01,Nevada,1003587,701158,660375,40783
1991-07-01,Ohio,8298658,5411862,5060524,351338
1991-07-01,Oklahoma,2363587,1510398,1420382,90016
1991-07-01,Oregon,2247139,1516934,1425035,91899
1991-07-01,Pennsylvania,9259590,5840418,5439481,400937
1991-07-01,Tennessee,3824306,2422005,2261164,160841
1991-07-01,Texas,12814426,8767631,8164477,603154
1991-07-01,Utah,1202520,849244,808810,40434
1991-07-01,Vermont,432463,306610,288318,18292
1991-07-01,Virginia,4714425,3323469,3132235,191234
1991-07-01,Washington,3766621,2558757,2404135,154622
1991-07-01,Wisconsin,3722654,2625846,2486773,139073
1991-07-01,Wyoming,333408,236647,225289,11358
1991-08-01,Alabama,3119042,1923588,1783691,139897
1991-08-01,Alaska,382828,276825,253404,23421
1991-08-01,Arizona,2864676,1813889,1703299,110590
1991-08-01,Arkansas,1805235,1135831,1054326,81505
1991-08-01,California,22800831,15123234,13930143,1193091
1991-08-01,Colorado,2549550,1805987,1711313,94674
1991-08-01,Connecticut,2570262,1830030,1706671,123359
1991-08-01,Delaware,522521,360796,340480,20316
1991-08-01,Florida,10520104,6524509,6016467,508042
1991-08-01,Georgia,4989217,3313316,3147833,165483
1991-08-01,Hawaii,828623,566138,550345,15793
1991-08-01,Idaho,755003,512493,480798,31695
1991-08-01,Illinois,8774978,5916745,5477621,439124
1991-08-01,Indiana,4247348,2792629,2640826,151803
1991-08-01,Iowa,2105562,1472722,1405115,67607
1991-08-01,Kansas,1834236,1284211,1228907,55304
1991-08-01,Kentucky,2829996,1757296,1629249,128047
1991-08-01,Louisiana,3097426,1908430,1771424,137006
1991-08-01,Maine,944537,637358,590259,47099
1991-08-01,Maryland,3723493,2617357,2465492,151865
1991-08-01,Massachusetts,4690801,3182436,2893323,289113
1991-08-01,Michigan,7079995,4580408,4160909,419499
1991-08-01,Minnesota,3312701,2433997,2311214,122783
1991-08-01,Mississippi,1916038,1180678,1082778,97900
1991-08-01,Missouri,3895631,2631837,2462416,169421
1991-08-01,Montana,603325,402821,375656,27165
1991-08-01,Nebraska,1174875,840553,817897,22656
1991-08-01,Nevada,1007512,703096,662179,40917
1991-08-01,Ohio,8303588,5409862,5062366,347496
1991-08-01,Oklahoma,2365776,1510398,1420912,89486
1991-08-01,Oregon,2251410,1518893,1425256,93637
1991-08-01,Pennsylvania,9262200,5841185,5441458,399727
1991-08-01,Tennessee,3828902,2425271,2263930,161341
1991-08-01,Texas,12835027,8783264,8176567,606697
1991-08-01,Utah,1206968,851728,811176,40552
1991-08-01,Vermont,432487,306910,288835,18075
1991-08-01,Virginia,4720553,3330867,3138983,191884
1991-08-01,Washington,3774864,2563623,2407055,156568
1991-08-01,Wisconsin,3726110,2626953,2489998,136955
1991-08-01,Wyoming,334430,236726,225349,11377
1991-09-01,Alabama,3122844,1924313,1784311,140002
1991-09-01,Alaska,383819,277400,253585,23815
1991-09-01,Arizona,2873460,1821144,1704266,116878
1991-09-01,Arkansas,1807647,1138127,1056762,81365
1991-09-01,California,22830922,15134655,13929655,1205000
1991-09-01,Colorado,2556528,1807265,1711057,96208
1991-09-01,Connecticut,2568725,1830298,1705240,125058
1991-09-01,Delaware,522597,361287,341264,20023
1991-09-01,Florida,10538460,6531951,6017182,514769
1991-09-01,Georgia,4999228,3316575,3152742,163833
1991-09-01,Hawaii,829754,567020,550764,16256
1991-09-01,Idaho,757003,514089,482220,31869
1991-09-01,Illinois,8783227,5921232,5466879,454353
1991-09-01,Indiana,4251915,2792502,2641294,151208
1991-09-01,Iowa,2107890,1472938,1405265,67673
1991-09-01,Kansas,1837248,1285335,1230817,54518
1991-09-01,Kentucky,2833045,1755940,1628648,127292
1991-09-01,Louisiana,3100447,1910234,1773739,136495
1991-09-01,Maine,944513,637304,590869,46435
1991-09-01,Maryland,3725318,2621427,2468216,153211
1991-09-01,Massachusetts,4690791,3184956,2895604,289352
1991-09-01,Michigan,7085695,4584138,4164642,419496
1991-09-01,Minnesota,3316386,2435406,2312925,122481
1991-09-01,Mississippi,1918140,1177305,1081486,95819
1991-09-01,Missouri,3899213,2632086,2464747,167339
1991-09-01,Montana,604292,403890,376604,27286
1991-09-01,Nebraska,1177119,841405,818575,22830
1991-09-01,Nevada,1011438,705438,663868,41570
1991-09-01,Ohio,8308517,5411059,5064430,346629
1991-09-01,Oklahoma,2368965,1510859,1421951,88908
1991-09-01,Oregon,2255680,1521482,1425201,96281
1991-09-01,Pennsylvania,9265810,5845348,5442800,402548
1991-09-01,Tennessee,3834497,2427555,2265430,162125
1991-09-01,Texas,12855628,8803379,8188254,615125
1991-09-01,Utah,1211417,854237,813521,40716
1991-09-01,Vermont,432512,307264,289282,17982
1991-09-01,Virginia,4726681,3338749,3144759,193990
1991-09-01,Washington,3783107,2569594,2409991,159603
1991-09-01,Wisconsin,3730565,2629896,2493582,136314
1991-09-01,Wyoming,334451,236913,225381,11532
1991-10-01,Alabama,3126646,1925981,1785187,140794
1991-10-01,Alaska,385810,278258,253941,24317
1991-10-01,Arizona,2882243,1828754,1705230,123524
1991-10-01,Arkansas,1809059,1141159,1059331,81828
1991-10-01,California,22861014,15150777,13926208,1224569
1991-10-01,Colorado,2563505,1808912,1710534,98378
1991-10-01,Connecticut,2568188,1830312,1703402,126910
1991-10-01,Delaware,523673,361953,342071,19882
1991-10-01,Florida,10555815,6538939,6015959,522980
1991-10-01,Georgia,5009239,3322128,3157237,164891
1991-10-01,Hawaii,830886,567773,550870,16903
1991-10-01,Idaho,759003,515566,483298,32268
1991-10-01,Illinois,8791476,5931886,5460625,471261
1991-10-01,Indiana,4257483,2795359,2642723,152636
1991-10-01,Iowa,2110218,1473292,1405140,68152
1991-10-01,Kansas,1839260,1287224,1233184,54040
1991-10-01,Kentucky,2836095,1755725,1628678,127047
1991-10-01,Louisiana,3102468,1912495,1775371,137124
1991-10-01,Maine,944490,637932,591194,46738
1991-10-01,Maryland,3728143,2626469,2469815,156654
1991-10-01,Massachusetts,4690781,3188344,2898728,289616
1991-10-01,Michigan,7092395,4593016,4169363,423653
1991-10-01,Minnesota,3320071,2436492,2313826,122666
1991-10-01,Mississippi,1919242,1174894,1080377,94517
1991-10-01,Missouri,3901794,2632893,2466995,165898
1991-10-01,Montana,605258,405034,377406,27628
1991-10-01,Nebraska,1178363,842156,819148,23008
1991-10-01,Nevada,1015363,708111,665356,42755
1991-10-01,Ohio,8313446,5415826,5066306,349520
1991-10-01,Oklahoma,2371153,1512303,1423212,89091
1991-10-01,Oregon,2259951,1524648,1424726,99922
1991-10-01,Pennsylvania,9269420,5852629,5443299,409330
1991-10-01,Tennessee,3839092,2429140,2265941,163199
1991-10-01,Texas,12876230,8827072,8198985,628087
1991-10-01,Utah,1215865,856691,815717,40974
1991-10-01,Vermont,433536,307643,289562,18081
1991-10-01,Virginia,4733808,3346755,3149000,197755
1991-10-01,Washington,3791350,2577068,2413302,163766
1991-10-01,Wisconsin,3735021,2633894,2497657,136237
1991-10-01,Wyoming,335473,237199,225367,11832
1991-11-01,Alabama,3129448,1928281,1786147,142134
1991-11-01,Alaska,386802,279304,254443,24861
1991-11-01,Arizona,2891027,1836537,1706280,130257
1991-11-01,Arkansas,1811471,1144692,1062055,82637
1991-11-01,California,22887105,15169339,13918928,1250411
1991-11-01,Colorado,2570483,1811284,1710283,101001
1991-11-01,Connecticut,2567651,1829625,1700802,128823
1991-11-01,Delaware,523750,362563,342743,19820
1991-11-01,Florida,10572170,6546044,6013806,532238
1991-11-01,Georgia,5018250,3329180,3160744,168436
1991-11-01,Hawaii,832017,568437,550798,17639
1991-11-01,Idaho,761003,516975,484163,32812
1991-11-01,Illinois,8797725,5946284,5459501,486783
1991-11-01,Indiana,4261050,2800590,2645103,155487
1991-11-01,Iowa,2111546,1480975,1412112,68863
1991-11-01,Kansas,1842272,1289776,1235798,53978
1991-11-01,Kentucky,2838145,1756068,1629195,126873
1991-11-01,Louisiana,3104490,1915211,1776222,138989
1991-11-01,Maine,944467,638896,591217,47679
1991-11-01,Maryland,3729967,2631768,2470045,161723
1991-11-01,Massachusetts,4690772,3191316,2901425,289891
1991-11-01,Michigan,7097095,4604970,4174922,430048
1991-11-01,Minnesota,3322756,2437255,2314287,122968
1991-11-01,Mississippi,1920343,1173620,1079503,94117
1991-11-01,Missouri,3904376,2633743,2468710,165033
1991-11-01,Montana,606224,406073,378108,27965
1991-11-01,Nebraska,1179606,842679,819507,23172
1991-11-01,Nevada,1019289,710875,666657,44218
1991-11-01,Ohio,8317376,5423461,5067461,356000
1991-11-01,Oklahoma,2373342,1514622,1424475,90147
1991-11-01,Oregon,2263221,1528091,1423962,104129
1991-11-01,Pennsylvania,9271030,5861046,5442841,418205
1991-11-01,Tennessee,3843687,2430780,2266570,164210
1991-11-01,Texas,12895831,8852283,8209310,642973
1991-11-01,Utah,1220314,859122,817761,41361
1991-11-01,Vermont,433561,308006,289658,18348
1991-11-01,Virginia,4738936,3354232,3151509,202723
1991-11-01,Washington,3799594,2585606,2417226,168380
1991-11-01,Wisconsin,3739476,2638180,2502425,135755
1991-11-01,Wyoming,335494,237518,225318,12200
1991-12-01,Alabama,3132250,1931005,1787353,143652
1991-12-01,Alaska,387793,280379,255040,25339
1991-12-01,Arizona,2898811,1844148,1707766,136382
1991-12-01,Arkansas,1812883,1148438,1065036,83402
1991-12-01,California,22910197,15187585,13908998,1278587
1991-12-01,Colorado,2576460,1814286,1710621,103665
1991-12-01,Connecticut,2566114,1828095,1697588,130507
1991-12-01,Delaware,524826,363066,343313,19753
1991-12-01,Florida,10587525,6553413,6012430,540983
1991-12-01,Georgia,5026261,3336765,3163383,173382
1991-12-01,Hawaii,833148,569137,550709,18428
1991-12-01,Idaho,763003,518503,485146,33357
1991-12-01,Illinois,8802974,5961920,5463670,498250
1991-12-01,Indiana,4264617,2807625,2648239,159386
1991-12-01,Iowa,2113874,1489064,1419539,69525
1991-12-01,Kansas,1844284,1292757,1238457,54300
1991-12-01,Kentucky,2840195,1756510,1630202,126308
1991-12-01,Louisiana,3106511,1918027,1776474,141553
1991-12-01,Maine,944444,639888,591141,48747
1991-12-01,Maryland,3731792,2636759,2469455,167304
1991-12-01,Massachusetts,4689762,3192694,2902960,289734
1991-12-01,Michigan,7100794,4617574,4181404,436170
1991-12-01,Minnesota,3325441,2438224,2315149,123075
1991-12-01,Mississippi,1921445,1173376,1079023,94353
1991-12-01,Missouri,3905957,2634225,2469709,164516
1991-12-01,Montana,606190,408575,380397,28178
1991-12-01,Nebraska,1180850,842942,819660,23282
1991-12-01,Nevada,1022215,713515,667861,45654
1991-12-01,Ohio,8319305,5434275,5068932,365343
1991-12-01,Oklahoma,2375531,1517452,1425953,91499
1991-12-01,Oregon,2266492,1531788,1423672,108116
1991-12-01,Pennsylvania,9272640,5868176,5441550,426626
1991-12-01,Tennessee,3847282,2432760,2268034,164726
1991-12-01,Texas,12912432,8877275,8220393,656882
1991-12-01,Utah,1223762,861646,819750,41896
1991-12-01,Vermont,433585,308343,289656,18687
1991-12-01,Virginia,4744064,3360738,3152783,207955
1991-12-01,Washington,3806837,2594587,2421896,172691
1991-12-01,Wisconsin,3741932,2642819,2508325,134494
1991-12-01,Wyoming,336515,237818,225283,12535
1992-01-01,Alabama,3134052,1934181,1789192,144989
1992-01-01,Alaska,388784,281503,255818,25685
1992-01-01,Arizona,2906595,1851118,1709964,141154
1992-01-01,Arkansas,1814294,1152189,1068343,83846
1992-01-01,California,22934288,15206059,13899792,1306267
1992-01-01,Colorado,2582438,1817886,1711771,106115
1992-01-01,Connecticut,2564577,1825890,1694154,131736
1992-01-01,Delaware,524902,363492,343793,19699
1992-01-01,Florida,10602880,6561712,6013854,547858
1992-01-01,Georgia,5035272,3344636,3165974,178662
1992-01-01,Hawaii,834279,570014,550706,19308
1992-01-01,Idaho,764003,520233,486455,33778
1992-01-01,Illinois,8808223,5978245,5473832,504413
1992-01-01,Indiana,4268185,2816059,2652476,163583
1992-01-01,Iowa,2115203,1497472,1427587,69885
1992-01-01,Kansas,1846295,1295931,1240968,54963
1992-01-01,Kentucky,2842245,1757189,1631945,125244
1992-01-01,Louisiana,3108532,1920929,1776664,144265
1992-01-01,Maine,944421,640742,591208,49534
1992-01-01,Maryland,3733617,2641402,2469142,172260
1992-01-01,Massachusetts,4688752,3192203,2903383,288820
1992-01-01,Michigan,7105494,4629279,4189184,440095
1992-01-01,Minnesota,3328126,2439907,2316995,122912
1992-01-01,Mississippi,1922547,1174084,1079279,94805
1992-01-01,Missouri,3907539,2634536,2470302,164234
1992-01-01,Montana,607157,411021,382762,28259
1992-01-01,Nebraska,1182094,843169,819808,23361
1992-01-01,Nevada,1026140,715946,669110,46836
1992-01-01,Ohio,8322234,5448349,5071532,376817
1992-01-01,Oklahoma,2377720,1520469,1427798,92671
1992-01-01,Oregon,2270762,1535704,1424524,111180
1992-01-01,Pennsylvania,9273250,5873673,5440757,432916
1992-01-01,Tennessee,3851877,2435572,2270941,164631
1992-01-01,Texas,12930034,8902377,8233551,668826
1992-01-01,Utah,1228211,864371,821872,42499
1992-01-01,Vermont,433609,308692,289678,19014
1992-01-01,Virginia,4749191,3366056,3153608,212448
1992-01-01,Washington,3815080,2603648,2427399,176249
1992-01-01,Wisconsin,3745387,2648565,2515774,132791
1992-01-01,Wyoming,336537,238119,225311,12808
1992-02-01,Alabama,3136854,1938121,1791892,146229
1992-02-01,Alaska,389776,282674,256792,25882
1992-02-01,Arizona,2914379,1857234,1712875,144359
1992-02-01,Arkansas,1815706,1155693,1071763,83930
1992-02-01,California,22954380,15226784,13893263,1333521
1992-02-01,Colorado,2588415,1822277,1713914,108363
1992-02-01,Connecticut,2563040,1823465,1690847,132618
1992-02-01,Delaware,525978,363912,344216,19696
1992-02-01,Florida,10616236,6572281,6019056,553225
1992-02-01,Georgia,5043283,3423071,3169079,253992
1992-02-01,Hawaii,835410,571113,550829,20284
1992-02-01,Idaho,766003,522120,488093,34027
1992-02-01,Illinois,8813472,5994309,5488248,506061
1992-02-01,Indiana,4270752,2825888,2658134,167754
1992-02-01,Iowa,2116531,1505891,1435929,69962
1992-02-01,Kansas,1848307,1299108,1243186,55922
1992-02-01,Kentucky,2844294,1758648,1634632,124016
1992-02-01,Louisiana,3109554,1924000,1777004,146996
1992-02-01,Maine,944398,641375,591568,49807
1992-02-01,Maryland,3734441,2646055,2470060,175995
1992-02-01,Massachusetts,4686742,3190492,2902936,287556
1992-02-01,Michigan,7108194,4640269,4198338,441931
1992-02-01,Minnesota,3329812,2442760,2320081,122679
1992-02-01,Mississippi,1922649,1175900,1080489,95411
1992-02-01,Missouri,3909120,2635307,2470905,164402
1992-02-01,Montana,608123,413457,385207,28250
1992-02-01,Nebraska,1182338,843687,820208,23479
1992-02-01,Nevada,1030066,718214,670502,47712
1992-02-01,Ohio,8324164,5464225,5075302,388923
1992-02-01,Oklahoma,2378909,1523340,1429879,93461
1992-02-01,Oregon,2274033,1539960,1426921,113039
1992-02-01,Pennsylvania,9272860,5878157,5441213,436944
1992-02-01,Tennessee,3854472,2439709,2275867,163842
1992-02-01,Texas,12945635,8927979,8248679,679300
1992-02-01,Utah,1231659,867284,824256,43028
1992-02-01,Vermont,433634,309027,289787,19240
1992-02-01,Virginia,4753319,3370521,3154950,215571
1992-02-01,Washington,3821323,2612610,2433547,179063
1992-02-01,Wisconsin,3748843,2656035,2524441,131594
1992-02-01,Wyoming,337558,238427,225403,13024
1992-03-01,Alabama,3139656,1943590,1796132,147458
1992-03-01,Alaska,390767,283799,257848,25951
1992-03-01,Arizona,2923162,1862604,1716566,146038
1992-03-01,Arkansas,1817118,1158770,1075055,83715
1992-03-01,California,22978471,15252804,13892272,1360532
1992-03-01,Colorado,2594393,1827756,1717315,110441
1992-03-01,Connecticut,2561503,1821758,1688472,133286
1992-03-01,Delaware,526054,364493,344778,19715
1992-03-01,Florida,10631591,6586010,6028403,557607
1992-03-01,Georgia,5052294,3422747,3173382,249365
1992-03-01,Hawaii,836541,572594,551223,21371
1992-03-01,Idaho,768003,524224,490066,34158
1992-03-01,Illinois,8818721,6009454,5504928,504526
1992-03-01,Indiana,4274319,2837280,2665500,171780
1992-03-01,Iowa,2117859,1514047,1444272,69775
1992-03-01,Kansas,1850319,1302460,1245424,57036
1992-03-01,Kentucky,2846344,1761664,1638717,122947
1992-03-01,Louisiana,3111575,1927337,1777754,149583
1992-03-01,Maine,944374,641895,592404,49491
1992-03-01,Maryland,3736266,2651126,2473081,178045
1992-03-01,Massachusetts,4685732,3189057,2902747,286310
1992-03-01,Michigan,7111894,4652221,4209679,442542
1992-03-01,Minnesota,3332497,2447334,2324621,122713
1992-03-01,Mississippi,1923751,1179254,1083092,96162
1992-03-01,Missouri,3910702,2637368,2472390,164978
1992-03-01,Montana,609089,415830,387613,28217
1992-03-01,Nebraska,1183581,844776,821103,23673
1992-03-01,Nevada,1032992,720506,672169,48337
1992-03-01,Ohio,8327093,5481324,5081073,400251
1992-03-01,Oklahoma,2381097,1525799,1432175,93624
1992-03-01,Oregon,2277303,1544862,1431142,113720
1992-03-01,Pennsylvania,9273470,5883544,5444143,439401
1992-03-01,Tennessee,3859067,2445566,2283117,162449
1992-03-01,Texas,12963237,8954554,8266572,687982
1992-03-01,Utah,1235107,870481,827066,43415
1992-03-01,Vermont,433658,309447,290081,19366
1992-03-01,Virginia,4758446,3375056,3158006,217050
1992-03-01,Washington,3829566,2621521,2440160,181361
1992-03-01,Wisconsin,3752298,2665739,2534019,131720
1992-03-01,Wyoming,337580,238729,225569,13160
1992-04-01,Alabama,3142458,1950784,1802202,148582
1992-04-01,Alaska,391759,284893,258949,25944
1992-04-01,Arizona,2930946,1867620,1721280,146340
1992-04-01,Arkansas,1818530,1161177,1077828,83349
1992-04-01,California,23004563,15284004,13895942,1388062
1992-04-01,Colorado,2601370,1833930,1721563,112367
1992-04-01,Connecticut,2559966,1821161,1687288,133873
1992-04-01,Delaware,527130,365327,345640,19687
1992-04-01,Florida,10646946,6601969,6040524,561445
1992-04-01,Georgia,5061304,3423953,3179158,244795
1992-04-01,Hawaii,837672,574305,551898,22407
1992-04-01,Idaho,770004,526504,492203,34301
1992-04-01,Illinois,8824970,6023607,5522450,501157
1992-04-01,Indiana,4277887,2849655,2673870,175785
1992-04-01,Iowa,2120187,1521547,1452196,69351
1992-04-01,Kansas,1852331,1306127,1247845,58282
1992-04-01,Kentucky,2848394,1766494,1644175,122319
1992-04-01,Louisiana,3113596,1930826,1778742,152084
1992-04-01,Maine,944351,642382,593684,48698
1992-04-01,Maryland,3738091,2656269,2477833,178436
1992-04-01,Massachusetts,4684722,3188503,2903166,285337
1992-04-01,Michigan,7116593,4665646,4223179,442467
1992-04-01,Minnesota,3336182,2453473,2330167,123306
1992-04-01,Mississippi,1924853,1184186,1087184,97002
1992-04-01,Missouri,3913284,2640697,2475060,165637
1992-04-01,Montana,610056,417997,389765,28232
1992-04-01,Nebraska,1184825,846344,822394,23950
1992-04-01,Nevada,1036917,722946,674099,48847
1992-04-01,Ohio,8331023,5498465,5088566,409899
1992-04-01,Oklahoma,2383286,1527715,1434461,93254
1992-04-01,Oregon,2281574,1550180,1436582,113598
1992-04-01,Pennsylvania,9276080,5890526,5449001,441525
1992-04-01,Tennessee,3863662,2452179,2291366,160813
1992-04-01,Texas,12981838,8980902,8286008,694894
1992-04-01,Utah,1239556,873923,830284,43639
1992-04-01,Vermont,433682,310052,290606,19446
1992-04-01,Virginia,4764574,3379433,3162444,216989
1992-04-01,Washington,3836810,2630176,2446735,183441
1992-04-01,Wisconsin,3755754,2677568,2544049,133519
1992-04-01,Wyoming,338601,239018,225785,13233
1992-05-01,Alabama,3145260,1958510,1809171,149339
1992-05-01,Alaska,393750,285886,260009,25877
1992-05-01,Arizona,2939730,1872182,1726652,145530
1992-05-01,Arkansas,1819941,1162581,1079672,82909
1992-05-01,California,23029654,15313501,13898720,1414781
1992-05-01,Colorado,2607348,1839985,1726015,113970
1992-05-01,Connecticut,2558429,1820951,1686633,134318
1992-05-01,Delaware,527206,366238,346602,19636
1992-05-01,Florida,10663301,6617368,6053065,564303
1992-05-01,Georgia,5070315,3425547,3185546,240001
1992-05-01,Hawaii,838804,575898,552632,23266
1992-05-01,Idaho,772004,528646,494127,34519
1992-05-01,Illinois,8831219,6034908,5539365,495543
1992-05-01,Indiana,4281454,2861099,2681856,179243
1992-05-01,Iowa,2121515,1524751,1455865,68886
1992-05-01,Kansas,1854343,1309643,1250128,59515
1992-05-01,Kentucky,2850444,1772372,1650137,122235
1992-05-01,Louisiana,3115618,1933378,1779111,154267
1992-05-01,Maine,944328,642726,595054,47672
1992-05-01,Maryland,3739915,2660381,2482740,177641
1992-05-01,Massachusetts,4683712,3187794,2903322,284472
1992-05-01,Michigan,7121293,4678090,4236541,441549
1992-05-01,Minnesota,3338867,2459926,2335712,124214
1992-05-01,Mississippi,1925955,1189836,1092033,97803
1992-05-01,Missouri,3915865,2643901,2478076,165825
1992-05-01,Montana,611022,419760,391449,28311
1992-05-01,Nebraska,1186069,847991,823701,24290
1992-05-01,Nevada,1040843,725401,676078,49323
1992-05-01,Ohio,8333952,5512427,5095487,416940
1992-05-01,Oklahoma,2385475,1528811,1436384,92427
1992-05-01,Oregon,2284844,1555119,1442001,113118
1992-05-01,Pennsylvania,9277690,5897454,5453699,443755
1992-05-01,Tennessee,3867257,2458124,2299076,159048
1992-05-01,Texas,13000439,9002828,8303448,699380
1992-05-01,Utah,1244004,877286,833634,43652
1992-05-01,Vermont,434707,310751,291247,19504
1992-05-01,Virginia,4769702,3382472,3166897,215575
1992-05-01,Washington,3845053,2638183,2452461,185722
1992-05-01,Wisconsin,3759209,2689984,2553255,136729
1992-05-01,Wyoming,338623,239229,225972,13257
1992-06-01,Alabama,3148063,1965499,1815979,149520
1992-06-01,Alaska,394741,286706,260927,25779
1992-06-01,Arizona,2948514,1875975,1731919,144056
1992-06-01,Arkansas,1822353,1162903,1080500,82403
1992-06-01,California,23055746,15335503,13896281,1439222
1992-06-01,Colorado,2614325,1845448,1730561,114887
1992-06-01,Connecticut,2557892,1820482,1685973,134509
1992-06-01,Delaware,528282,367025,347445,19580
1992-06-01,Florida,10678657,6630094,6064621,565473
1992-06-01,Georgia,5079326,3426474,3191734,234740
1992-06-01,Hawaii,839935,577269,553244,24025
1992-06-01,Idaho,773004,530490,495626,34864
1992-06-01,Illinois,8837467,6042066,5555635,486431
1992-06-01,Indiana,4286022,2869810,2688445,181365
1992-06-01,Iowa,2123843,1534006,1465536,68470
1992-06-01,Kansas,1856354,1312557,1252036,60521
1992-06-01,Kentucky,2853493,1778264,1655712,122552
1992-06-01,Louisiana,3117639,1934036,1778416,155620
1992-06-01,Maine,945305,642875,596129,46746
1992-06-01,Maryland,3741740,2662701,2486447,176254
1992-06-01,Massachusetts,4683702,3186400,2903049,283351
1992-06-01,Michigan,7125993,4687166,4248123,439043
1992-06-01,Minnesota,3341552,2465704,2340626,125078
1992-06-01,Mississippi,1927057,1195232,1096908,98324
1992-06-01,Missouri,3917447,2645762,2480604,165158
1992-06-01,Montana,611988,420408,391991,28417
1992-06-01,Nebraska,1187313,849412,824825,24587
1992-06-01,Nevada,1044768,727777,677988,49789
1992-06-01,Ohio,8337881,5520732,5099813,420919
1992-06-01,Oklahoma,2387664,1528974,1437877,91097
1992-06-01,Oregon,2289115,1559314,1446705,112609
1992-06-01,Pennsylvania,9279301,5903094,5457431,445663
1992-06-01,Tennessee,3871852,2463473,2306059,157414
1992-06-01,Texas,13019041,9017991,8316986,701005
1992-06-01,Utah,1247453,880437,836956,43481
1992-06-01,Vermont,434731,311474,291901,19573
1992-06-01,Virginia,4775829,3383683,3170553,213130
1992-06-01,Washington,3852296,2645598,2457154,188444
1992-06-01,Wisconsin,3763665,2701212,2560869,140343
1992-06-01,Wyoming,339644,239355,226118,13237
1992-07-01,Alabama,3150865,1971012,1821865,149147
1992-07-01,Alaska,395733,287403,261731,25672
1992-07-01,Arizona,2956297,1879078,1736581,142497
1992-07-01,Arkansas,1823765,1162420,1080621,81799
1992-07-01,California,23081837,15348541,13887168,1461373
1992-07-01,Colorado,2620303,1850344,1735277,115067
1992-07-01,Connecticut,2556355,1819636,1685166,134470
1992-07-01,Delaware,528358,367628,348141,19487
1992-07-01,Florida,10696012,6639938,6075212,564726
1992-07-01,Georgia,5088337,3426382,3197496,228886
1992-07-01,Hawaii,841066,578451,553707,24744
1992-07-01,Idaho,775004,531981,496771,35210
1992-07-01,Illinois,8844716,6045836,5571744,474092
1992-07-01,Indiana,4289589,2875176,2693344,181832
1992-07-01,Iowa,2125171,1532916,1464790,68126
1992-07-01,Kansas,1858366,1314694,1253491,61203
1992-07-01,Kentucky,2855543,1783350,1660332,123018
1992-07-01,Louisiana,3119660,1932627,1776675,155952
1992-07-01,Maine,945282,642894,596718,46176
1992-07-01,Maryland,3743565,2663077,2488241,174836
1992-07-01,Massachusetts,4682692,3184450,2902646,281804
1992-07-01,Michigan,7131693,4692240,4257805,434435
1992-07-01,Minnesota,3344237,2470533,2344845,125688
1992-07-01,Mississippi,1928159,1199647,1101374,98273
1992-07-01,Missouri,3920028,2646060,2482299,163761
1992-07-01,Montana,612954,422407,393943,28464
1992-07-01,Nebraska,1188556,850386,825713,24673
1992-07-01,Nevada,1048694,730090,679842,50248
1992-07-01,Ohio,8341811,5522052,5100285,421767
1992-07-01,Oklahoma,2390852,1528726,1439054,89672
1992-07-01,Oregon,2292385,1562869,1450379,112490
1992-07-01,Pennsylvania,9280911,5907106,5460239,446867
1992-07-01,Tennessee,3876447,2469585,2313056,156529
1992-07-01,Texas,13037642,9027021,8326355,700666
1992-07-01,Utah,1251901,883507,840265,43242
1992-07-01,Vermont,434755,312179,292534,19645
1992-07-01,Virginia,4780957,3383262,3173032,210230
1992-07-01,Washington,3860539,2652742,2461279,191463
1992-07-01,Wisconsin,3767120,2710555,2567243,143312
1992-07-01,Wyoming,339666,239437,226255,13182
1992-08-01,Alabama,3155667,1974481,1826061,148420
1992-08-01,Alaska,396724,287956,262466,25490
1992-08-01,Arizona,2967081,1881916,1740819,141097
1992-08-01,Arkansas,1827177,1161246,1080315,80931
1992-08-01,California,23090929,15351559,13872275,1479284
1992-08-01,Colorado,2629280,1855029,1740201,114828
1992-08-01,Connecticut,2556818,1818284,1684105,134179
1992-08-01,Delaware,529434,368095,348802,19293
1992-08-01,Florida,10713367,6647205,6085597,561608
1992-08-01,Georgia,5098348,3429840,3203075,226765
1992-08-01,Hawaii,841197,579439,554028,25411
1992-08-01,Idaho,778004,533111,497732,35379
1992-08-01,Illinois,8852965,6046163,5586117,460046
1992-08-01,Indiana,4295156,2877285,2696809,180476
1992-08-01,Iowa,2127499,1532226,1464439,67787
1992-08-01,Kansas,1861378,1315985,1254437,61548
1992-08-01,Kentucky,2859593,1786918,1663675,123243
1992-08-01,Louisiana,3121681,1929126,1773983,155143
1992-08-01,Maine,945259,642631,596707,45924
1992-08-01,Maryland,3745390,2661566,2488134,173432
1992-08-01,Massachusetts,4684682,3182139,2902565,279574
1992-08-01,Michigan,7135392,4692848,4265990,426858
1992-08-01,Minnesota,3348922,2474238,2348347,125891
1992-08-01,Mississippi,1930261,1202326,1105011,97315
1992-08-01,Missouri,3924610,2645106,2483216,161890
1992-08-01,Montana,613921,421930,393556,28374
1992-08-01,Nebraska,1189800,850841,826276,24565
1992-08-01,Nevada,1052620,732320,681698,50622
1992-08-01,Ohio,8347740,5517277,5097690,419587
1992-08-01,Oklahoma,2393041,1528223,1439737,88486
1992-08-01,Oregon,2297656,1565538,1452587,112951
1992-08-01,Pennsylvania,9285521,5908535,5461969,446566
1992-08-01,Tennessee,3882042,2476780,2320277,156503
1992-08-01,Texas,13061243,9031146,8332373,698773
1992-08-01,Utah,1256349,886670,843660,43010
1992-08-01,Vermont,434780,312810,293140,19670
1992-08-01,Virginia,4788085,3381298,3174114,207184
1992-08-01,Washington,3869782,2659603,2464918,194685
1992-08-01,Wisconsin,3771576,2717326,2572543,144783
1992-08-01,Wyoming,340687,239458,226404,13054
1992-09-01,Alabama,3159469,1975981,1828276,147705
1992-09-01,Alaska,397715,288319,263151,25168
1992-09-01,Arizona,2976865,1884697,1744809,139888
1992-09-01,Arkansas,1830589,1159589,1079890,79699
1992-09-01,California,23101020,15345438,13854154,1491284
1992-09-01,Colorado,2637258,1859979,1745401,114578
1992-09-01,Connecticut,2556281,1816280,1682697,133583
1992-09-01,Delaware,530510,368519,349539,18980
1992-09-01,Florida,10731722,6653040,6096766,556274
1992-09-01,Georgia,5109359,3422398,3208888,213510
1992-09-01,Hawaii,842328,580163,554182,25981
1992-09-01,Idaho,780004,533917,498646,35271
1992-09-01,Illinois,8862214,6042677,5595529,447148
1992-09-01,Indiana,4300724,2876696,2699134,177562
1992-09-01,Iowa,2128827,1532346,1464900,67446
1992-09-01,Kansas,1863390,1316587,1254862,61725
1992-09-01,Kentucky,2863643,1788775,1666016,122759
1992-09-01,Louisiana,3124703,1923811,1770672,153139
1992-09-01,Maine,946235,641736,595970,45766
1992-09-01,Maryland,3748214,2658616,2486847,171769
1992-09-01,Massachusetts,4685672,3179638,2903153,276485
1992-09-01,Michigan,7141092,4688790,4273070,415720
1992-09-01,Minnesota,3353607,2476888,2351239,125649
1992-09-01,Mississippi,1932362,1202908,1107531,95377
1992-09-01,Missouri,3928191,2643835,2483588,160247
1992-09-01,Montana,614887,421429,393291,28138
1992-09-01,Nebraska,1191044,850814,826457,24357
1992-09-01,Nevada,1056545,734469,683644,50825
1992-09-01,Ohio,8353669,5508926,5093805,415121
1992-09-01,Oklahoma,2395230,1527288,1439928,87360
1992-09-01,Oregon,2303926,1567268,1453570,113698
1992-09-01,Pennsylvania,9291131,5906782,5463012,443770
1992-09-01,Tennessee,3887637,2484525,2327731,156794
1992-09-01,Texas,13085845,9032430,8336409,696021
1992-09-01,Utah,1260798,890046,847269,42777
1992-09-01,Vermont,435804,313341,293712,19629
1992-09-01,Virginia,4795212,3378342,3174530,203812
1992-09-01,Washington,3878026,2665619,2467788,197831
1992-09-01,Wisconsin,3777031,2721209,2576728,144481
1992-09-01,Wyoming,340709,239422,226583,12839
1992-10-01,Alabama,3164271,1976841,1829571,147270
1992-10-01,Alaska,397707,288616,263900,24716
1992-10-01,Arizona,2986649,1887517,1748822,138695
1992-10-01,Arkansas,1834000,1158061,1079853,78208
1992-10-01,California,23112112,15333868,13836474,1497394
1992-10-01,Colorado,2646235,1865867,1751400,114467
1992-10-01,Connecticut,2556745,1813956,1681294,132662
1992-10-01,Delaware,531586,369048,350448,18600
1992-10-01,Florida,10750077,6659556,6110057,549499
1992-10-01,Georgia,5120370,3429265,3215648,213617
1992-10-01,Hawaii,843459,580631,554227,26404
1992-10-01,Idaho,783004,534508,499612,34896
1992-10-01,Illinois,8871463,6037609,5598998,438611
1992-10-01,Indiana,4306291,2875194,2701581,173613
1992-10-01,Iowa,2131155,1533501,1466376,67125
1992-10-01,Kansas,1865402,1316907,1254962,61945
1992-10-01,Kentucky,2867693,1789933,1668442,121491
1992-10-01,Louisiana,3127724,1917636,1767415,150221
1992-10-01,Maine,946212,640100,594632,45468
1992-10-01,Maryland,3751039,2655348,2485728,169620
1992-10-01,Massachusetts,4687662,3177616,2905023,272593
1992-10-01,Michigan,7145792,4681115,4279910,401205
1992-10-01,Minnesota,3359292,2479083,2354069,125014
1992-10-01,Mississippi,1934464,1202235,1109463,92772
1992-10-01,Missouri,3932773,2643768,2484097,159671
1992-10-01,Montana,616853,421088,393278,27810
1992-10-01,Nebraska,1193288,850700,826451,24249
1992-10-01,Nevada,1060471,736739,685848,50891
1992-10-01,Ohio,8360599,5500364,5091057,409307
1992-10-01,Oklahoma,2397419,1525921,1439988,85933
1992-10-01,Oregon,2309197,1568769,1454559,114210
1992-10-01,Pennsylvania,9296741,5903032,5464528,438504
1992-10-01,Tennessee,3893233,2492036,2335053,156983
1992-10-01,Texas,13111446,9034416,8341121,693295
1992-10-01,Utah,1266246,893795,851334,42461
1992-10-01,Vermont,435829,313763,294235,19528
1992-10-01,Virginia,4803340,3375347,3175382,199965
1992-10-01,Washington,3887269,2670486,2470030,200456
1992-10-01,Wisconsin,3782487,2723095,2580598,142497
1992-10-01,Wyoming,341730,239442,226825,12617
1992-11-01,Alabama,3168073,1978029,1830691,147338
1992-11-01,Alaska,398698,288935,264738,24197
1992-11-01,Arizona,2996433,1890018,1752487,137531
1992-11-01,Arkansas,1836412,1157114,1080386,76728
1992-11-01,California,23118204,15319026,13819527,1499499
1992-11-01,Colorado,2654213,1872608,1758145,114463
1992-11-01,Connecticut,2556208,1811370,1679801,131569
1992-11-01,Delaware,531662,369659,351440,18219
1992-11-01,Florida,10766433,6667641,6125163,542478
1992-11-01,Georgia,5129381,3435921,3223093,212828
1992-11-01,Hawaii,844591,580876,554191,26685
1992-11-01,Idaho,785004,534838,500417,34421
1992-11-01,Illinois,8879712,6033167,5596092,437075
1992-11-01,Indiana,4310859,2875050,2705603,169447
1992-11-01,Iowa,2132484,1535286,1468401,66885
1992-11-01,Kansas,1867414,1317003,1254680,62323
1992-11-01,Kentucky,2870742,1791230,1671293,119937
1992-11-01,Louisiana,3129745,1911588,1764455,147133
1992-11-01,Maine,947189,637799,592872,44927
1992-11-01,Maryland,3752864,2652383,2485195,167188
1992-11-01,Massachusetts,4688652,3176651,2908336,268315
1992-11-01,Michigan,7149492,4672041,4287208,384833
1992-11-01,Minnesota,3362977,2481189,2356904,124285
1992-11-01,Mississippi,1936566,1201351,1111230,90121
1992-11-01,Missouri,3936354,2645411,2484946,160465
1992-11-01,Montana,617819,420977,393495,27482
1992-11-01,Nebraska,1193531,850852,826499,24353
1992-11-01,Nevada,1064396,739227,688242,50985
1992-11-01,Ohio,8365528,5493262,5089793,403469
1992-11-01,Oklahoma,2399608,1524303,1439766,84537
1992-11-01,Oregon,2314467,1570738,1456383,114355
1992-11-01,Pennsylvania,9300351,5898329,5466080,432249
1992-11-01,Tennessee,3898828,2497978,2340837,157141
1992-11-01,Texas,13133047,9038283,8347206,691077
1992-11-01,Utah,1270695,897789,855771,42018
1992-11-01,Vermont,435853,314024,294647,19377
1992-11-01,Virginia,4809468,3372692,3176727,195965
1992-11-01,Washington,3895512,2674147,2471655,202492
1992-11-01,Wisconsin,3786942,2720767,2584438,136329
1992-11-01,Wyoming,341752,239564,227082,12482
1992-12-01,Alabama,3171875,1979921,1832107,147814
1992-12-01,Alaska,399690,289305,265602,23703
1992-12-01,Arizona,3005216,1892368,1756062,136306
1992-12-01,Arkansas,1839824,1157121,1081645,75476
1992-12-01,California,23121295,15303615,13804709,1498906
1992-12-01,Colorado,2662190,1880045,1765582,114463
1992-12-01,Connecticut,2555671,1808469,1678090,130379
1992-12-01,Delaware,532738,370233,352343,17890
1992-12-01,Florida,10780788,6677988,6142148,535840
1992-12-01,Georgia,5138391,3442534,3231106,211428
1992-12-01,Hawaii,845722,581041,554274,26767
1992-12-01,Idaho,788005,535008,500989,34019
1992-12-01,Illinois,8885961,6031255,5588698,442557
1992-12-01,Indiana,4315426,2878102,2712192,165910
1992-12-01,Iowa,2133812,1537372,1470667,66705
1992-12-01,Kansas,1868425,1317047,1254166,62881
1992-12-01,Kentucky,2874792,1792955,1674322,118633
1992-12-01,Louisiana,3130767,1906779,1762204,144575
1992-12-01,Maine,947166,635176,590985,44191
1992-12-01,Maryland,3754688,2650100,2485297,164803
1992-12-01,Massachusetts,4688642,3176975,2913066,263909
1992-12-01,Michigan,7153192,4665151,4295967,369184
1992-12-01,Minnesota,3366662,2483732,2359879,123853
1992-12-01,Mississippi,1938668,1201180,1113229,87951
1992-12-01,Missouri,3939936,2648802,2486475,162327
1992-12-01,Montana,618786,421081,393898,27183
1992-12-01,Nebraska,1194775,851487,826877,24610
1992-12-01,Nevada,1068322,742011,690790,51221
1992-12-01,Ohio,8369458,5488046,5089891,398155
1992-12-01,Oklahoma,2401796,1522805,1439081,83724
1992-12-01,Oregon,2318738,1573372,1459031,114341
1992-12-01,Pennsylvania,9302961,5893992,5467665,426327
1992-12-01,Tennessee,3903423,2502203,2344887,157316
1992-12-01,Texas,13154649,9044485,8355849,688636
1992-12-01,Utah,1275143,901952,860523,41429
1992-12-01,Vermont,436877,314110,294942,19168
1992-12-01,Virginia,4815595,3370676,3178635,192041
1992-12-01,Washington,3903755,2676812,2473075,203737
1992-12-01,Wisconsin,3791398,2718776,2588427,130349
1992-12-01,Wyoming,342773,239783,227314,12469
1993-01-01,Alabama,3175677,1982813,1834554,148259
1993-01-01,Alaska,399681,289801,266501,23300
1993-01-01,Arizona,3015000,1895248,1760662,134586
1993-01-01,Arkansas,1842236,1158246,1083745,74501
1993-01-01,California,23126387,15289957,13794715,1495242
1993-01-01,Colorado,2670168,1887890,1773832,114058
1993-01-01,Connecticut,2555134,1805654,1676706,128948
1993-01-01,Delaware,533814,370820,353183,17637
1993-01-01,Florida,10797143,6691256,6161848,529408
1993-01-01,Georgia,5148402,3449688,3240226,209462
1993-01-01,Hawaii,845853,581283,554692,26591
1993-01-01,Idaho,790005,535474,501615,33859
1993-01-01,Illinois,8893210,6032572,5579967,452605
1993-01-01,Indiana,4318993,2885573,2721878,163695
1993-01-01,Iowa,2135140,1539756,1473402,66354
1993-01-01,Kansas,1870437,1317529,1253911,63618
1993-01-01,Kentucky,2877842,1795300,1677526,117774
1993-01-01,Louisiana,3132788,1903889,1761123,142766
1993-01-01,Maine,947143,632804,589394,43410
1993-01-01,Maryland,3756513,2648973,2486279,162694
1993-01-01,Massachusetts,4689632,3178624,2919461,259163
1993-01-01,Michigan,7155891,4663640,4306941,356699
1993-01-01,Minnesota,3371347,2487321,2363409,123912
1993-01-01,Mississippi,1940770,1202381,1115964,86417
1993-01-01,Missouri,3943518,2653974,2489256,164718
1993-01-01,Montana,619752,421431,394519,26912
1993-01-01,Nebraska,1196019,852762,827837,24925
1993-01-01,Nevada,1072248,745239,693603,51636
1993-01-01,Ohio,8374387,5484708,5092052,392656
1993-01-01,Oklahoma,2402985,1522100,1438465,83635
1993-01-01,Oregon,2324008,1576788,1462517,114271
1993-01-01,Pennsylvania,9306571,5890752,5469561,421191
1993-01-01,Tennessee,3909018,2505004,2347753,157251
1993-01-01,Texas,13176250,9053364,8368981,684383
1993-01-01,Utah,1279592,906443,865682,40761
1993-01-01,Vermont,436902,314124,295253,18871
1993-01-01,Virginia,4821723,3369520,3181460,188060
1993-01-01,Washington,3911998,2679093,2475153,203940
1993-01-01,Wisconsin,3795853,2718337,2593030,125307
1993-01-01,Wyoming,342795,240078,227552,12526
1993-02-01,Alabama,3178479,1986436,1838024,148412
1993-02-01,Alaska,400672,290471,267451,23020
1993-02-01,Arizona,3023784,1899125,1766991,132134
1993-02-01,Arkansas,1845647,1160423,1086633,73790
1993-02-01,California,23128478,15278528,13789592,1488936
1993-02-01,Colorado,2678145,1895876,1782922,112954
1993-02-01,Connecticut,2554597,1803358,1676192,127166
1993-02-01,Delaware,533891,371487,353984,17503
1993-02-01,Florida,10811498,6706639,6183624,523015
1993-02-01,Georgia,5156413,3457373,3250375,206998
1993-02-01,Hawaii,846984,581604,555408,26196
1993-02-01,Idaho,792005,536588,502627,33961
1993-02-01,Illinois,8899459,6037582,5574177,463405
1993-02-01,Indiana,4323561,2897673,2734700,162973
1993-02-01,Iowa,2136468,1542591,1476612,65979
1993-02-01,Kansas,1872449,1318724,1254248,64476
1993-02-01,Kentucky,2880892,1798032,1680749,117283
1993-02-01,Louisiana,3134809,1902611,1761069,141542
1993-02-01,Maine,948120,631060,588297,42763
1993-02-01,Maryland,3757338,2648963,2487811,161152
1993-02-01,Massachusetts,4689623,3181158,2927212,253946
1993-02-01,Michigan,7158591,4668623,4320000,348623
1993-02-01,Minnesota,3375032,2491973,2367553,124420
1993-02-01,Mississippi,1941872,1204648,1119344,85304
1993-02-01,Missouri,3946099,2660360,2493295,167065
1993-02-01,Montana,620718,422040,395331,26709
1993-02-01,Nebraska,1197263,854565,829397,25168
1993-02-01,Nevada,1076173,748921,696728,52193
1993-02-01,Ohio,8377316,5483046,5096435,386611
1993-02-01,Oklahoma,2405174,1522707,1438462,84245
1993-02-01,Oregon,2328279,1580937,1466626,114311
1993-02-01,Pennsylvania,9308181,5888683,5471550,417133
1993-02-01,Tennessee,3913613,2507282,2350409,156873
1993-02-01,Texas,13195851,9064817,8386732,678085
1993-02-01,Utah,1283040,911363,871243,40120
1993-02-01,Vermont,436926,314163,295673,18490
1993-02-01,Virginia,4826851,3368837,3184656,184181
1993-02-01,Washington,3919242,2681685,2478375,203310
1993-02-01,Wisconsin,3799309,2720019,2598337,121682
1993-02-01,Wyoming,343816,240467,227852,12615
1993-03-01,Alabama,3182281,1990369,1842086,148283
1993-03-01,Alaska,401664,291297,268411,22886
1993-03-01,Arizona,3032568,1904411,1775344,129067
1993-03-01,Arkansas,1848059,1163508,1090192,73316
1993-03-01,California,23130570,15271158,13789663,1481495
1993-03-01,Colorado,2685123,1904000,1792908,111092
1993-03-01,Connecticut,2553060,1801806,1676702,125104
1993-03-01,Delaware,534967,372273,354738,17535
1993-03-01,Florida,10825854,6723186,6206293,516893
1993-03-01,Georgia,5165424,3465803,3261462,204341
1993-03-01,Hawaii,848115,581963,556255,25708
1993-03-01,Idaho,795005,538537,504334,34203
1993-03-01,Illinois,8905708,6047333,5575718,471615
1993-03-01,Indiana,4327128,2914157,2750687,163470
1993-03-01,Iowa,2137796,1546098,1480233,65865
1993-03-01,Kansas,1873461,1320656,1255309,65347
1993-03-01,Kentucky,2883941,1800814,1683780,117034
1993-03-01,Louisiana,3135830,1902581,1761801,140780
1993-03-01,Maine,948096,630110,587713,42397
1993-03-01,Maryland,3759162,2650334,2489703,160631
1993-03-01,Massachusetts,4689613,3184264,2935746,248518
1993-03-01,Michigan,7161291,4679471,4334572,344899
1993-03-01,Minnesota,3378717,2497323,2372288,125035
1993-03-01,Mississippi,1943974,1207300,1122977,84323
1993-03-01,Missouri,3948681,2667439,2498484,168955
1993-03-01,Montana,622684,422935,396337,26598
1993-03-01,Nebraska,1197506,856756,831521,25235
1993-03-01,Nevada,1079099,753018,700205,52813
1993-03-01,Ohio,8381246,5483474,5103600,379874
1993-03-01,Oklahoma,2406363,1524937,1439477,85460
1993-03-01,Oregon,2333549,1585427,1470833,114594
1993-03-01,Pennsylvania,9310791,5888614,5474080,414534
1993-03-01,Tennessee,3917208,2510794,2354538,156256
1993-03-01,Texas,13215453,9080228,8409093,671135
1993-03-01,Utah,1287488,916756,877204,39552
1993-03-01,Vermont,436950,314272,296232,18040
1993-03-01,Virginia,4831978,3368563,3187807,180756
1993-03-01,Washington,3927485,2685137,2482786,202351
1993-03-01,Wisconsin,3802764,2724096,2604497,119599
1993-03-01,Wyoming,343838,241010,228255,12755
1993-04-01,Alabama,3185083,1994118,1846262,147856
1993-04-01,Alaska,401655,292134,269288,22846
1993-04-01,Arizona,3042352,1911180,1785549,125631
1993-04-01,Arkansas,1850471,1166994,1094070,72924
1993-04-01,California,23133661,15267468,13794804,1472664
1993-04-01,Colorado,2693100,1911964,1803373,108591
1993-04-01,Connecticut,2552523,1800960,1678191,122769
1993-04-01,Delaware,535043,373231,355515,17716
1993-04-01,Florida,10841209,6739356,6228655,510701
1993-04-01,Georgia,5174435,3475005,3273413,201592
1993-04-01,Hawaii,848246,582332,557056,25276
1993-04-01,Idaho,797005,541369,506997,34372
1993-04-01,Illinois,8911957,6060654,5585213,475441
1993-04-01,Indiana,4331695,2933276,2768722,164554
1993-04-01,Iowa,2139124,1550145,1484237,65908
1993-04-01,Kansas,1875473,1323167,1257236,65931
1993-04-01,Kentucky,2886991,1803128,1686459,116669
1993-04-01,Louisiana,3137852,1902924,1762858,140066
1993-04-01,Maine,948073,629945,587571,42374
1993-04-01,Maryland,3760987,2653065,2492128,160937
1993-04-01,Massachusetts,4689603,3187448,2944494,242954
1993-04-01,Michigan,7163991,4693827,4349571,344256
1993-04-01,Minnesota,3382402,2502621,2377390,125231
1993-04-01,Mississippi,1945076,1209736,1126502,83234
1993-04-01,Missouri,3952262,2674790,2504743,170047
1993-04-01,Montana,623651,424003,397476,26527
1993-04-01,Nebraska,1198750,859171,834136,25035
1993-04-01,Nevada,1083025,757401,704023,53378
1993-04-01,Ohio,8385175,5486482,5114136,372346
1993-04-01,Oklahoma,2408552,1528375,1441628,86747
1993-04-01,Oregon,2337820,1589941,1474876,115065
1993-04-01,Pennsylvania,9313401,5890798,5477947,412851
1993-04-01,Tennessee,3922803,2516652,2361432,155220
1993-04-01,Texas,13236054,9100173,8436016,664157
1993-04-01,Utah,1291937,922585,883523,39062
1993-04-01,Vermont,437975,314436,296914,17522
1993-04-01,Virginia,4838106,3368674,3190843,177831
1993-04-01,Washington,3934728,2689446,2488073,201373
1993-04-01,Wisconsin,3807219,2729960,2611474,118486
1993-04-01,Wyoming,344859,241684,228781,12903
1993-05-01,Alabama,3188885,1997263,1850022,147241
1993-05-01,Alaska,402647,292919,270050,22869
1993-05-01,Arizona,3051135,1919395,1797064,122331
1993-05-01,Arkansas,1853883,1170394,1097819,72575
1993-05-01,California,23137753,15267275,13802686,1464589
1993-05-01,Colorado,2701078,1919228,1813304,105924
1993-05-01,Connecticut,2551986,1800731,1680395,120336
1993-05-01,Delaware,536119,374411,356424,17987
1993-05-01,Florida,10855564,6753816,6248870,504946
1993-05-01,Georgia,5183446,3485115,3285844,199271
1993-05-01,Hawaii,849378,582680,557705,24975
1993-05-01,Idaho,799005,545005,510603,34402
1993-05-01,Illinois,8918206,6075064,5599394,475670
1993-05-01,Indiana,4336263,2952768,2786716,166052
1993-05-01,Iowa,2140452,1554425,1488523,65902
1993-05-01,Kansas,1876484,1326074,1259861,66213
1993-05-01,Kentucky,2890041,1804466,1688569,115897
1993-05-01,Louisiana,3139873,1903162,1763802,139360
1993-05-01,Maine,948050,630417,587742,42675
1993-05-01,Maryland,3761812,2656708,2495176,161532
1993-05-01,Massachusetts,4689593,3190371,2952736,237635
1993-05-01,Michigan,7166690,4709205,4363890,345315
1993-05-01,Minnesota,3386087,2507334,2382446,124888
1993-05-01,Mississippi,1947178,1211694,1129578,82116
1993-05-01,Missouri,3955844,2682062,2511563,170499
1993-05-01,Montana,624617,425058,398594,26464
1993-05-01,Nebraska,1199994,861559,836936,24623
1993-05-01,Nevada,1086950,761877,708049,53828
1993-05-01,Ohio,8389105,5492274,5126754,365520
1993-05-01,Oklahoma,2409740,1532158,1444414,87744
1993-05-01,Oregon,2343090,1594213,1478666,115547
1993-05-01,Pennsylvania,9316011,5894799,5482806,411993
1993-05-01,Tennessee,3927398,2524457,2370675,153782
1993-05-01,Texas,13257655,9124710,8465902,658808
1993-05-01,Utah,1296385,928695,890018,38677
1993-05-01,Vermont,437999,314644,297664,16980
1993-05-01,Virginia,4844234,3369062,3193461,175601
1993-05-01,Washington,3942971,2694345,2493724,200621
1993-05-01,Wisconsin,3811675,2738075,2618950,119125
1993-05-01,Wyoming,344881,242439,229413,13026
1993-06-01,Alabama,3192688,1999503,1852992,146511
1993-06-01,Alaska,403638,293787,270865,22922
1993-06-01,Arizona,3060919,1929173,1809449,119724
1993-06-01,Arkansas,1856294,1173490,1101228,72262
1993-06-01,California,23142844,15268668,13809845,1458823
1993-06-01,Colorado,2709055,1925905,1822290,103615
1993-06-01,Connecticut,2551449,1800410,1682462,117948
1993-06-01,Delaware,537195,375712,357429,18283
1993-06-01,Florida,10871919,6765740,6265583,500157
1993-06-01,Georgia,5193457,3496010,3298249,197761
1993-06-01,Hawaii,850509,582878,558144,24734
1993-06-01,Idaho,802005,549091,514846,34245
1993-06-01,Illinois,8926454,6087885,5614494,473391
1993-06-01,Indiana,4340830,2970870,2802870,168000
1993-06-01,Iowa,2141780,1558366,1492643,65723
1993-06-01,Kansas,1878496,1329034,1262688,66346
1993-06-01,Kentucky,2894091,1804659,1690110,114549
1993-06-01,Louisiana,3141894,1903594,1764423,139171
1993-06-01,Maine,949027,631114,587988,43126
1993-06-01,Maryland,3763636,2660639,2498730,161909
1993-06-01,Massachusetts,4690583,3192647,2959736,232911
1993-06-01,Michigan,7170390,4723458,4376416,347042
1993-06-01,Minnesota,3390772,2511474,2387452,124022
1993-06-01,Mississippi,1949279,1213073,1131976,81097
1993-06-01,Missouri,3959425,2688893,2518263,170630
1993-06-01,Montana,625583,425917,399527,26390
1993-06-01,Nebraska,1201238,863719,839612,24107
1993-06-01,Nevada,1090876,766261,712154,54107
1993-06-01,Ohio,8394034,5500451,5139658,360793
1993-06-01,Oklahoma,2411929,1535719,1447185,88534
1993-06-01,Oregon,2348361,1598347,1482633,115714
1993-06-01,Pennsylvania,9319621,5899502,5487751,411751
1993-06-01,Tennessee,3931993,2532615,2380758,151857
1993-06-01,Texas,13279257,9152639,8496074,656565
1993-06-01,Utah,1300834,934860,896528,38332
1993-06-01,Vermont,438024,314830,298380,16450
1993-06-01,Virginia,4850361,3369503,3195385,174118
1993-06-01,Washington,3951214,2699323,2499447,199876
1993-06-01,Wisconsin,3816130,2742467,2626257,116210
1993-06-01,Wyoming,345902,243209,230089,13120
1993-07-01,Alabama,3196490,2000343,1854984,145359
1993-07-01,Alaska,403629,294642,271717,22925
1993-07-01,Arizona,3069703,1939882,1821831,118051
1993-07-01,Arkansas,1859706,1176229,1104352,71877
1993-07-01,California,23147936,15265798,13813359,1452439
1993-07-01,Colorado,2717033,1932228,1830566,101662
1993-07-01,Connecticut,2550912,1798730,1683311,115419
1993-07-01,Delaware,537271,376897,358327,18570
1993-07-01,Florida,10888274,6773849,6278475,495374
1993-07-01,Georgia,5202468,3506571,3309729,196842
1993-07-01,Hawaii,850640,582758,558215,24543
1993-07-01,Idaho,804005,553070,519203,33867
1993-07-01,Illinois,8933703,6095971,5628304,467667
1993-07-01,Indiana,4344398,2955351,2816180,139171
1993-07-01,Iowa,2143108,1561311,1496146,65165
1993-07-01,Kansas,1880508,1331417,1265084,66333
1993-07-01,Kentucky,2897141,1803554,1691116,112438
1993-07-01,Louisiana,3143916,1904463,1764949,139514
1993-07-01,Maine,949004,631422,587969,43453
1993-07-01,Maryland,3765461,2664136,2502554,161582
1993-07-01,Massachusetts,4691573,3193434,2965009,228425
1993-07-01,Michigan,7174090,4734367,4386395,347972
1993-07-01,Minnesota,3394458,2515110,2392639,122471
1993-07-01,Mississippi,1950381,1213807,1133651,80156
1993-07-01,Missouri,3963007,2694376,2524099,170277
1993-07-01,Montana,626550,426376,400147,26229
1993-07-01,Nebraska,1202482,865505,841891,23614
1993-07-01,Nevada,1094801,770273,716191,54082
1993-07-01,Ohio,8398963,5509394,5151218,358176
1993-07-01,Oklahoma,2414118,1538255,1449501,88754
1993-07-01,Oregon,2352631,1602678,1487665,115013
1993-07-01,Pennsylvania,9322231,5903091,5492507,410584
1993-07-01,Tennessee,3937588,2539492,2390470,149022
1993-07-01,Texas,13300858,9180267,8524094,656173
1993-07-01,Utah,1305282,940708,902845,37863
1993-07-01,Vermont,439048,314863,298925,15938
1993-07-01,Virginia,4856489,3369538,3196819,172719
1993-07-01,Washington,3959458,2703620,2505099,198521
1993-07-01,Wisconsin,3820586,2750116,2632761,117355
1993-07-01,Wyoming,345924,243892,230735,13157
1993-08-01,Alabama,3199292,2000375,1856654,143721
1993-08-01,Alaska,404621,295416,272535,22881
1993-08-01,Arizona,3083487,1951235,1833816,117419
1993-08-01,Arkansas,1862118,1178870,1107469,71401
1993-08-01,California,23155027,15258689,13813918,1444771
1993-08-01,Colorado,2725010,1938520,1838695,99825
1993-08-01,Connecticut,2551375,1795266,1682535,112731
1993-08-01,Delaware,538347,377823,359002,18821
1993-08-01,Florida,10908630,6779573,6289078,490495
1993-08-01,Georgia,5214478,3516546,3320002,196544
1993-08-01,Hawaii,851771,582430,557922,24508
1993-08-01,Idaho,806006,556736,523323,33413
1993-08-01,Illinois,8939952,6099394,5640571,458823
1993-08-01,Indiana,4348965,2958569,2826522,132047
1993-08-01,Iowa,2144436,1563031,1498853,64178
1993-08-01,Kansas,1882520,1333017,1266806,66211
1993-08-01,Kentucky,2900190,1801536,1691845,109691
1993-08-01,Louisiana,3145937,1906552,1766098,140454
1993-08-01,Maine,948981,631097,587599,43498
1993-08-01,Maryland,3769286,2666949,2506580,160369
1993-08-01,Massachusetts,4693563,3192494,2968432,224062
1993-08-01,Michigan,7179790,4742889,4395067,347822
1993-08-01,Minnesota,3399143,2519057,2398442,120615
1993-08-01,Mississippi,1953483,1214536,1135165,79371
1993-08-01,Missouri,3967588,2698270,2529051,169219
1993-08-01,Montana,628516,426558,400636,25922
1993-08-01,Nebraska,1203725,867001,843801,23200
1993-08-01,Nevada,1100727,773912,720159,53753
1993-08-01,Ohio,8402893,5517289,5160078,357211
1993-08-01,Oklahoma,2416307,1539824,1451526,88298
1993-08-01,Oregon,2356902,1607704,1494512,113192
1993-08-01,Pennsylvania,9326841,5904805,5497078,407727
1993-08-01,Tennessee,3943183,2545017,2399612,145405
1993-08-01,Texas,13325460,9205425,8549772,655653
1993-08-01,Utah,1309730,946161,908920,37241
1993-08-01,Vermont,439072,314710,299239,15471
1993-08-01,Virginia,4862616,3369472,3198412,171060
1993-08-01,Washington,3966701,2707113,2511039,196074
1993-08-01,Wisconsin,3824041,2756538,2638766,117772
1993-08-01,Wyoming,346945,244486,231338,13148
1993-09-01,Alabama,3203094,2000625,1858865,141760
1993-09-01,Alaska,404612,296232,273380,22852
1993-09-01,Arizona,3096271,1963799,1845990,117809
1993-09-01,Arkansas,1864530,1181693,1110829,70864
1993-09-01,California,23163119,15252455,13815494,1436961
1993-09-01,Colorado,2732988,1945497,1847328,98169
1993-09-01,Connecticut,2551838,1790639,1680578,110061
1993-09-01,Delaware,539423,378555,359516,19039
1993-09-01,Florida,10929985,6786784,6300797,485987
1993-09-01,Georgia,5227489,3527050,3330101,196949
1993-09-01,Hawaii,852902,582258,557491,24767
1993-09-01,Idaho,809006,560213,527224,32989
1993-09-01,Illinois,8946201,6100971,5652834,448137
1993-09-01,Indiana,4353532,2966890,2834918,131972
1993-09-01,Iowa,2146765,1563742,1500766,62976
1993-09-01,Kansas,1884532,1334130,1268104,66026
1993-09-01,Kentucky,2902240,1799435,1692468,106967
1993-09-01,Louisiana,3148958,1910860,1768624,142236
1993-09-01,Maine,949957,630412,587103,43309
1993-09-01,Maryland,3772110,2669417,2510964,158453
1993-09-01,Massachusetts,4696553,3190426,2970390,220036
1993-09-01,Michigan,7185489,4752235,4404559,347676
1993-09-01,Minnesota,3403828,2524282,2405393,118889
1993-09-01,Mississippi,1955585,1215998,1137048,78950
1993-09-01,Missouri,3972170,2701283,2533911,167372
1993-09-01,Montana,629482,426746,401245,25501
1993-09-01,Nebraska,1204969,868634,845718,22916
1993-09-01,Nevada,1106653,777461,724214,53247
1993-09-01,Ohio,8406822,5524166,5167183,356983
1993-09-01,Oklahoma,2418496,1541252,1453637,87615
1993-09-01,Oregon,2361172,1613569,1502993,110576
1993-09-01,Pennsylvania,9330451,5904806,5501233,403573
1993-09-01,Tennessee,3949778,2550105,2408380,141725
1993-09-01,Texas,13350061,9228929,8574677,654252
1993-09-01,Utah,1315179,951456,914886,36570
1993-09-01,Vermont,439097,314451,299385,15066
1993-09-01,Virginia,4868744,3370048,3200590,169458
1993-09-01,Washington,3973944,2710651,2517940,192711
1993-09-01,Wisconsin,3828497,2763514,2645195,118319
1993-09-01,Wyoming,347967,245051,231928,13123
1993-10-01,Alabama,3206896,2001456,1861721,139735
1993-10-01,Alaska,405603,297112,274242,22870
1993-10-01,Arizona,3110054,1978201,1859101,119100
1993-10-01,Arkansas,1867942,1184585,1114240,70345
1993-10-01,California,23171210,15250959,13821036,1429923
1993-10-01,Colorado,2741965,1953568,1856680,96888
1993-10-01,Connecticut,2551301,1785581,1677928,107653
1993-10-01,Delaware,539499,379232,359990,19242
1993-10-01,Florida,10950340,6797955,6315414,482541
1993-10-01,Georgia,5239500,3538578,3340671,197907
1993-10-01,Hawaii,854033,582384,557009,25375
1993-10-01,Idaho,811006,563715,531071,32644
1993-10-01,Illinois,8952450,6102433,5665453,436980
1993-10-01,Indiana,4357100,2977209,2842410,134799
1993-10-01,Iowa,2148093,1563772,1501879,61893
1993-10-01,Kansas,1886543,1335137,1269245,65892
1993-10-01,Kentucky,2905290,1797894,1693077,104817
1993-10-01,Louisiana,3150980,1917465,1772662,144803
1993-10-01,Maine,949934,629651,586622,43029
1993-10-01,Maryland,3774935,2671689,2515421,156268
1993-10-01,Massachusetts,4699543,3188258,2971639,216619
1993-10-01,Michigan,7190189,4763933,4415547,348386
1993-10-01,Minnesota,3408513,2530908,2413260,117648
1993-10-01,Mississippi,1957687,1218158,1139234,78924
1993-10-01,Missouri,3976752,2704139,2539252,164887
1993-10-01,Montana,630448,427114,402044,25070
1993-10-01,Nebraska,1206213,870672,847814,22858
1993-10-01,Nevada,1111578,781131,728410,52721
1993-10-01,Ohio,8411751,5531837,5174820,357017
1993-10-01,Oklahoma,2420684,1542875,1455795,87080
1993-10-01,Oregon,2366443,1619726,1511903,107823
1993-10-01,Pennsylvania,9335061,5903909,5504642,399267
1993-10-01,Tennessee,3956373,2555744,2417105,138639
1993-10-01,Texas,13374662,9251521,8598569,652952
1993-10-01,Utah,1319627,956777,920769,36008
1993-10-01,Vermont,440121,314223,299487,14736
1993-10-01,Virginia,4874872,3371441,3203080,168361
1993-10-01,Washington,3981187,2714629,2525361,189268
1993-10-01,Wisconsin,3831952,2771882,2652046,119836
1993-10-01,Wyoming,347988,245618,232524,13094
1993-11-01,Alabama,3209698,2003156,1865241,137915
1993-11-01,Alaska,405595,298013,275031,22982
1993-11-01,Arizona,3122838,1994504,1873490,121014
1993-11-01,Arkansas,1869353,1187385,1117434,69951
1993-11-01,California,23175302,15256636,13831117,1425519
1993-11-01,Colorado,2749943,1962702,1866517,96185
1993-11-01,Connecticut,2551765,1780862,1675116,105746
1993-11-01,Delaware,540575,379904,360445,19459
1993-11-01,Florida,10969695,6814100,6332846,481254
1993-11-01,Georgia,5250511,3550732,3351506,199226
1993-11-01,Hawaii,854165,582789,556467,26322
1993-11-01,Idaho,814006,567445,535057,32388
1993-11-01,Illinois,8957699,6104681,5678151,426530
1993-11-01,Indiana,4361667,2988256,2849201,139055
1993-11-01,Iowa,2149421,1563624,1502434,61190
1993-11-01,Kansas,1887555,1336432,1270388,66044
1993-11-01,Kentucky,2908340,1797480,1694082,103398
1993-11-01,Louisiana,3153001,1925458,1777631,147827
1993-11-01,Maine,949911,628953,586189,42764
1993-11-01,Maryland,3777760,2673674,2519557,154117
1993-11-01,Massachusetts,4701533,3186739,2972567,214172
1993-11-01,Michigan,7194889,4777517,4427728,349789
1993-11-01,Minnesota,3412198,2538381,2421384,116997
1993-11-01,Mississippi,1960789,1220881,1141589,79292
1993-11-01,Missouri,3980333,2707341,2545165,162176
1993-11-01,Montana,632415,427773,403029,24744
1993-11-01,Nebraska,1206457,873013,849916,23097
1993-11-01,Nevada,1117504,785042,732704,52338
1993-11-01,Ohio,8414681,5541577,5184165,357412
1993-11-01,Oklahoma,2421873,1544856,1457876,86980
1993-11-01,Oregon,2369713,1625278,1520004,105274
1993-11-01,Pennsylvania,9337671,5903034,5506832,396202
1993-11-01,Tennessee,3961969,2563458,2427033,136425
1993-11-01,Texas,13397264,9274088,8620928,653160
1993-11-01,Utah,1324076,962209,926496,35713
1993-11-01,Vermont,440145,314128,299642,14486
1993-11-01,Virginia,4880999,3374027,3205870,168157
1993-11-01,Washington,3988430,2718910,2532384,186526
1993-11-01,Wisconsin,3836408,2781296,2658852,122444
1993-11-01,Wyoming,349010,246217,233127,13090
1993-12-01,Alabama,3212500,2006031,1869779,136252
1993-12-01,Alaska,406586,298901,275712,23189
1993-12-01,Arizona,3135622,2012268,1889168,123100
1993-12-01,Arkansas,1871765,1190118,1120466,69652
1993-12-01,California,23178393,15268411,13845982,1422429
1993-12-01,Colorado,2756920,1972836,1876955,95881
1993-12-01,Connecticut,2551228,1776945,1672663,104282
1993-12-01,Delaware,540651,380608,360925,19683
1993-12-01,Florida,10988050,6834333,6352544,481789
1993-12-01,Georgia,5261522,3562676,3362332,200344
1993-12-01,Hawaii,855296,583337,555855,27482
1993-12-01,Idaho,816006,571468,539284,32184
1993-12-01,Illinois,8961948,6107986,5691519,416467
1993-12-01,Indiana,4364235,2999139,2855982,143157
1993-12-01,Iowa,2150749,1563681,1502851,60830
1993-12-01,Kansas,1889567,1338253,1271866,66387
1993-12-01,Kentucky,2910390,1798836,1696308,102528
1993-12-01,Louisiana,3155022,1933286,1782625,150661
1993-12-01,Maine,950888,628385,585860,42525
1993-12-01,Maryland,3780584,2675527,2523417,152110
1993-12-01,Massachusetts,4702523,3186200,2973668,212532
1993-12-01,Michigan,7199589,4790667,4440881,349786
1993-12-01,Minnesota,3415883,2545963,2429645,116318
1993-12-01,Mississippi,1962891,1224074,1144213,79861
1993-12-01,Missouri,3983915,2711011,2551798,159213
1993-12-01,Montana,633381,428790,404247,24543
1993-12-01,Nebraska,1207700,875491,851961,23530
1993-12-01,Nevada,1123429,789210,737101,52109
1993-12-01,Ohio,8417610,5553466,5195731,357735
1993-12-01,Oklahoma,2424062,1547225,1459961,87264
1993-12-01,Oregon,2373984,1629680,1526793,102887
1993-12-01,Pennsylvania,9339281,5902449,5507784,394665
1993-12-01,Tennessee,3967564,2574529,2439642,134887
1993-12-01,Texas,13418865,9297086,8642673,654413
1993-12-01,Utah,1328524,967791,932101,35690
1993-12-01,Vermont,441170,314212,299899,14313
1993-12-01,Virginia,4886127,3378041,3209234,168807
1993-12-01,Washington,3994674,2723098,2538354,184744
1993-12-01,Wisconsin,3839863,2790858,2665632,125226
1993-12-01,Wyoming,349031,246884,233773,13111
1994-01-01,Alabama,3215302,2009497,1875035,134462
1994-01-01,Alaska,406578,299594,276202,23392
1994-01-01,Arizona,3147406,2030213,1905081,125132
1994-01-01,Arkansas,1874177,1192747,1123416,69331
1994-01-01,California,23179485,15280494,13863654,1416840
1994-01-01,Colorado,2764898,1983097,1887673,95424
1994-01-01,Connecticut,2550691,1773499,1670478,103021
1994-01-01,Delaware,541727,381306,361460,19846
1994-01-01,Florida,11006406,6855397,6373118,482279
1994-01-01,Georgia,5272533,3572920,3372684,200236
1994-01-01,Hawaii,855427,583696,555125,28571
1994-01-01,Idaho,818006,575487,543532,31955
1994-01-01,Illinois,8966197,6111087,5705574,405513
1994-01-01,Indiana,4367802,3008700,2863131,145569
1994-01-01,Iowa,2152077,1564177,1503584,60593
1994-01-01,Kansas,1890579,1340210,1273736,66474
1994-01-01,Kentucky,2912439,1801677,1699894,101783
1994-01-01,Louisiana,3156043,1939183,1786629,152554
1994-01-01,Maine,950865,627821,585553,42268
1994-01-01,Maryland,3782409,2677017,2526939,150078
1994-01-01,Massachusetts,4704513,3186163,2975067,211096
1994-01-01,Michigan,7203288,4799540,4453975,345565
1994-01-01,Minnesota,3419568,2552802,2437976,114826
1994-01-01,Mississippi,1963993,1227249,1146958,80291
1994-01-01,Missouri,3987496,2714420,2558738,155682
1994-01-01,Montana,634347,430000,405619,24381
1994-01-01,Nebraska,1208944,877736,853829,23907
1994-01-01,Nevada,1128355,793383,741457,51926
1994-01-01,Ohio,8419540,5565818,5208940,356878
1994-01-01,Oklahoma,2425251,1549364,1461772,87592
1994-01-01,Oregon,2377254,1632670,1532084,100586
1994-01-01,Pennsylvania,9340891,5902169,5508420,393749
1994-01-01,Tennessee,3973159,2588784,2455254,133530
1994-01-01,Texas,13440466,9318616,8663719,654897
1994-01-01,Utah,1332973,973250,937464,35786
1994-01-01,Vermont,441194,314412,300224,14188
1994-01-01,Virginia,4891255,3383003,3213179,169824
1994-01-01,Washington,4000917,2726284,2542783,183501
1994-01-01,Wisconsin,3842319,2799236,2672111,127125
1994-01-01,Wyoming,350052,247563,234438,13125
1994-02-01,Alabama,3217104,2012659,1880447,132212
1994-02-01,Alaska,406569,299978,276458,23520
1994-02-01,Arizona,3159189,2046720,1919830,126890
1994-02-01,Arkansas,1875589,1195139,1126245,68894
1994-02-01,California,23176576,15285958,13880192,1405766
1994-02-01,Colorado,2771875,1992261,1897944,94317
1994-02-01,Connecticut,2549154,1769918,1668209,101709
1994-02-01,Delaware,541803,381938,362059,19879
1994-02-01,Florida,11022761,6873541,6392868,480673
1994-02-01,Georgia,5282544,3580602,3382216,198386
1994-02-01,Hawaii,856558,583635,554256,29379
1994-02-01,Idaho,820006,579147,547422,31725
1994-02-01,Illinois,8968446,6111788,5718309,393479
1994-02-01,Indiana,4369369,3015428,2869525,145903
1994-02-01,Iowa,2152405,1565121,1505132,59989
1994-02-01,Kansas,1891591,1341690,1275643,66047
1994-02-01,Kentucky,2913489,1805211,1704309,100902
1994-02-01,Louisiana,3157065,1942270,1789169,153101
1994-02-01,Maine,950842,627187,585163,42024
1994-02-01,Maryland,3784234,2677814,2530041,147773
1994-02-01,Massachusetts,4704503,3186010,2976737,209273
1994-02-01,Michigan,7204988,4801178,4465125,336053
1994-02-01,Minnesota,3423253,2558073,2445829,112244
1994-02-01,Mississippi,1966095,1230167,1149748,80419
1994-02-01,Missouri,3990078,2716752,2565280,151472
1994-02-01,Montana,635313,431148,406960,24188
1994-02-01,Nebraska,1209188,879348,855322,24026
1994-02-01,Nevada,1134281,797215,745536,51679
1994-02-01,Ohio,8419469,5574928,5220943,353985
1994-02-01,Oklahoma,2426439,1550498,1462939,87559
1994-02-01,Oregon,2380525,1634095,1535979,98116
1994-02-01,Pennsylvania,9340501,5901585,5509307,392278
1994-02-01,Tennessee,3977754,2604269,2472379,131890
1994-02-01,Texas,13458068,9336299,8683410,652889
1994-02-01,Utah,1337421,978262,942353,35909
1994-02-01,Vermont,441218,314607,300540,14067
1994-02-01,Virginia,4895382,3387912,3217421,170491
1994-02-01,Washington,4006160,2727628,2545550,182078
1994-02-01,Wisconsin,3844774,2805251,2677780,127471
1994-02-01,Wyoming,350074,248142,235056,13086
1994-03-01,Alabama,3219906,2015266,1885645,129621
1994-03-01,Alaska,407560,300133,276557,23576
1994-03-01,Arizona,3171973,2061175,1932703,128472
1994-03-01,Arkansas,1878000,1197349,1128950,68399
1994-03-01,California,23176668,15281558,13891567,1389991
1994-03-01,Colorado,2779853,2000275,1907743,92532
1994-03-01,Connecticut,2548617,1766008,1665680,100328
1994-03-01,Delaware,542879,382495,362738,19757
1994-03-01,Florida,11040116,6887315,6410980,476335
1994-03-01,Georgia,5292555,3585824,3390752,195072
1994-03-01,Hawaii,856689,583129,553262,29867
1994-03-01,Idaho,822006,582144,550581,31563
1994-03-01,Illinois,8972695,6108715,5727208,381507
1994-03-01,Indiana,4372937,3019086,2874092,144994
1994-03-01,Iowa,2153733,1566457,1507639,58818
1994-03-01,Kansas,1892603,1342532,1277261,65271
1994-03-01,Kentucky,2915539,1808883,1709026,99857
1994-03-01,Louisiana,3159086,1943107,1790511,152596
1994-03-01,Maine,950818,626474,584581,41893
1994-03-01,Maryland,3786058,2677975,2532660,145315
1994-03-01,Massachusetts,4705493,3185717,2978743,206974
1994-03-01,Michigan,7207688,4796361,4473259,323102
1994-03-01,Minnesota,3426938,2561665,2452644,109021
1994-03-01,Mississippi,1968196,1232960,1152642,80318
1994-03-01,Missouri,3993659,2718168,2571084,147084
1994-03-01,Montana,636280,432162,408203,23959
1994-03-01,Nebraska,1210432,880202,856369,23833
1994-03-01,Nevada,1139206,800589,749217,51372
1994-03-01,Ohio,8421398,5576973,5227714,349259
1994-03-01,Oklahoma,2427628,1550408,1463315,87093
1994-03-01,Oregon,2384795,1634809,1539425,95384
1994-03-01,Pennsylvania,9342111,5899798,5510011,389787
1994-03-01,Tennessee,3982349,2618993,2488951,130042
1994-03-01,Texas,13478669,9349793,8701323,648470
1994-03-01,Utah,1341869,982731,946647,36084
1994-03-01,Vermont,441243,314747,300790,13957
1994-03-01,Virginia,4899510,3392137,3221692,170445
1994-03-01,Washington,4012403,2727485,2547422,180063
1994-03-01,Wisconsin,3847230,2808366,2682031,126335
1994-03-01,Wyoming,351095,248586,235615,12971
1994-04-01,Alabama,3222708,2017666,1890547,127119
1994-04-01,Alaska,407552,300229,276683,23546
1994-04-01,Arizona,3184757,2073864,1943800,130064
1994-04-01,Arkansas,1880412,1199791,1131928,67863
1994-04-01,California,23180760,15268995,13897431,1371564
1994-04-01,Colorado,2786830,2008215,1918000,90215
1994-04-01,Connecticut,2549080,1761909,1662907,99002
1994-04-01,Delaware,542955,382937,363462,19475
1994-04-01,Florida,11058471,6897714,6427946,469768
1994-04-01,Georgia,5304565,3589321,3398398,190923
1994-04-01,Hawaii,857820,582376,552260,30116
1994-04-01,Idaho,825007,584374,552884,31490
1994-04-01,Illinois,8977944,6103028,5733097,369931
1994-04-01,Indiana,4376504,3021777,2878021,143756
1994-04-01,Iowa,2155061,1568426,1510972,57454
1994-04-01,Kansas,1894614,1342835,1278403,64432
1994-04-01,Kentucky,2917589,1812660,1713927,98733
1994-04-01,Louisiana,3161107,1943213,1791625,151588
1994-04-01,Maine,950795,625678,583838,41840
1994-04-01,Maryland,3788883,2678080,2535027,143053
1994-04-01,Massachusetts,4707483,3185942,2981538,204404
1994-04-01,Michigan,7212388,4789169,4479675,309494
1994-04-01,Minnesota,3430623,2564649,2458856,105793
1994-04-01,Mississippi,1970298,1235547,1155695,79852
1994-04-01,Missouri,3997241,2719331,2576307,143024
1994-04-01,Montana,637246,433193,409453,23740
1994-04-01,Nebraska,1210675,880507,857094,23413
1994-04-01,Nevada,1145132,803602,752564,51038
1994-04-01,Ohio,8424328,5571443,5228364,343079
1994-04-01,Oklahoma,2429817,1549578,1463324,86254
1994-04-01,Oregon,2388066,1636007,1543488,92519
1994-04-01,Pennsylvania,9344721,5896826,5510594,386232
1994-04-01,Tennessee,3987944,2632235,2503915,128320
1994-04-01,Texas,13501270,9360326,8718051,642275
1994-04-01,Utah,1346318,986720,950415,36305
1994-04-01,Vermont,442267,314827,300942,13885
1994-04-01,Virginia,4905638,3396129,3226479,169650
1994-04-01,Washington,4018646,2727242,2549921,177321
1994-04-01,Wisconsin,3851685,2809434,2685217,124217
1994-04-01,Wyoming,351117,248933,236145,12788
1994-05-01,Alabama,3225510,2020873,1895841,125032
1994-05-01,Alaska,408543,300393,276975,23418
1994-05-01,Arizona,3196541,2085610,1953923,131687
1994-05-01,Arkansas,1881824,1202710,1135460,67250
1994-05-01,California,23181851,15254424,13902417,1352007
1994-05-01,Colorado,2794808,2017295,1929764,87531
1994-05-01,Connecticut,2547543,1758020,1660175,97845
1994-05-01,Delaware,544032,383279,364242,19037
1994-05-01,Florida,11076827,6907276,6445484,461792
1994-05-01,Georgia,5314576,3592770,3406158,186612
1994-05-01,Hawaii,857951,581718,551423,30295
1994-05-01,Idaho,827007,586003,554457,31546
1994-05-01,Illinois,8981193,6098520,5739075,359445
1994-05-01,Indiana,4379071,3026365,2883379,142986
1994-05-01,Iowa,2156389,1570896,1514652,56244
1994-05-01,Kansas,1895626,1342949,1279250,63699
1994-05-01,Kentucky,2919638,1817154,1719363,97791
1994-05-01,Louisiana,3162129,1944158,1793586,150572
1994-05-01,Maine,950772,624954,583118,41836
1994-05-01,Maryland,3790708,2679162,2537915,141247
1994-05-01,Massachusetts,4708474,3187386,2985591,201795
1994-05-01,Michigan,7216088,4784569,4486816,297753
1994-05-01,Minnesota,3434308,2568356,2465141,103215
1994-05-01,Mississippi,1972400,1238174,1159228,78946
1994-05-01,Missouri,4000822,2721518,2581907,139611
1994-05-01,Montana,639212,434390,410811,23579
1994-05-01,Nebraska,1211919,880778,857862,22916
1994-05-01,Nevada,1150058,806507,755777,50730
1994-05-01,Ohio,8426257,5561958,5226614,335344
1994-05-01,Oklahoma,2431006,1548854,1463813,85041
1994-05-01,Oregon,2392336,1638162,1548480,89682
1994-05-01,Pennsylvania,9346331,5893678,5511867,381811
1994-05-01,Tennessee,3993539,2644086,2517058,127028
1994-05-01,Texas,13521872,9370215,8735679,634536
1994-05-01,Utah,1350766,990451,953867,36584
1994-05-01,Vermont,442292,314922,301050,13872
1994-05-01,Virginia,4909765,3400847,3232668,168179
1994-05-01,Washington,4024890,2728117,2554115,174002
1994-05-01,Wisconsin,3854141,2810531,2688643,121888
1994-05-01,Wyoming,352138,249225,236667,12558
1994-06-01,Alabama,3228313,2025757,1902131,123626
1994-06-01,Alaska,408534,300585,277381,23204
1994-06-01,Arizona,3209325,2097345,1964149,133196
1994-06-01,Arkansas,1884236,1205912,1139365,66547
1994-06-01,California,23185943,15244302,13911550,1332752
1994-06-01,Colorado,2802785,2027947,1943129,84818
1994-06-01,Connecticut,2548006,1754857,1657867,96990
1994-06-01,Delaware,544108,383640,365143,18497
1994-06-01,Florida,11096182,6919101,6465458,453643
1994-06-01,Georgia,5326587,3597778,3415032,182746
1994-06-01,Hawaii,859083,581447,550924,30523
1994-06-01,Idaho,829007,587324,555565,31759
1994-06-01,Illinois,8986441,6098205,5746597,351608
1994-06-01,Indiana,4382639,3034361,2891283,143078
1994-06-01,Iowa,2157717,1573626,1518164,55462
1994-06-01,Kansas,1897638,1343420,1280213,63207
1994-06-01,Kentucky,2921688,1822688,1725473,97215
1994-06-01,Louisiana,3164150,1946762,1796948,149814
1994-06-01,Maine,951749,624521,582670,41851
1994-06-01,Maryland,3793532,2681804,2541919,139885
1994-06-01,Massachusetts,4710464,3190207,2990728,199479
1994-06-01,Michigan,7220787,4785633,4496481,289152
1994-06-01,Minnesota,3437993,2573300,2471717,101583
1994-06-01,Mississippi,1974502,1241252,1163292,77960
1994-06-01,Missouri,4004404,2726019,2588791,137228
1994-06-01,Montana,640179,435758,412246,23512
1994-06-01,Nebraska,1213163,881552,859036,22516
1994-06-01,Nevada,1155983,809572,759030,50542
1994-06-01,Ohio,8429186,5553253,5227088,326165
1994-06-01,Oklahoma,2433195,1548865,1465362,83503
1994-06-01,Oregon,2395607,1641030,1553914,87116
1994-06-01,Pennsylvania,9348941,5890819,5513969,376850
1994-06-01,Tennessee,3999134,2654655,2528423,126232
1994-06-01,Texas,13544473,9381834,8756361,625473
1994-06-01,Utah,1355215,994138,957166,36972
1994-06-01,Vermont,442316,315102,301184,13918
1994-06-01,Virginia,4915893,3406855,3240578,166277
1994-06-01,Washington,4031133,2731040,2560228,170812
1994-06-01,Wisconsin,3857596,2813342,2693450,119892
1994-06-01,Wyoming,353160,249512,237208,12304
1994-07-01,Alabama,3231115,2032389,1909474,122915
1994-07-01,Alaska,409526,300806,277837,22969
1994-07-01,Arizona,3222108,2110075,1975724,134351
1994-07-01,Arkansas,1886648,1208976,1143219,65757
1994-07-01,California,23189034,15242769,13927712,1315057
1994-07-01,Colorado,2810763,2039930,1957488,82442
1994-07-01,Connecticut,2547469,1752998,1656452,96546
1994-07-01,Delaware,545184,384157,366224,17933
1994-07-01,Florida,11114537,6935216,6488835,446381
1994-07-01,Georgia,5337598,3605169,3425499,179670
1994-07-01,Hawaii,860214,581746,550956,30790
1994-07-01,Idaho,831007,588724,556578,32146
1994-07-01,Illinois,8990690,6102240,5755382,346858
1994-07-01,Indiana,4386206,3046365,2902575,143790
1994-07-01,Iowa,2159046,1576478,1521224,55254
1994-07-01,Kansas,1899650,1344647,1281514,63133
1994-07-01,Kentucky,2923738,1829309,1732195,97114
1994-07-01,Louisiana,3166171,1951069,1801656,149413
1994-07-01,Maine,951726,624667,582893,41774
1994-07-01,Maryland,3796357,2686219,2547302,138917
1994-07-01,Massachusetts,4712454,3194544,2996765,197779
1994-07-01,Michigan,7224487,4792497,4509275,283222
1994-07-01,Minnesota,3441678,2579621,2478728,100893
1994-07-01,Mississippi,1976604,1244881,1167575,77306
1994-07-01,Missouri,4008986,2733548,2597261,136287
1994-07-01,Montana,641145,437288,413693,23595
1994-07-01,Nebraska,1214407,883230,860833,22397
1994-07-01,Nevada,1161909,812977,762470,50507
1994-07-01,Ohio,8432116,5549614,5233773,315841
1994-07-01,Oklahoma,2434383,1550045,1468036,82009
1994-07-01,Oregon,2399877,1644128,1559156,84972
1994-07-01,Pennsylvania,9350551,5888927,5516746,372181
1994-07-01,Tennessee,4004729,2664691,2538772,125919
1994-07-01,Texas,13567074,9396868,8780774,616094
1994-07-01,Utah,1359663,997905,960460,37445
1994-07-01,Vermont,443340,315453,301445,14008
1994-07-01,Virginia,4921021,3414389,3249946,164443
1994-07-01,Washington,4038376,2736535,2568007,168528
1994-07-01,Wisconsin,3861052,2818474,2700054,118420
1994-07-01,Wyoming,353181,249857,237802,12055
1994-08-01,Alabama,3232917,2039982,1917265,122717
1994-08-01,Alaska,409517,301153,278404,22749
1994-08-01,Arizona,3233892,2123754,1989018,134736
1994-08-01,Arkansas,1889059,1211493,1146660,64833
1994-08-01,California,23197126,15248084,13950128,1297956
1994-08-01,Colorado,2817740,2052297,1971771,80526
1994-08-01,Connecticut,2547932,1752328,1655967,96361
1994-08-01,Delaware,546260,384805,367410,17395
1994-08-01,Florida,11134892,6954199,6514207,439992
1994-08-01,Georgia,5348609,3614126,3437088,177038
1994-08-01,Hawaii,860345,582509,551501,31008
1994-08-01,Idaho,834007,590267,557671,32596
1994-08-01,Illinois,8995939,6108666,5765270,343396
1994-08-01,Indiana,4390774,3061796,2917598,144198
1994-08-01,Iowa,2160374,1579098,1523596,55502
1994-08-01,Kansas,1901662,1346657,1283138,63519
1994-08-01,Kentucky,2926788,1836571,1739282,97289
1994-08-01,Louisiana,3169192,1956093,1807022,149071
1994-08-01,Maine,951703,625461,583928,41533
1994-08-01,Maryland,3798182,2691826,2553748,138078
1994-08-01,Massachusetts,4715444,3199936,3003426,196510
1994-08-01,Michigan,7230187,4802118,4523899,278219
1994-08-01,Minnesota,3446363,2586900,2486198,100702
1994-08-01,Mississippi,1978706,1248719,1171578,77141
1994-08-01,Missouri,4012567,2743436,2606842,136594
1994-08-01,Montana,642111,438797,414975,23822
1994-08-01,Nebraska,1215650,885754,863146,22608
1994-08-01,Nevada,1166834,816613,766073,50540
1994-08-01,Ohio,8437045,5552350,5247921,304429
1994-08-01,Oklahoma,2436572,1552059,1471318,80741
1994-08-01,Oregon,2404148,1646764,1563637,83127
1994-08-01,Pennsylvania,9354161,5887757,5519986,367771
1994-08-01,Tennessee,4011324,2674775,2548882,125893
1994-08-01,Texas,13589676,9414553,8807408,607145
1994-08-01,Utah,1364112,1001623,963716,37907
1994-08-01,Vermont,443365,315980,301905,14075
1994-08-01,Virginia,4926148,3423049,3260143,162906
1994-08-01,Washington,4045619,2743711,2576572,167139
1994-08-01,Wisconsin,3865507,2825261,2708090,117171
1994-08-01,Wyoming,354203,250258,238426,11832
1994-09-01,Alabama,3235719,2047405,1924730,122675
1994-09-01,Alaska,410509,301488,278958,22530
1994-09-01,Arizona,3244676,2137542,2003746,133796
1994-09-01,Arkansas,1891471,1213495,1149686,63809
1994-09-01,California,23206217,15255392,13976634,1278758
1994-09-01,Colorado,2824718,2063961,1984998,78963
1994-09-01,Connecticut,2548395,1752316,1656200,96116
1994-09-01,Delaware,546336,385463,368568,16895
1994-09-01,Florida,11155247,6972615,6539152,433463
1994-09-01,Georgia,5359620,3622879,3448677,174202
1994-09-01,Hawaii,861476,583376,552343,31033
1994-09-01,Idaho,836007,591737,558767,32970
1994-09-01,Illinois,9001188,6116050,5777206,338844
1994-09-01,Indiana,4394341,3078788,2935537,143251
1994-09-01,Iowa,2162702,1581340,1525512,55828
1994-09-01,Kansas,1903673,1349097,1284970,64127
1994-09-01,Kentucky,2930838,1843686,1746384,97302
1994-09-01,Louisiana,3171214,1960407,1812195,148212
1994-09-01,Maine,952679,626751,585688,41063
1994-09-01,Maryland,3801006,2697693,2560643,137050
1994-09-01,Massachusetts,4719434,3205457,3010378,195079
1994-09-01,Michigan,7236887,4810769,4538546,272223
1994-09-01,Minnesota,3451048,2594705,2494182,100523
1994-09-01,Mississippi,1980808,1252275,1175046,77229
1994-09-01,Missouri,4016149,2753967,2616476,137491
1994-09-01,Montana,644077,440035,415963,24072
1994-09-01,Nebraska,1216894,888581,865603,22978
1994-09-01,Nevada,1172760,820201,769706,50495
1994-09-01,Ohio,8442975,5559306,5267266,292040
1994-09-01,Oklahoma,2438761,1554122,1474719,79403
1994-09-01,Oregon,2408418,1648539,1567115,81424
1994-09-01,Pennsylvania,9357771,5886613,5523638,362975
1994-09-01,Tennessee,4017919,2685141,2559370,125771
1994-09-01,Texas,13613277,9432364,8834474,597890
1994-09-01,Utah,1368560,1005029,966792,38237
1994-09-01,Vermont,444389,316607,302546,14061
1994-09-01,Virginia,4932276,3432037,3270738,161299
1994-09-01,Washington,4052862,2751286,2584868,166418
1994-09-01,Wisconsin,3869963,2832402,2717023,115379
1994-09-01,Wyoming,354224,250692,239030,11662
1994-10-01,Alabama,3237521,2053700,1931317,122383
1994-10-01,Alaska,410500,301612,279330,22282
1994-10-01,Arizona,3256460,2150608,2019422,131186
1994-10-01,Arkansas,1893883,1215302,1152653,62649
1994-10-01,California,23215309,15260112,14005371,1254741
1994-10-01,Colorado,2832695,2073978,1996588,77390
1994-10-01,Connecticut,2548858,1752338,1656894,95444
1994-10-01,Delaware,547412,386069,369671,16398
1994-10-01,Florida,11175603,6987689,6562399,425290
1994-10-01,Georgia,5371631,3630207,3459607,170600
1994-10-01,Hawaii,861607,584049,553312,30737
1994-10-01,Idaho,839007,592994,559853,33141
1994-10-01,Illinois,9006437,6123316,5791890,331426
1994-10-01,Indiana,4398908,3094843,2954449,140394
1994-10-01,Iowa,2165030,1583464,1527672,55792
1994-10-01,Kansas,1905685,1351398,1286966,64432
1994-10-01,Kentucky,2933887,1849757,1753002,96755
1994-10-01,Louisiana,3174235,1963056,1816616,146440
1994-10-01,Maine,952656,628237,587955,40282
1994-10-01,Maryland,3803831,2702722,2567462,135260
1994-10-01,Massachusetts,4723424,3210165,3017414,192751
1994-10-01,Michigan,7242586,4816151,4551593,264558
1994-10-01,Minnesota,3455733,2602529,2502649,99880
1994-10-01,Mississippi,1983910,1255075,1177960,77115
1994-10-01,Missouri,4020730,2763456,2625227,138229
1994-10-01,Montana,645044,440939,416727,24212
1994-10-01,Nebraska,1219138,891131,867986,23145
1994-10-01,Nevada,1177686,823534,773310,50224
1994-10-01,Ohio,8447904,5566940,5288275,278665
1994-10-01,Oklahoma,2439950,1555751,1478072,77679
1994-10-01,Oregon,2413689,1649377,1569853,79524
1994-10-01,Pennsylvania,9361381,5885030,5528398,356632
1994-10-01,Tennessee,4024514,2695581,2570483,125098
1994-10-01,Texas,13636878,9448214,8861738,586476
1994-10-01,Utah,1373008,1007913,969641,38272
1994-10-01,Vermont,444413,317238,303303,13935
1994-10-01,Virginia,4938404,3440577,3281535,159042
1994-10-01,Washington,4061106,2758407,2592625,165782
1994-10-01,Wisconsin,3874418,2838660,2726150,112510
1994-10-01,Wyoming,355246,251129,239600,11529
1994-11-01,Alabama,3239323,2058507,1936715,121792
1994-11-01,Alaska,411491,301561,279562,21999
1994-11-01,Arizona,3267244,2163001,2035522,127479
1994-11-01,Arkansas,1896295,1217210,1155795,61415
1994-11-01,California,23221400,15262583,14034864,1227719
1994-11-01,Colorado,2839673,2082266,2006415,75851
1994-11-01,Connecticut,2549321,1752258,1657911,94347
1994-11-01,Delaware,548488,386673,370751,15922
1994-11-01,Florida,11194958,6999058,6583667,415391
1994-11-01,Georgia,5381642,3636572,3469931,166641
1994-11-01,Hawaii,862738,584434,554245,30189
1994-11-01,Idaho,841007,594131,561062,33069
1994-11-01,Illinois,9010686,6131155,5809100,322055
1994-11-01,Indiana,4403476,3108742,2972175,136567
1994-11-01,Iowa,2166358,1585745,1530435,55310
1994-11-01,Kansas,1907697,1353242,1289117,64125
1994-11-01,Kentucky,2936937,1854364,1758597,95767
1994-11-01,Louisiana,3176256,1964223,1820193,144030
1994-11-01,Maine,953633,629756,590434,39322
1994-11-01,Maryland,3805656,2706817,2573937,132880
1994-11-01,Massachusetts,4726414,3213860,3024367,189493
1994-11-01,Michigan,7248286,4818398,4561506,256892
1994-11-01,Minnesota,3459418,2609937,2511271,98666
1994-11-01,Mississippi,1986012,1256874,1180265,76609
1994-11-01,Missouri,4024312,2778771,2640294,138477
1994-11-01,Montana,647010,441535,417317,24218
1994-11-01,Nebraska,1220382,893274,870301,22973
1994-11-01,Nevada,1183611,826626,776908,49718
1994-11-01,Ohio,8452833,5573426,5308028,265398
1994-11-01,Oklahoma,2442139,1556813,1481291,75522
1994-11-01,Oregon,2416959,1649714,1572331,77383
1994-11-01,Pennsylvania,9362991,5884412,5535486,348926
1994-11-01,Tennessee,4030109,2705327,2581089,124238
1994-11-01,Texas,13658480,9462754,8888815,573939
1994-11-01,Utah,1376457,1010278,972311,37967
1994-11-01,Vermont,445438,317833,304116,13717
1994-11-01,Virginia,4943531,3448168,3291961,156207
1994-11-01,Washington,4068349,2765092,2599946,165146
1994-11-01,Wisconsin,3878874,2843966,2734889,109077
1994-11-01,Wyoming,355267,251567,240148,11419
1994-12-01,Alabama,3241125,2061653,1940381,121272
1994-12-01,Alaska,412483,301411,279703,21708
1994-12-01,Arizona,3279027,2174713,2050905,123808
1994-12-01,Arkansas,1898706,1218853,1158541,60312
1994-12-01,California,23225492,15264437,14060146,1204291
1994-12-01,Colorado,2846650,2088971,2014040,74931
1994-12-01,Connecticut,2548785,1751765,1658540,93225
1994-12-01,Delaware,549564,387187,371644,15543
1994-12-01,Florida,11212313,7006448,6600810,405638
1994-12-01,Georgia,5391652,3642521,3478872,163649
1994-12-01,Hawaii,862870,584546,554879,29667
1994-12-01,Idaho,843008,595138,562288,32850
1994-12-01,Illinois,9013935,6139506,5825190,314316
1994-12-01,Indiana,4407043,3119422,2985811,133611
1994-12-01,Iowa,2167686,1587657,1532951,54706
1994-12-01,Kansas,1909709,1354327,1290926,63401
1994-12-01,Kentucky,2938987,1857155,1762263,94892
1994-12-01,Louisiana,3178278,1964360,1822655,141705
1994-12-01,Maine,953610,631181,592748,38433
1994-12-01,Maryland,3808480,2709780,2579053,130727
1994-12-01,Massachusetts,4728404,3215995,3029918,186077
1994-12-01,Michigan,7252986,4818749,4566816,251933
1994-12-01,Minnesota,3463104,2615909,2518455,97454
1994-12-01,Mississippi,1988113,1257407,1181553,75854
1994-12-01,Missouri,4026893,2791998,2653429,138569
1994-12-01,Montana,647976,441716,417548,24168
1994-12-01,Nebraska,1221625,894911,872251,22660
1994-12-01,Nevada,1188537,829418,780310,49108
1994-12-01,Ohio,8455763,5577312,5322558,254754
1994-12-01,Oklahoma,2443327,1557156,1483907,73249
1994-12-01,Oregon,2421230,1649875,1574318,75557
1994-12-01,Pennsylvania,9364601,5885202,5543137,342065
1994-12-01,Tennessee,4036705,2712862,2588622,124240
1994-12-01,Texas,13679081,9476149,8912404,563745
1994-12-01,Utah,1380905,1012013,974566,37447
1994-12-01,Vermont,445462,318326,304849,13477
1994-12-01,Virginia,4948659,3453739,3300180,153559
1994-12-01,Washington,4074592,2771101,2606099,165002
1994-12-01,Wisconsin,3882329,2848293,2742045,106248
1994-12-01,Wyoming,355289,251961,240575,11386
1995-01-01,Alabama,3242927,2063222,1942035,121187
1995-01-01,Alaska,412474,301220,279733,21487
1995-01-01,Arizona,3289811,2186008,2064921,121087
1995-01-01,Arkansas,1900118,1219834,1160377,59457
1995-01-01,California,23229583,15267263,14077198,1190065
1995-01-01,Colorado,2853628,2094469,2019305,75164
1995-01-01,Connecticut,2549248,1750300,1657849,92451
1995-01-01,Delaware,550640,387406,372045,15361
1995-01-01,Florida,11231668,7010015,6611902,398113
1995-01-01,Georgia,5402663,3648326,3485548,162778
1995-01-01,Hawaii,864001,584528,555074,29454
1995-01-01,Idaho,845008,596021,563425,32596
1995-01-01,Illinois,9018184,6147100,5836629,310471
1995-01-01,Indiana,4410611,3125950,2993098,132852
1995-01-01,Iowa,2169014,1588463,1534077,54386
1995-01-01,Kansas,1910721,1354463,1291879,62584
1995-01-01,Kentucky,2942037,1858327,1763672,94655
1995-01-01,Louisiana,3180299,1963940,1823927,140013
1995-01-01,Maine,953587,632517,594706,37811
1995-01-01,Maryland,3810305,2711503,2581842,129661
1995-01-01,Massachusetts,4731394,3215683,3032395,183288
1995-01-01,Michigan,7257686,4819313,4567643,251670
1995-01-01,Minnesota,3466789,2619600,2522901,96699
1995-01-01,Mississippi,1990215,1256702,1181493,75209
1995-01-01,Missouri,4030475,2803137,2664236,138901
1995-01-01,Montana,648942,441512,417336,24176
1995-01-01,Nebraska,1222869,895958,873532,22426
1995-01-01,Nevada,1193462,831889,783342,48547
1995-01-01,Ohio,8459692,5578262,5329334,248928
1995-01-01,Oklahoma,2444516,1556914,1485595,71319
1995-01-01,Oregon,2425500,1649984,1575384,74600
1995-01-01,Pennsylvania,9366211,5886323,5548131,338192
1995-01-01,Tennessee,4042300,2717222,2591385,125837
1995-01-01,Texas,13699683,9488698,8930104,558594
1995-01-01,Utah,1384354,1013045,976163,36882
1995-01-01,Vermont,445487,318615,305333,13282
1995-01-01,Virginia,4953786,3456801,3304962,151839
1995-01-01,Washington,4081835,2776462,2610684,165778
1995-01-01,Wisconsin,3886785,2851664,2746854,104810
1995-01-01,Wyoming,356310,252268,240810,11458
1995-02-01,Alabama,3244729,2064034,1942492,121542
1995-02-01,Alaska,413465,301074,279679,21395
1995-02-01,Arizona,3299595,2197797,2078076,119721
1995-02-01,Arkansas,1902530,1220213,1161372,58841
1995-02-01,California,23232675,15275279,14088868,1186411
1995-02-01,Colorado,2860605,2099615,2022952,76663
1995-02-01,Connecticut,2548711,1747820,1655666,92154
1995-02-01,Delaware,551716,387249,371845,15404
1995-02-01,Florida,11248024,7011842,6618176,393666
1995-02-01,Georgia,5411674,3654631,3490308,164323
1995-02-01,Hawaii,864132,584606,554944,29662
1995-02-01,Idaho,847008,596946,564533,32413
1995-02-01,Illinois,9020433,6153923,5843543,310380
1995-02-01,Indiana,4413178,3128824,2994450,134374
1995-02-01,Iowa,2170342,1587952,1533419,54533
1995-02-01,Kansas,1912733,1354037,1292156,61881
1995-02-01,Kentucky,2944086,1858705,1763496,95209
1995-02-01,Louisiana,3182320,1963633,1824568,139065
1995-02-01,Maine,953564,633823,596293,37530
1995-02-01,Maryland,3811130,2712383,2582424,129959
1995-02-01,Massachusetts,4733384,3213020,3031620,181400
1995-02-01,Michigan,7262385,4822057,4566118,255939
1995-02-01,Minnesota,3470474,2621400,2524871,96529
1995-02-01,Mississippi,1992317,1255277,1180408,74869
1995-02-01,Missouri,4033056,2813030,2673463,139567
1995-02-01,Montana,650909,441206,416918,24288
1995-02-01,Nebraska,1224113,896670,874257,22413
1995-02-01,Nevada,1199388,834278,786152,48126
1995-02-01,Ohio,8462621,5578483,5329961,248522
1995-02-01,Oklahoma,2445705,1556674,1486667,70007
1995-02-01,Oregon,2428771,1650300,1575658,74642
1995-02-01,Pennsylvania,9367821,5887682,5549716,337966
1995-02-01,Tennessee,4047895,2718826,2589680,129146
1995-02-01,Texas,13719284,9502085,8943026,559059
1995-02-01,Utah,1388802,1013647,977283,36364
1995-02-01,Vermont,446511,318746,305566,13180
1995-02-01,Virginia,4957914,3457860,3306671,151189
1995-02-01,Washington,4088079,2781442,2614019,167423
1995-02-01,Wisconsin,3890240,2854729,2750004,104725
1995-02-01,Wyoming,356332,252495,240895,11600
1995-03-01,Alabama,3245531,2064578,1942434,122144
1995-03-01,Alaska,413457,301035,279632,21403
1995-03-01,Arizona,3310379,2210140,2090506,119634
1995-03-01,Arkansas,1904942,1220045,1161594,58451
1995-03-01,California,23234766,15290438,14099170,1191268
1995-03-01,Colorado,2866583,2104831,2025686,79145
1995-03-01,Connecticut,2549174,1744577,1652289,92288
1995-03-01,Delaware,552792,386803,371200,15603
1995-03-01,Florida,11266379,7013726,6621657,392069
1995-03-01,Georgia,5421685,3661829,3493959,167870
1995-03-01,Hawaii,865263,584879,554632,30247
1995-03-01,Idaho,850008,598031,565630,32401
1995-03-01,Illinois,9023682,6159903,5846772,313131
1995-03-01,Indiana,4416745,3128894,2991631,137263
1995-03-01,Iowa,2172670,1586353,1531286,55067
1995-03-01,Kansas,1914744,1353340,1292029,61311
1995-03-01,Kentucky,2946136,1858766,1762219,96547
1995-03-01,Louisiana,3184342,1963488,1824967,138521
1995-03-01,Maine,954540,635074,597520,37554
1995-03-01,Maryland,3812954,2712645,2581342,131303
1995-03-01,Massachusetts,4736374,3208581,3028254,180327
1995-03-01,Michigan,7266085,4826864,4564445,262419
1995-03-01,Minnesota,3474159,2621916,2525206,96710
1995-03-01,Mississippi,1994419,1253731,1178746,74985
1995-03-01,Missouri,4035638,2822235,2681842,140393
1995-03-01,Montana,651875,440998,416485,24513
1995-03-01,Nebraska,1225357,897328,874653,22675
1995-03-01,Nevada,1204314,836783,788916,47867
1995-03-01,Ohio,8465551,5580429,5327598,252831
1995-03-01,Oklahoma,2446894,1556751,1487421,69330
1995-03-01,Oregon,2433041,1650990,1575449,75541
1995-03-01,Pennsylvania,9368431,5889125,5548469,340656
1995-03-01,Tennessee,4053490,2718243,2584576,133667
1995-03-01,Texas,13738885,9516748,8952476,564272
1995-03-01,Utah,1392250,1014095,978169,35926
1995-03-01,Vermont,446535,318800,305625,13175
1995-03-01,Virginia,4963042,3457295,3305862,151433
1995-03-01,Washington,4094322,2786094,2616240,169854
1995-03-01,Wisconsin,3893696,2858204,2752753,105451
1995-03-01,Wyoming,357353,252607,240854,11753
1995-04-01,Alabama,3247333,2064899,1942123,122776
1995-04-01,Alaska,414448,301122,279607,21515
1995-04-01,Arizona,3322163,2222219,2101933,120286
1995-04-01,Arkansas,1906353,1219477,1161177,58300
1995-04-01,California,23240858,15312439,14111632,1200807
1995-04-01,Colorado,2873560,2110306,2028175,82131
1995-04-01,Connecticut,2549637,1741064,1648395,92669
1995-04-01,Delaware,552868,386285,370401,15884
1995-04-01,Florida,11284734,7016921,6624364,392557
1995-04-01,Georgia,5432696,3669882,3497268,172614
1995-04-01,Hawaii,865394,585273,554182,31091
1995-04-01,Idaho,852008,599207,566620,32587
1995-04-01,Illinois,9027931,6164015,5846521,317494
1995-04-01,Indiana,4421313,3126974,2986782,140192
1995-04-01,Iowa,2173998,1584228,1528502,55726
1995-04-01,Kansas,1916756,1352688,1291849,60839
1995-04-01,Kentucky,2949186,1858655,1760169,98486
1995-04-01,Louisiana,3186363,1963401,1825437,137964
1995-04-01,Maine,954517,636310,598506,37804
1995-04-01,Maryland,3815779,2712564,2579388,133176
1995-04-01,Massachusetts,4739364,3203190,3023460,179730
1995-04-01,Michigan,7271785,4831766,4563594,268172
1995-04-01,Minnesota,3477844,2621440,2524627,96813
1995-04-01,Mississippi,1996521,1252721,1176880,75841
1995-04-01,Missouri,4039219,2831279,2690132,141147
1995-04-01,Montana,652841,440987,416162,24825
1995-04-01,Nebraska,1226600,898099,874999,23100
1995-04-01,Nevada,1209239,839481,791768,47713
1995-04-01,Ohio,8469480,5585108,5324788,260320
1995-04-01,Oklahoma,2449083,1557129,1487917,69212
1995-04-01,Oregon,2437312,1652232,1575393,76839
1995-04-01,Pennsylvania,9371041,5890189,5545255,344934
1995-04-01,Tennessee,4059085,2716686,2578237,138449
1995-04-01,Texas,13760487,9532806,8960132,572674
1995-04-01,Utah,1396699,1014620,979028,35592
1995-04-01,Vermont,446560,318844,305611,13233
1995-04-01,Virginia,4968169,3455376,3303054,152322
1995-04-01,Washington,4101565,2790299,2617554,172745
1995-04-01,Wisconsin,3897151,2862084,2755755,106329
1995-04-01,Wyoming,357375,252631,240734,11897
1995-05-01,Alabama,3249135,2065176,1941947,123229
1995-05-01,Alaska,414440,301371,279653,21718
1995-05-01,Arizona,3332946,2233491,2112520,120971
1995-05-01,Arkansas,1908765,1219013,1160638,58375
1995-05-01,California,23244949,15299050,14088435,1210615
1995-05-01,Colorado,2880538,2116253,2031179,85074
1995-05-01,Connecticut,2549100,1738069,1645017,93052
1995-05-01,Delaware,553944,385914,369747,16167
1995-05-01,Florida,11303089,7022498,6628398,394100
1995-05-01,Georgia,5442707,3678683,3501293,177390
1995-05-01,Hawaii,866525,585694,553663,32031
1995-05-01,Idaho,854008,600360,567507,32853
1995-05-01,Illinois,9031180,6166872,5845323,321549
1995-05-01,Indiana,4423880,3124733,2982822,141911
1995-05-01,Iowa,2175327,1582669,1526390,56279
1995-05-01,Kansas,1917768,1352548,1292124,60424
1995-05-01,Kentucky,2952236,1858420,1757894,100526
1995-05-01,Louisiana,3188384,1963422,1826399,137023
1995-05-01,Maine,954494,637587,599498,38089
1995-05-01,Maryland,3817604,2712479,2577486,134993
1995-05-01,Massachusetts,4742354,3198417,3019295,179122
1995-05-01,Michigan,7276485,4835270,4564640,270630
1995-05-01,Minnesota,3481529,2620899,2524318,96581
1995-05-01,Mississippi,1998623,1252596,1175325,77271
1995-05-01,Missouri,4042801,2837113,2695564,141549
1995-05-01,Montana,653807,441302,416148,25154
1995-05-01,Nebraska,1227844,899210,875645,23565
1995-05-01,Nevada,1214165,842471,794904,47567
1995-05-01,Ohio,8473410,5592152,5323518,268634
1995-05-01,Oklahoma,2450271,1557890,1488338,69552
1995-05-01,Oregon,2440582,1654584,1576509,78075
1995-05-01,Pennsylvania,9372651,5891569,5542644,348925
1995-05-01,Tennessee,4065680,2715985,2573343,142642
1995-05-01,Texas,13781088,9551015,8968732,582283
1995-05-01,Utah,1400147,1015495,980162,35333
1995-05-01,Vermont,447584,318966,305664,13302
1995-05-01,Virginia,4972297,3452865,3299325,153540
1995-05-01,Washington,4108808,2794285,2618975,175310
1995-05-01,Wisconsin,3901607,2866228,2759412,106816
1995-05-01,Wyoming,358396,252692,240671,12021
1995-06-01,Alabama,3250938,2065524,1942300,123224
1995-06-01,Alaska,415431,301858,279893,21965
1995-06-01,Arizona,3343730,2243372,2122366,121006
1995-06-01,Arkansas,1911177,1219196,1160591,58605
1995-06-01,California,23251041,15290438,14073315,1217123
1995-06-01,Colorado,2887515,2122651,2035200,87451
1995-06-01,Connecticut,2549563,1736197,1643013,93184
1995-06-01,Delaware,555020,385792,369408,16384
1995-06-01,Florida,11322444,7030182,6634627,395555
1995-06-01,Georgia,5452718,3687851,3506801,181050
1995-06-01,Hawaii,866657,586007,553138,32869
1995-06-01,Idaho,856008,601495,568378,33117
1995-06-01,Illinois,9035428,6169873,5846262,323611
1995-06-01,Indiana,4428448,3123638,2981636,142002
1995-06-01,Iowa,2176655,1582538,1525978,56560
1995-06-01,Kansas,1919780,1352936,1293034,59902
1995-06-01,Kentucky,2954286,1858219,1755989,102230
1995-06-01,Louisiana,3191405,1963451,1828013,135438
1995-06-01,Maine,955471,638912,600680,38232
1995-06-01,Maryland,3819428,2712575,2576204,136371
1995-06-01,Massachusetts,4745344,3195768,3017785,177983
1995-06-01,Michigan,7281184,4836626,4567815,268811
1995-06-01,Minnesota,3486214,2621329,2525319,96010
1995-06-01,Mississippi,2000725,1253218,1174595,78623
1995-06-01,Missouri,4046383,2850385,2709370,141015
1995-06-01,Montana,655774,441958,416516,25442
1995-06-01,Nebraska,1230088,900646,876716,23930
1995-06-01,Nevada,1220090,845768,798416,47352
1995-06-01,Ohio,8477339,5600402,5324508,275894
1995-06-01,Oklahoma,2451460,1559093,1489032,70061
1995-06-01,Oregon,2444853,1658166,1579198,78968
1995-06-01,Pennsylvania,9374261,5894334,5542968,351366
1995-06-01,Tennessee,4071275,2717335,2571749,145586
1995-06-01,Texas,13802689,9570506,8979583,590923
1995-06-01,Utah,1404596,1016803,981729,35074
1995-06-01,Vermont,447608,319243,305885,13358
1995-06-01,Virginia,4978425,3450346,3295655,154691
1995-06-01,Washington,4116051,2798428,2621364,177064
1995-06-01,Wisconsin,3905062,2870534,2763740,106794
1995-06-01,Wyoming,358418,252867,240731,12136
1995-07-01,Alabama,3252740,2066181,1943377,122804
1995-07-01,Alaska,416422,302566,280347,22219
1995-07-01,Arizona,3354514,2251221,2131148,120073
1995-07-01,Arkansas,1913589,1220350,1161392,58958
1995-07-01,California,23257132,15284519,14065570,1218949
1995-07-01,Colorado,2895493,2129472,2040464,89008
1995-07-01,Connecticut,2550026,1735715,1642762,92953
1995-07-01,Delaware,556097,385860,369349,16511
1995-07-01,Florida,11341800,7039940,6643205,396735
1995-07-01,Georgia,5463729,3696842,3513868,182974
1995-07-01,Hawaii,867788,586051,552636,33415
1995-07-01,Idaho,859008,602654,569303,33351
1995-07-01,Illinois,9039677,6174220,5850181,324039
1995-07-01,Indiana,4432015,3123700,2982877,140823
1995-07-01,Iowa,2178983,1584065,1527537,56528
1995-07-01,Kansas,1921792,1353720,1294623,59097
1995-07-01,Kentucky,2957335,1857965,1754754,103211
1995-07-01,Louisiana,3193427,1963415,1829955,133460
1995-07-01,Maine,955448,640146,601950,38196
1995-07-01,Maryland,3822253,2712672,2575694,136978
1995-07-01,Massachusetts,4748335,3195880,3019782,176098
1995-07-01,Michigan,7286884,4836144,4572330,263814
1995-07-01,Minnesota,3489899,2623257,2527850,95407
1995-07-01,Mississippi,2003827,1254321,1174823,79498
1995-07-01,Missouri,4049964,2852213,2713029,139184
1995-07-01,Montana,656740,442784,417132,25652
1995-07-01,Nebraska,1231332,902178,878091,24087
1995-07-01,Nevada,1225016,849365,802266,47099
1995-07-01,Ohio,8482268,5608827,5327598,281229
1995-07-01,Oklahoma,2453649,1560508,1490220,70288
1995-07-01,Oregon,2449123,1662538,1582992,79546
1995-07-01,Pennsylvania,9376871,5898588,5546846,351742
1995-07-01,Tennessee,4077870,2720392,2573551,146841
1995-07-01,Texas,13824291,9590083,8992894,597189
1995-07-01,Utah,1408044,1018517,983730,34787
1995-07-01,Vermont,448633,319663,306274,13389
1995-07-01,Virginia,4983552,3447933,3292552,155381
1995-07-01,Washington,4123295,2803004,2625039,177965
1995-07-01,Wisconsin,3909518,2874650,2768114,106536
1995-07-01,Wyoming,358439,253165,240908,12257
1995-08-01,Alabama,3256542,2066920,1945059,121861
1995-08-01,Alaska,416414,303307,280830,22477
1995-08-01,Arizona,3364298,2256571,2138063,118508
1995-08-01,Arkansas,1916001,1222419,1162994,59425
1995-08-01,California,23274224,15277686,14061236,1216450
1995-08-01,Colorado,2901470,2136204,2046462,89742
1995-08-01,Connecticut,2550489,1736384,1643918,92466
1995-08-01,Delaware,557173,385938,369319,16619
1995-08-01,Florida,11362155,7050756,6653607,397149
1995-08-01,Georgia,5475739,3704787,3521759,183028
1995-08-01,Hawaii,868919,585815,552177,33638
1995-08-01,Idaho,860009,603755,570266,33489
1995-08-01,Illinois,9045926,6179675,5855510,324165
1995-08-01,Indiana,4436582,3123578,2984287,139291
1995-08-01,Iowa,2180311,1587065,1530812,56253
1995-08-01,Kansas,1923803,1354517,1296533,57984
1995-08-01,Kentucky,2960385,1857301,1753946,103355
1995-08-01,Louisiana,3196448,1963395,1831696,131699
1995-08-01,Maine,956425,641199,603261,37938
1995-08-01,Maryland,3825078,2712806,2575764,137042
1995-08-01,Massachusetts,4751325,3198030,3024418,173612
1995-08-01,Michigan,7294584,4834411,4576991,257420
1995-08-01,Minnesota,3494584,2626447,2531380,95067
1995-08-01,Mississippi,2005929,1255357,1175603,79754
1995-08-01,Missouri,4053546,2853428,2717090,136338
1995-08-01,Montana,657706,443555,417781,25774
1995-08-01,Nebraska,1232575,903593,879535,24058
1995-08-01,Nevada,1230942,853133,806246,46887
1995-08-01,Ohio,8486198,5616055,5331244,284811
1995-08-01,Oklahoma,2455838,1561918,1491902,70016
1995-08-01,Oregon,2454394,1667174,1587230,79944
1995-08-01,Pennsylvania,9380481,5904014,5553027,350987
1995-08-01,Tennessee,4084465,2724332,2577764,146568
1995-08-01,Texas,13846892,9608253,9007450,600803
1995-08-01,Utah,1412493,1020442,985927,34515
1995-08-01,Vermont,448657,320172,306781,13391
1995-08-01,Virginia,4989680,3445300,3289835,155465
1995-08-01,Washington,4129538,2808599,2630206,178393
1995-08-01,Wisconsin,3913973,2878170,2771807,106363
1995-08-01,Wyoming,359461,253524,241146,12378
1995-09-01,Alabama,3259344,2067404,1947133,120271
1995-09-01,Alaska,417405,303971,281238,22733
1995-09-01,Arizona,3374082,2259814,2142754,117060
1995-09-01,Arkansas,1918412,1224844,1164903,59941
1995-09-01,California,23292316,15266835,14055290,1211545
1995-09-01,Colorado,2908448,2142263,2052411,89852
1995-09-01,Connecticut,2551952,1737609,1645704,91905
1995-09-01,Delaware,558249,385851,369052,16799
1995-09-01,Florida,11383510,7061002,6664472,396530
1995-09-01,Georgia,5486750,3711196,3529764,181432
1995-09-01,Hawaii,869050,585529,551851,33678
1995-09-01,Idaho,862009,604890,571323,33567
1995-09-01,Illinois,9052175,6184870,5859994,324876
1995-09-01,Indiana,4441150,3122151,2983701,138450
1995-09-01,Iowa,2181639,1590698,1534723,55975
1995-09-01,Kansas,1925815,1354984,1298248,56736
1995-09-01,Kentucky,2963435,1856162,1753258,102904
1995-09-01,Louisiana,3198469,1963539,1832863,130676
1995-09-01,Maine,956401,642135,604649,37486
1995-09-01,Maryland,3828902,2713320,2576189,137131
1995-09-01,Massachusetts,4754315,3200688,3029856,170832
1995-09-01,Michigan,7302284,4832102,4580994,251108
1995-09-01,Minnesota,3499269,2630164,2535022,95142
1995-09-01,Mississippi,2008030,1255900,1176382,79518
1995-09-01,Missouri,4058127,2854032,2720907,133125
1995-09-01,Montana,658673,444114,418266,25848
1995-09-01,Nebraska,1233819,904841,880842,23999
1995-09-01,Nevada,1235867,856892,810170,46722
1995-09-01,Ohio,8491127,5621384,5334305,287079
1995-09-01,Oklahoma,2459027,1563311,1493782,69529
1995-09-01,Oregon,2458664,1671800,1591270,80530
1995-09-01,Pennsylvania,9385091,5910145,5559646,350499
1995-09-01,Tennessee,4091060,2728651,2583121,145530
1995-09-01,Texas,13869493,9623573,9021392,602181
1995-09-01,Utah,1416941,1022371,988072,34299
1995-09-01,Vermont,449682,320722,307349,13373
1995-09-01,Virginia,4996808,3441974,3286899,155075
1995-09-01,Washington,4135781,2815292,2636773,178519
1995-09-01,Wisconsin,3918429,2881043,2774311,106732
1995-09-01,Wyoming,359482,253834,241388,12446
1995-10-01,Alabama,3263146,2067660,1949307,118353
1995-10-01,Alaska,417396,304582,281596,22986
1995-10-01,Arizona,3384865,2261597,2145298,116299
1995-10-01,Arkansas,1920824,1227070,1166624,60446
1995-10-01,California,23311407,15251422,14044544,1206878
1995-10-01,Colorado,2915425,2147331,2057505,89826
1995-10-01,Connecticut,2553415,1738773,1647318,91455
1995-10-01,Delaware,558325,385504,368359,17145
1995-10-01,Florida,11405865,7070465,6674885,395580
1995-10-01,Georgia,5498761,3716280,3537389,178891
1995-10-01,Hawaii,870181,585507,551786,33721
1995-10-01,Idaho,864009,606112,572465,33647
1995-10-01,Illinois,9059424,6188928,5862525,326403
1995-10-01,Indiana,4446717,3119048,2980482,138566
1995-10-01,Iowa,2182967,1594064,1538084,55980
1995-10-01,Kansas,1927827,1355188,1299466,55722
1995-10-01,Kentucky,2966485,1854754,1752555,102199
1995-10-01,Louisiana,3201491,1964103,1833561,130542
1995-10-01,Maine,957378,643116,606128,36988
1995-10-01,Maryland,3833727,2714414,2576699,137715
1995-10-01,Massachusetts,4758305,3202494,3034360,168134
1995-10-01,Michigan,7309984,4830751,4584776,245975
1995-10-01,Minnesota,3504954,2634007,2538238,95769
1995-10-01,Mississippi,2010132,1255846,1176750,79096
1995-10-01,Missouri,4061709,2854458,2724167,130291
1995-10-01,Montana,659639,444376,418486,25890
1995-10-01,Nebraska,1236063,905923,881864,24059
1995-10-01,Nevada,1241793,860499,813907,46592
1995-10-01,Ohio,8497056,5624550,5336125,288425
1995-10-01,Oklahoma,2462215,1564697,1495700,68997
1995-10-01,Oregon,2463935,1676415,1594669,81746
1995-10-01,Pennsylvania,9389701,5915814,5564891,350923
1995-10-01,Tennessee,4098655,2732933,2588521,144412
1995-10-01,Texas,13894095,9635581,9033523,602058
1995-10-01,Utah,1420389,1024168,989968,34200
1995-10-01,Vermont,449706,321252,307913,13339
1995-10-01,Virginia,5003935,3437702,3283393,154309
1995-10-01,Washington,4142024,2822821,2644420,178401
1995-10-01,Wisconsin,3922884,2883900,2776286,107614
1995-10-01,Wyoming,360504,254011,241567,12444
1995-11-01,Alabama,3265948,2067700,1951431,116269
1995-11-01,Alaska,417388,305124,281904,23220
1995-11-01,Arizona,3393649,2262380,2146292,116088
1995-11-01,Arkansas,1923236,1228681,1167791,60890
1995-11-01,California,23325499,15250575,14048728,1201847
1995-11-01,Colorado,2922403,2150923,2061108,89815
1995-11-01,Connecticut,2553878,1739419,1648338,91081
1995-11-01,Delaware,559401,384991,367338,17653
1995-11-01,Florida,11426221,7078749,6685037,393712
1995-11-01,Georgia,5509772,3720453,3544584,175869
1995-11-01,Hawaii,871312,585914,552050,33864
1995-11-01,Idaho,866009,607301,573561,33740
1995-11-01,Illinois,9064673,6191365,5863729,327636
1995-11-01,Indiana,4450284,3114051,2975200,138851
1995-11-01,Iowa,2184295,1596772,1540509,56263
1995-11-01,Kansas,1928839,1355245,1300151,55094
1995-11-01,Kentucky,2969534,1853311,1751796,101515
1995-11-01,Louisiana,3203512,1965059,1834191,130868
1995-11-01,Maine,958355,644282,607771,36511
1995-11-01,Maryland,3836552,2715758,2577109,138649
1995-11-01,Massachusetts,4761295,3202538,3037115,165423
1995-11-01,Michigan,7316683,4831096,4589080,242016
1995-11-01,Minnesota,3509639,2637814,2540805,97009
1995-11-01,Mississippi,2012234,1255299,1176732,78567
1995-11-01,Missouri,4065290,2855103,2726746,128357
1995-11-01,Montana,660605,444415,418540,25875
1995-11-01,Nebraska,1237307,906747,882528,24219
1995-11-01,Nevada,1246719,863855,817417,46438
1995-11-01,Ohio,8499986,5625241,5336911,288330
1995-11-01,Oklahoma,2464404,1566001,1497636,68365
1995-11-01,Oregon,2468205,1681013,1597340,83673
1995-11-01,Pennsylvania,9392311,5920040,5568367,351673
1995-11-01,Tennessee,4104250,2736422,2593104,143318
1995-11-01,Texas,13914696,9643830,9043826,600004
1995-11-01,Utah,1424838,1025730,991525,34205
1995-11-01,Vermont,449730,321727,308423,13304
1995-11-01,Virginia,5010063,3432471,3279584,152887
1995-11-01,Washington,4148267,2830709,2652805,177904
1995-11-01,Wisconsin,3927340,2887368,2778877,108491
1995-11-01,Wyoming,360525,254061,241636,12425
1995-12-01,Alabama,3267750,2067617,1953285,114332
1995-12-01,Alaska,418379,305568,282155,23413
1995-12-01,Arizona,3403433,2263010,2146501,116509
1995-12-01,Arkansas,1924648,1229735,1168393,61342
1995-12-01,California,23337590,15205811,14009652,1196159
1995-12-01,Colorado,2928380,2152989,2063202,89787
1995-12-01,Connecticut,2554341,1739721,1648899,90822
1995-12-01,Delaware,560477,384586,366376,18210
1995-12-01,Florida,11444576,7086591,6695625,390966
1995-12-01,Georgia,5520783,3724916,3551848,173068
1995-12-01,Hawaii,871443,586795,552661,34134
1995-12-01,Idaho,868009,608417,574554,33863
1995-12-01,Illinois,9068922,6193319,5865215,328104
1995-12-01,Indiana,4453852,3108249,2969546,138703
1995-12-01,Iowa,2185623,1599219,1542460,56759
1995-12-01,Kansas,1929851,1355452,1300474,54978
1995-12-01,Kentucky,2971584,1852066,1751011,101055
1995-12-01,Louisiana,3205533,1966651,1835342,131309
1995-12-01,Maine,958332,645603,609476,36127
1995-12-01,Maryland,3839376,2717267,2577694,139573
1995-12-01,Massachusetts,4763285,3201708,3038984,162724
1995-12-01,Michigan,7322383,4833708,4594108,239600
1995-12-01,Minnesota,3513324,2641562,2542935,98627
1995-12-01,Mississippi,2013336,1254686,1176504,78182
1995-12-01,Missouri,4068872,2856767,2728901,127866
1995-12-01,Montana,661571,444523,418695,25828
1995-12-01,Nebraska,1238550,907374,882973,24401
1995-12-01,Nevada,1251644,867094,820788,46306
1995-12-01,Ohio,8502915,5624783,5337938,286845
1995-12-01,Oklahoma,2466593,1567399,1499676,67723
1995-12-01,Oregon,2472476,1685873,1599800,86073
1995-12-01,Pennsylvania,9394921,5923534,5571539,351995
1995-12-01,Tennessee,4110845,2738737,2596450,142287
1995-12-01,Texas,13934297,9649799,9053425,596374
1995-12-01,Utah,1428286,1027133,992810,34323
1995-12-01,Vermont,450755,322189,308893,13296
1995-12-01,Virginia,5015191,3427310,3276346,150964
1995-12-01,Washington,4153511,2839175,2661879,177296
1995-12-01,Wisconsin,3930795,2891898,2782820,109078
1995-12-01,Wyoming,360546,254047,241631,12416
1996-01-01,Alabama,3270552,2068045,1955199,112846
1996-01-01,Alaska,418371,305998,282473,23525
1996-01-01,Arizona,3412217,2264527,2146892,117635
1996-01-01,Arkansas,1927059,1230594,1168670,61924
1996-01-01,California,23347682,15224699,14034613,1190086
1996-01-01,Colorado,2934358,2154763,2064658,90105
1996-01-01,Connecticut,2554805,1740403,1649646,90757
1996-01-01,Delaware,560553,384619,365960,18659
1996-01-01,Florida,11462931,7095622,6707566,388056
1996-01-01,Georgia,5530794,3731284,3560059,171225
1996-01-01,Hawaii,872575,588116,553597,34519
1996-01-01,Idaho,869009,609466,575487,33979
1996-01-01,Illinois,9072171,6197743,5868805,328938
1996-01-01,Indiana,4457419,3103713,2965753,137960
1996-01-01,Iowa,2185951,1601659,1544314,57345
1996-01-01,Kansas,1931863,1356325,1300891,55434
1996-01-01,Kentucky,2973634,1851380,1750537,100843
1996-01-01,Louisiana,3207554,1969263,1837564,131699
1996-01-01,Maine,959309,646950,611067,35883
1996-01-01,Maryland,3842201,2719465,2579363,140102
1996-01-01,Massachusetts,4765275,3202006,3041756,160250
1996-01-01,Michigan,7327083,4839375,4600523,238852
1996-01-01,Minnesota,3517009,2645509,2545212,100297
1996-01-01,Mississippi,2015438,1254589,1176537,78052
1996-01-01,Missouri,4071453,2860444,2731515,128929
1996-01-01,Montana,662538,444910,419160,25750
1996-01-01,Nebraska,1239794,908131,883567,24564
1996-01-01,Nevada,1256570,870461,824275,46186
1996-01-01,Ohio,8504845,5625737,5340645,285092
1996-01-01,Oklahoma,2468782,1569313,1502219,67094
1996-01-01,Oregon,2476746,1691188,1602661,88527
1996-01-01,Pennsylvania,9395531,5928327,5577071,351256
1996-01-01,Tennessee,4116441,2740357,2598882,141475
1996-01-01,Texas,13952899,9655855,9063885,591970
1996-01-01,Utah,1431735,1028674,994135,34539
1996-01-01,Vermont,450779,322722,309382,13340
1996-01-01,Virginia,5020318,3423449,3274301,149148
1996-01-01,Washington,4158754,2848378,2671375,177003
1996-01-01,Wisconsin,3934251,2897709,2788465,109244
1996-01-01,Wyoming,361568,254043,241635,12408
1996-02-01,Alabama,3272354,2069647,1957709,111938
1996-02-01,Alaska,419362,306486,282954,23532
1996-02-01,Arizona,3421000,2267245,2147831,119414
1996-02-01,Arkansas,1928471,1231494,1168844,62650
1996-02-01,California,23357773,15248554,14064840,1183714
1996-02-01,Colorado,2940335,2156813,2065845,90968
1996-02-01,Connecticut,2555268,1741692,1650805,90887
1996-02-01,Delaware,561629,385245,366359,18886
1996-02-01,Florida,11480286,7106650,6720888,385762
1996-02-01,Georgia,5540805,3740587,3569998,170589
1996-02-01,Hawaii,872706,589736,554781,34955
1996-02-01,Idaho,871009,610369,576349,34020
1996-02-01,Illinois,9076420,6206521,5875263,331258
1996-02-01,Indiana,4460987,3101578,2965005,136573
1996-02-01,Iowa,2186279,1604016,1546037,57979
1996-02-01,Kansas,1932874,1358058,1301731,56327
1996-02-01,Kentucky,2975684,1851715,1750886,100829
1996-02-01,Louisiana,3209576,1972805,1840965,131840
1996-02-01,Maine,959286,648341,612579,35762
1996-02-01,Maryland,3845026,2722839,2582803,140036
1996-02-01,Massachusetts,4767265,3204519,3046453,158066
1996-02-01,Michigan,7332783,4848399,4608941,239458
1996-02-01,Minnesota,3520694,2649706,2547901,101805
1996-02-01,Mississippi,2016540,1255374,1177239,78135
1996-02-01,Missouri,4075035,2866453,2735238,131215
1996-02-01,Montana,663504,445552,419909,25643
1996-02-01,Nebraska,1240038,909282,884543,24739
1996-02-01,Nevada,1261495,874105,828056,46049
1996-02-01,Ohio,8506774,5630352,5346322,284030
1996-02-01,Oklahoma,2470970,1571862,1505456,66406
1996-02-01,Oregon,2481017,1696927,1606070,90857
1996-02-01,Pennsylvania,9397141,5935857,5586843,349014
1996-02-01,Tennessee,4121036,2742163,2601221,140942
1996-02-01,Texas,13971500,9663419,9076408,587011
1996-02-01,Utah,1436183,1030507,995716,34791
1996-02-01,Vermont,451803,323315,309872,13443
1996-02-01,Virginia,5025446,3421972,3273724,148248
1996-02-01,Washington,4163997,2858056,2681013,177043
1996-02-01,Wisconsin,3936706,2904562,2795457,109105
1996-02-01,Wyoming,361589,254104,241669,12435
1996-03-01,Alabama,3275156,2072789,1961434,111355
1996-03-01,Alaska,419353,307068,283629,23439
1996-03-01,Arizona,3429784,2271263,2149672,121591
1996-03-01,Arkansas,1930883,1232703,1169317,63386
1996-03-01,California,23370865,15277868,14102011,1175857
1996-03-01,Colorado,2946313,2158703,2066618,92085
1996-03-01,Connecticut,2555731,1743321,1652272,91049
1996-03-01,Delaware,562705,386281,367373,18908
1996-03-01,Florida,11499641,7119804,6735546,384258
1996-03-01,Georgia,5550816,3752906,3581997,170909
1996-03-01,Hawaii,873837,591401,556088,35313
1996-03-01,Idaho,873009,611200,577266,33934
1996-03-01,Illinois,9080669,6219336,5884838,334498
1996-03-01,Indiana,4464554,3101482,2966972,134510
1996-03-01,Iowa,2187608,1606389,1547827,58562
1996-03-01,Kansas,1933886,1360441,1303064,57377
1996-03-01,Kentucky,2977734,1853535,1752880,100655
1996-03-01,Louisiana,3211597,1976823,1845249,131574
1996-03-01,Maine,960262,649877,614186,35691
1996-03-01,Maryland,3847850,2727663,2588279,139384
1996-03-01,Massachusetts,4769255,3209470,3053503,155967
1996-03-01,Michigan,7338482,4859904,4618982,240922
1996-03-01,Minnesota,3525379,2654206,2551152,103054
1996-03-01,Mississippi,2018642,1257086,1178860,78226
1996-03-01,Missouri,4077617,2874151,2740182,133969
1996-03-01,Montana,664470,446347,420837,25510
1996-03-01,Nebraska,1241282,910799,885884,24915
1996-03-01,Nevada,1267421,878101,832214,45887
1996-03-01,Ohio,8509703,5639643,5355959,283684
1996-03-01,Oklahoma,2473159,1574912,1509365,65547
1996-03-01,Oregon,2485287,1702651,1609782,92869
1996-03-01,Pennsylvania,9398751,5946492,5601505,344987
1996-03-01,Tennessee,4127631,2744987,2604503,140484
1996-03-01,Texas,13991101,9673017,9091964,581053
1996-03-01,Utah,1439632,1032649,997660,34989
1996-03-01,Vermont,451828,323894,310312,13582
1996-03-01,Virginia,5030574,3423452,3275105,148347
1996-03-01,Washington,4170240,2867832,2690857,176975
1996-03-01,Wisconsin,3940162,2911552,2802838,108714
1996-03-01,Wyoming,361611,254272,241765,12507
1996-04-01,Alabama,3277958,2077361,1966726,110635
1996-04-01,Alaska,419345,307664,284414,23250
1996-04-01,Arizona,3439568,2276470,2152680,123790
1996-04-01,Arkansas,1933295,1234292,1170361,63931
1996-04-01,California,23385956,15310667,14145908,1164759
1996-04-01,Colorado,2953290,2159951,2066931,93020
1996-04-01,Connecticut,2556194,1744937,1653894,91043
1996-04-01,Delaware,562781,387392,368573,18819
1996-04-01,Florida,11519997,7134438,6751539,382899
1996-04-01,Georgia,5561826,3767475,3595904,171571
1996-04-01,Hawaii,874968,592851,557407,35444
1996-04-01,Idaho,874010,612151,578414,33737
1996-04-01,Illinois,9085918,6233705,5896339,337366
1996-04-01,Indiana,4468121,3102255,2970347,131908
1996-04-01,Iowa,2188936,1608503,1549644,58859
1996-04-01,Kansas,1935898,1363076,1304768,58308
1996-04-01,Kentucky,2980783,1856764,1756770,99994
1996-04-01,Louisiana,3213618,1980859,1850060,130799
1996-04-01,Maine,961239,651467,615907,35560
1996-04-01,Maryland,3850675,2733653,2595545,138108
1996-04-01,Massachusetts,4772245,3216649,3062970,153679
1996-04-01,Michigan,7345182,4872237,4629801,242436
1996-04-01,Minnesota,3529064,2658899,2555006,103893
1996-04-01,Mississippi,2020744,1259294,1181437,77857
1996-04-01,Missouri,4081198,2882184,2745942,136242
1996-04-01,Montana,665436,447167,421823,25344
1996-04-01,Nebraska,1243525,912459,887427,25032
1996-04-01,Nevada,1272347,882492,836778,45714
1996-04-01,Ohio,8513633,5651928,5368332,283596
1996-04-01,Oklahoma,2475348,1578317,1513898,64419
1996-04-01,Oregon,2489558,1707636,1613369,94267
1996-04-01,Pennsylvania,9402361,5958858,5619814,339044
1996-04-01,Tennessee,4134226,2748736,2608946,139790
1996-04-01,Texas,14012703,9683657,9110433,573224
1996-04-01,Utah,1444080,1035068,1000018,35050
1996-04-01,Vermont,451852,324426,310699,13727
1996-04-01,Virginia,5036701,3427198,3278348,148850
1996-04-01,Washington,4175483,2877012,2700658,176354
1996-04-01,Wisconsin,3944617,2917583,2809600,107983
1996-04-01,Wyoming,361632,254529,241935,12594
1996-05-01,Alabama,3280760,2082905,1973363,109542
1996-05-01,Alaska,420336,308239,285260,22979
1996-05-01,Arizona,3448352,2282099,2156306,125793
1996-05-01,Arkansas,1935707,1236131,1171946,64185
1996-05-01,California,23400048,15344340,14194736,1149604
1996-05-01,Colorado,2959268,2160270,2066885,93385
1996-05-01,Connecticut,2556657,1746402,1655595,90807
1996-05-01,Delaware,563857,388349,369602,18747
1996-05-01,Florida,11539352,7150108,6769160,380948
1996-05-01,Georgia,5572837,3783176,3611147,172029
1996-05-01,Hawaii,875099,593878,558635,35243
1996-05-01,Idaho,876010,613353,579927,33426
1996-05-01,Illinois,9091167,6245968,5907179,338789
1996-05-01,Indiana,4472689,3102652,2973827,128825
1996-05-01,Iowa,2190264,1610113,1551362,58751
1996-05-01,Kansas,1936910,1365542,1306688,58854
1996-05-01,Kentucky,2982833,1861286,1762359,98927
1996-05-01,Louisiana,3215640,1984763,1855073,129690
1996-05-01,Maine,961216,652988,617679,35309
1996-05-01,Maryland,3854500,2740564,2604135,136429
1996-05-01,Massachusetts,4775235,3225113,3074004,151109
1996-05-01,Michigan,7351882,4884088,4640745,243343
1996-05-01,Minnesota,3533750,2663353,2559287,104066
1996-05-01,Mississippi,2021846,1261634,1184693,76941
1996-05-01,Missouri,4084780,2889310,2751947,137363
1996-05-01,Montana,666403,447884,422748,25136
1996-05-01,Nebraska,1244769,914012,889005,25007
1996-05-01,Nevada,1277272,887225,841685,45540
1996-05-01,Ohio,8517562,5664034,5380741,283293
1996-05-01,Oklahoma,2477537,1581879,1518871,63008
1996-05-01,Oregon,2493828,1711412,1616462,94950
1996-05-01,Pennsylvania,9404971,5971366,5639387,331979
1996-05-01,Tennessee,4139821,2753341,2614483,138858
1996-05-01,Texas,14033304,9694535,9131506,563029
1996-05-01,Utah,1447528,1037696,1002734,34962
1996-05-01,Vermont,452876,324904,311055,13849
1996-05-01,Virginia,5042829,3432141,3282881,149260
1996-05-01,Washington,4181727,2885468,2710330,175138
1996-05-01,Wisconsin,3949073,2922075,2815259,106816
1996-05-01,Wyoming,362654,254808,242149,12659
1996-06-01,Alabama,3283563,2088801,1980603,108198
1996-06-01,Alaska,420327,308734,286038,22696
1996-06-01,Arizona,3458136,2287464,2159934,127530
1996-06-01,Arkansas,1937118,1238099,1173880,64219
1996-06-01,California,23416139,15378518,14246367,1132151
1996-06-01,Colorado,2966245,2159571,2066571,93000
1996-06-01,Connecticut,2558120,1747908,1657442,90466
1996-06-01,Delaware,564933,389078,370256,18822
1996-06-01,Florida,11560707,7166984,6788711,378273
1996-06-01,Georgia,5583848,3799143,3626867,172276
1996-06-01,Hawaii,876230,594564,559683,34881
1996-06-01,Idaho,878010,614870,581792,33078
1996-06-01,Illinois,9097415,6253741,5915743,337998
1996-06-01,Indiana,4477256,3102151,2976942,125209
1996-06-01,Iowa,2191592,1611398,1553039,58359
1996-06-01,Kansas,1938922,1367769,1308733,59036
1996-06-01,Kentucky,2985883,1866931,1769027,97904
1996-06-01,Louisiana,3217661,1988617,1860079,128538
1996-06-01,Maine,962193,654414,619484,34930
1996-06-01,Maryland,3858324,2748132,2613416,134716
1996-06-01,Massachusetts,4778225,3233738,3085300,148438
1996-06-01,Michigan,7359582,4894836,4651696,243140
1996-06-01,Minnesota,3538435,2667212,2563681,103531
1996-06-01,Mississippi,2023947,1263788,1188016,75772
1996-06-01,Missouri,4089361,2895210,2757688,137522
1996-06-01,Montana,667369,448493,423626,24867
1996-06-01,Nebraska,1246013,915331,890453,24878
1996-06-01,Nevada,1283198,892139,846796,45343
1996-06-01,Ohio,8521491,5673381,5390976,282405
1996-06-01,Oklahoma,2480726,1585357,1523725,61632
1996-06-01,Oregon,2499099,1714176,1619087,95089
1996-06-01,Pennsylvania,9408581,5983218,5658135,325083
1996-06-01,Tennessee,4146416,2759318,2620964,138354
1996-06-01,Texas,14054906,9707126,9154959,552167
1996-06-01,Utah,1451977,1040462,1005647,34815
1996-06-01,Vermont,452901,325352,311410,13942
1996-06-01,Virginia,5048956,3437543,3288238,149305
1996-06-01,Washington,4187970,2893260,2720076,173184
1996-06-01,Wisconsin,3952528,2924967,2819766,105201
1996-06-01,Wyoming,362675,255079,242396,12683
1996-07-01,Alabama,3286365,2094676,1987805,106871
1996-07-01,Alaska,421319,309136,286664,22472
1996-07-01,Arizona,3467919,2292487,2163604,128883
1996-07-01,Arkansas,1939530,1240051,1175855,64196
1996-07-01,California,23432231,15413793,14298555,1115238
1996-07-01,Colorado,2972223,2158069,2066257,91812
1996-07-01,Connecticut,2558583,1749691,1659456,90235
1996-07-01,Delaware,566009,389661,370562,19099
1996-07-01,Florida,11581062,7185019,6809786,375233
1996-07-01,Georgia,5595859,3815199,3642450,172749
1996-07-01,Hawaii,877362,595248,560587,34661
1996-07-01,Idaho,880010,616765,583952,32813
1996-07-01,Illinois,9102664,6257937,5922883,335054
1996-07-01,Indiana,4480824,3101086,2979735,121351
1996-07-01,Iowa,2192920,1612535,1554638,57897
1996-07-01,Kansas,1940933,1369822,1310864,58958
1996-07-01,Kentucky,2988933,1873575,1775948,97627
1996-07-01,Louisiana,3220682,1992597,1865013,127584
1996-07-01,Maine,963170,655805,621347,34458
1996-07-01,Maryland,3861149,2755840,2622419,133421
1996-07-01,Massachusetts,4781215,3241652,3095626,146026
1996-07-01,Michigan,7366281,4904530,4662809,241721
1996-07-01,Minnesota,3543120,2670394,2567909,102485
1996-07-01,Mississippi,2026049,1265620,1191022,74598
1996-07-01,Missouri,4092943,2900097,2762797,137300
1996-07-01,Montana,668335,449056,424476,24580
1996-07-01,Nebraska,1247257,916416,891731,24685
1996-07-01,Nevada,1288123,897098,851948,45150
1996-07-01,Ohio,8525421,5678388,5397360,281028
1996-07-01,Oklahoma,2482914,1588659,1527933,60726
1996-07-01,Oregon,2503369,1716492,1621352,95140
1996-07-01,Pennsylvania,9412191,5994307,5674695,319612
1996-07-01,Tennessee,4153011,2766558,2627625,138933
1996-07-01,Texas,14077507,9723214,9180061,543153
1996-07-01,Utah,1455425,1043359,1008569,34790
1996-07-01,Vermont,453925,325816,311791,14025
1996-07-01,Virginia,5055084,3442676,3293676,149000
1996-07-01,Washington,4194213,2900628,2729847,170781
1996-07-01,Wisconsin,3956984,2926717,2823380,103337
1996-07-01,Wyoming,363697,255335,242651,12684
1996-08-01,Alabama,3289167,2100380,1994400,105980
1996-08-01,Alaska,421310,309475,287120,22355
1996-08-01,Arizona,3478703,2297155,2167534,129621
1996-08-01,Arkansas,1941942,1241579,1177368,64211
1996-08-01,California,23469322,15450920,14349188,1101732
1996-08-01,Colorado,2979200,2156662,2066514,90148
1996-08-01,Connecticut,2560046,1751868,1661570,90298
1996-08-01,Delaware,566085,390242,370725,19517
1996-08-01,Florida,11603417,7204630,6831668,372962
1996-08-01,Georgia,5607870,3831441,3657316,174125
1996-08-01,Hawaii,878493,596149,561464,34685
1996-08-01,Idaho,882010,619133,586364,32769
1996-08-01,Illinois,9108913,6260158,5929616,330542
1996-08-01,Indiana,4484391,3099894,2982368,117526
1996-08-01,Iowa,2194248,1613494,1555973,57521
1996-08-01,Kansas,1941945,1371832,1313059,58773
1996-08-01,Kentucky,2989983,1881019,1782396,98623
1996-08-01,Louisiana,3222704,1996572,1869723,126849
1996-08-01,Maine,964147,657153,623133,34020
1996-08-01,Maryland,3863974,2762682,2629958,132724
1996-08-01,Massachusetts,4785205,3248883,3104632,144251
1996-08-01,Michigan,7369981,4913165,4673292,239873
1996-08-01,Minnesota,3547805,2672626,2571408,101218
1996-08-01,Mississippi,2028151,1267133,1193441,73692
1996-08-01,Missouri,4096524,2904566,2767234,137332
1996-08-01,Montana,668302,449595,425237,24358
1996-08-01,Nebraska,1248501,917253,892797,24456
1996-08-01,Nevada,1294049,902027,857042,44985
1996-08-01,Ohio,8528350,5679513,5399825,279688
1996-08-01,Oklahoma,2486103,1591889,1531251,60638
1996-08-01,Oregon,2507640,1718844,1623220,95624
1996-08-01,Pennsylvania,9413801,6004912,5688691,316221
1996-08-01,Tennessee,4159606,2773772,2633091,140681
1996-08-01,Texas,14103108,9743203,9205783,537420
1996-08-01,Utah,1458874,1046331,1011392,34939
1996-08-01,Vermont,453950,326301,312177,14124
1996-08-01,Virginia,5061212,3447091,3298486,148605
1996-08-01,Washington,4201456,2907610,2739193,168417
1996-08-01,Wisconsin,3960439,2927826,2826042,101784
1996-08-01,Wyoming,363718,255591,242870,12721
1996-09-01,Alabama,3290969,2105533,1999611,105922
1996-09-01,Alaska,421302,309764,287406,22358
1996-09-01,Arizona,3489487,2300511,2170843,129668
1996-09-01,Arkansas,1944354,1242165,1177866,64299
1996-09-01,California,23508414,15487870,14394854,1093016
1996-09-01,Colorado,2986178,2155858,2067518,88340
1996-09-01,Connecticut,2561509,1754095,1663398,90697
1996-09-01,Delaware,567161,390829,370906,19923
1996-09-01,Florida,11626773,7224607,6852347,372260
1996-09-01,Georgia,5620881,3846976,3670178,176798
1996-09-01,Hawaii,879624,597251,562311,34940
1996-09-01,Idaho,884010,621652,588718,32934
1996-09-01,Illinois,9116162,6260730,5935096,325634
1996-09-01,Indiana,4487958,3098452,2984655,113797
1996-09-01,Iowa,2195576,1613953,1556656,57297
1996-09-01,Kansas,1943957,1373726,1315044,58682
1996-09-01,Kentucky,2992032,1888306,1787476,100830
1996-09-01,Louisiana,3225725,1999644,1873493,126151
1996-09-01,Maine,965123,658220,624451,33769
1996-09-01,Maryland,3867798,2767203,2634728,132475
1996-09-01,Massachusetts,4789195,3255704,3112392,143312
1996-09-01,Michigan,7375681,4919969,4681639,238330
1996-09-01,Minnesota,3551490,2673371,2573445,99926
1996-09-01,Mississippi,2030253,1268247,1194947,73300
1996-09-01,Missouri,4101106,2908771,2770774,137997
1996-09-01,Montana,669268,449994,425754,24240
1996-09-01,Nebraska,1249744,917705,893429,24276
1996-09-01,Nevada,1299975,906675,861847,44828
1996-09-01,Ohio,8532280,5678114,5398669,279445
1996-09-01,Oklahoma,2488292,1594801,1533530,61271
1996-09-01,Oregon,2511910,1721096,1624451,96645
1996-09-01,Pennsylvania,9416411,6014550,5699735,314815
1996-09-01,Tennessee,4166201,2779011,2635714,143297
1996-09-01,Texas,14129710,9765578,9229227,536351
1996-09-01,Utah,1462322,1049068,1013851,35217
1996-09-01,Vermont,454974,326729,312498,14231
1996-09-01,Virginia,5068339,3450325,3301840,148485
1996-09-01,Washington,4209699,2913717,2747445,166272
1996-09-01,Wisconsin,3963894,2928299,2827328,100971
1996-09-01,Wyoming,363740,255805,242970,12835
1996-10-01,Alabama,3293771,2109820,2003211,106609
1996-10-01,Alaska,422293,309997,287523,22474
1996-10-01,Arizona,3501271,2301884,2172736,129148
1996-10-01,Arkansas,1946765,1241684,1177156,64528
1996-10-01,California,23547505,15522838,14433664,1089174
1996-10-01,Colorado,2993155,2156228,2069602,86626
1996-10-01,Connecticut,2561972,1755949,1664570,91379
1996-10-01,Delaware,568238,391302,371161,20141
1996-10-01,Florida,11650128,7242446,6869526,372920
1996-10-01,Georgia,5632892,3860928,3680440,180488
1996-10-01,Hawaii,880755,598469,563088,35381
1996-10-01,Idaho,885010,623834,590614,33220
1996-10-01,Illinois,9122411,6260526,5938392,322134
1996-10-01,Indiana,4491526,3096852,2986143,110709
1996-10-01,Iowa,2196904,1613564,1556330,57234
1996-10-01,Kansas,1945969,1375174,1316465,58709
1996-10-01,Kentucky,2994082,1894595,1790698,103897
1996-10-01,Louisiana,3228746,2001414,1875790,125624
1996-10-01,Maine,965100,658876,625092,33784
1996-10-01,Maryland,3870623,2769061,2636344,132717
1996-10-01,Massachusetts,4794186,3262348,3119083,143265
1996-10-01,Michigan,7380381,4924303,4687127,237176
1996-10-01,Minnesota,3556175,2672462,2573904,98558
1996-10-01,Mississippi,2032355,1269092,1195569,73523
1996-10-01,Missouri,4105687,2912434,2773299,139135
1996-10-01,Montana,670234,450171,425920,24251
1996-10-01,Nebraska,1250988,917729,893517,24212
1996-10-01,Nevada,1305900,910898,866234,44664
1996-10-01,Ohio,8536209,5676161,5394951,281210
1996-10-01,Oklahoma,2491481,1597268,1534821,62447
1996-10-01,Oregon,2516181,1723032,1624893,98139
1996-10-01,Pennsylvania,9419021,6023142,5707604,315538
1996-10-01,Tennessee,4172796,2781322,2634775,146547
1996-10-01,Texas,14156311,9788916,9247692,541224
1996-10-01,Utah,1465770,1051344,1015799,35545
1996-10-01,Vermont,454998,327061,312724,14337
1996-10-01,Virginia,5074467,3452625,3303569,149056
1996-10-01,Washington,4216943,2918883,2754351,164532
1996-10-01,Wisconsin,3967350,2928057,2826887,101170
1996-10-01,Wyoming,363761,255906,242901,13005
1996-11-01,Alabama,3296573,2113270,2005595,107675
1996-11-01,Alaska,422284,310169,287511,22658
1996-11-01,Arizona,3512055,2301360,2173399,127961
1996-11-01,Arkansas,1949177,1240505,1175717,64788
1996-11-01,California,23584597,15555852,14468388,1087464
1996-11-01,Colorado,2999133,2158691,2073607,85084
1996-11-01,Connecticut,2563435,1757192,1665146,92046
1996-11-01,Delaware,568314,391546,371498,20048
1996-11-01,Florida,11672483,7257425,6882913,374512
1996-11-01,Georgia,5645903,3873119,3688933,184186
1996-11-01,Hawaii,881886,599677,563810,35867
1996-11-01,Idaho,887010,625483,591980,33503
1996-11-01,Illinois,9128660,6260775,5939981,320794
1996-11-01,Indiana,4494093,3095827,2987240,108587
1996-11-01,Iowa,2198232,1612025,1554813,57212
1996-11-01,Kansas,1947981,1376099,1317432,58667
1996-11-01,Kentucky,2996132,1899474,1792512,106962
1996-11-01,Louisiana,3230767,2001962,1876862,125100
1996-11-01,Maine,966077,659196,625079,34117
1996-11-01,Maryland,3873448,2768990,2635678,133312
1996-11-01,Massachusetts,4798176,3269198,3125493,143705
1996-11-01,Michigan,7384080,4926768,4690772,235996
1996-11-01,Minnesota,3559860,2670491,2573406,97085
1996-11-01,Mississippi,2034457,1269777,1195633,74144
1996-11-01,Missouri,4110269,2915579,2775547,140032
1996-11-01,Montana,670200,450153,425756,24397
1996-11-01,Nebraska,1252232,917486,893306,24180
1996-11-01,Nevada,1312826,914796,870394,44402
1996-11-01,Ohio,8539138,5675960,5391374,284586
1996-11-01,Oklahoma,2493670,1599295,1535517,63778
1996-11-01,Oregon,2519451,1724800,1624825,99975
1996-11-01,Pennsylvania,9420631,6030338,5712788,317550
1996-11-01,Tennessee,4179391,2781600,2631734,149866
1996-11-01,Texas,14181912,9811341,9261290,550051
1996-11-01,Utah,1469219,1053253,1017494,35759
1996-11-01,Vermont,456023,327277,312867,14410
1996-11-01,Virginia,5080595,3454630,3304399,150231
1996-11-01,Washington,4225186,2923366,2760292,163074
1996-11-01,Wisconsin,3970805,2927495,2825083,102412
1996-11-01,Wyoming,364783,255878,242725,13153
1996-12-01,Alabama,3298375,2116205,2007664,108541
1996-12-01,Alaska,422276,310387,287553,22834
1996-12-01,Arizona,3521838,2299423,2173660,125763
1996-12-01,Arkansas,1951589,1239275,1174469,64806
1996-12-01,California,23617688,15587392,14503984,1083408
1996-12-01,Colorado,3005110,2163231,2079715,83516
1996-12-01,Connecticut,2563898,1757704,1665438,92266
1996-12-01,Delaware,569390,391512,371847,19665
1996-12-01,Florida,11692838,7270824,6895033,375791
1996-12-01,Georgia,5656913,3883735,3697120,186615
1996-12-01,Hawaii,883017,600662,564450,36212
1996-12-01,Idaho,889011,626612,592965,33647
1996-12-01,Illinois,9132909,6262090,5941826,320264
1996-12-01,Indiana,4496660,3095874,2988733,107141
1996-12-01,Iowa,2198560,1609602,1552659,56943
1996-12-01,Kansas,1948992,1376638,1318336,58302
1996-12-01,Kentucky,2997182,1902980,1793932,109048
1996-12-01,Louisiana,3232789,2001668,1877367,124301
1996-12-01,Maine,967054,659368,624688,34680
1996-12-01,Maryland,3876272,2768191,2634273,133918
1996-12-01,Massachusetts,4801166,3276203,3132290,143913
1996-12-01,Michigan,7386780,4928399,4694532,233867
1996-12-01,Minnesota,3563545,2668540,2572976,95564
1996-12-01,Mississippi,2036559,1270328,1195760,74568
1996-12-01,Missouri,4112851,2918140,2778392,139748
1996-12-01,Montana,671167,450052,425445,24607
1996-12-01,Nebraska,1252476,917197,893175,24022
1996-12-01,Nevada,1317752,918574,874636,43938
1996-12-01,Ohio,8540068,5678460,5390556,287904
1996-12-01,Oklahoma,2495858,1600852,1536182,64670
1996-12-01,Oregon,2522722,1726466,1624996,101470
1996-12-01,Pennsylvania,9421241,6036201,5716802,319399
1996-12-01,Tennessee,4184986,2781341,2629112,152229
1996-12-01,Texas,14204514,9830983,9272462,558521
1996-12-01,Utah,1472667,1055025,1019340,35685
1996-12-01,Vermont,456047,327402,312995,14407
1996-12-01,Virginia,5085722,3456766,3305490,151276
1996-12-01,Washington,4231429,2927542,2766267,161275
1996-12-01,Wisconsin,3973261,2927299,2823237,104062
1996-12-01,Wyoming,364804,255770,242548,13222
1997-01-01,Alabama,3300177,2118833,2009942,108891
1997-01-01,Alaska,422267,310662,287746,22916
1997-01-01,Arizona,3532622,2296685,2174126,122559
1997-01-01,Arkansas,1954001,1238426,1173905,64521
1997-01-01,California,23649780,15618081,14543009,1075072
1997-01-01,Colorado,3011088,2168878,2087271,81607
1997-01-01,Connecticut,2564361,1757646,1665799,91847
1997-01-01,Delaware,570466,391272,372127,19145
1997-01-01,Florida,11713194,7284573,6908554,376019
1997-01-01,Georgia,5667924,3893440,3706215,187225
1997-01-01,Hawaii,884149,601288,564924,36364
1997-01-01,Idaho,891011,627482,593829,33653
1997-01-01,Illinois,9137158,6264684,5945892,318792
1997-01-01,Indiana,4499228,3097220,2991013,106207
1997-01-01,Iowa,2199889,1607063,1550766,56297
1997-01-01,Kansas,1950004,1376980,1319421,57559
1997-01-01,Kentucky,2998231,1905243,1795583,109660
1997-01-01,Louisiana,3234810,2001102,1877683,123419
1997-01-01,Maine,968031,659521,624212,35309
1997-01-01,Maryland,3878097,2767733,2633334,134399
1997-01-01,Massachusetts,4804156,3283299,3139784,143515
1997-01-01,Michigan,7389480,4929741,4699501,230240
1997-01-01,Minnesota,3567230,2667432,2573237,94195
1997-01-01,Mississippi,2037661,1270737,1196201,74536
1997-01-01,Missouri,4116432,2919921,2782121,137800
1997-01-01,Montana,671133,449999,425175,24824
1997-01-01,Nebraska,1253719,917061,893314,23747
1997-01-01,Nevada,1323677,922463,879117,43346
1997-01-01,Ohio,8541997,5683545,5394515,289030
1997-01-01,Oklahoma,2498047,1601959,1536981,64978
1997-01-01,Oregon,2526992,1728097,1626081,102016
1997-01-01,Pennsylvania,9420851,6040661,5720280,320381
1997-01-01,Tennessee,4190581,2781307,2628136,153171
1997-01-01,Texas,14227115,9847371,9283773,563598
1997-01-01,Utah,1475116,1056851,1021529,35322
1997-01-01,Vermont,457071,327498,313187,14311
1997-01-01,Virginia,5090850,3459125,3307659,151466
1997-01-01,Washington,4237672,2932060,2773291,158769
1997-01-01,Wisconsin,3975716,2928223,2822608,105615
1997-01-01,Wyoming,364826,255643,242430,13213
1997-02-01,Alabama,3300979,2121101,2012414,108687
1997-02-01,Alaska,422259,310956,288118,22838
1997-02-01,Arizona,3541406,2294012,2175360,118652
1997-02-01,Arkansas,1955412,1238133,1174040,64093
1997-02-01,California,23675872,15648451,14586270,1062181
1997-02-01,Colorado,3016065,2175382,2096135,79247
1997-02-01,Connecticut,2563825,1757626,1666824,90802
1997-02-01,Delaware,570542,390974,372302,18672
1997-02-01,Florida,11730549,7300060,6925178,374882
1997-02-01,Georgia,5677935,3902864,3716822,186042
1997-02-01,Hawaii,884280,601521,565180,36341
1997-02-01,Idaho,892011,628378,594845,33533
1997-02-01,Illinois,9139407,6267959,5952698,315261
1997-02-01,Indiana,4499795,3100416,2994801,105615
1997-02-01,Iowa,2200217,1605070,1549862,55208
1997-02-01,Kansas,1951016,1377245,1320782,56463
1997-02-01,Kentucky,2998281,1906487,1797765,108722
1997-02-01,Louisiana,3235831,2000916,1878194,122722
1997-02-01,Maine,968008,659627,623823,35804
1997-02-01,Maryland,3878922,2768295,2633621,134674
1997-02-01,Massachusetts,4806146,3290677,3148222,142455
1997-02-01,Michigan,7390180,4931402,4706072,225330
1997-02-01,Minnesota,3569915,2667672,2574818,92854
1997-02-01,Mississippi,2038763,1270854,1196854,74000
1997-02-01,Missouri,4118014,2920921,2786563,134358
1997-02-01,Montana,672099,450082,425084,24998
1997-02-01,Nebraska,1253963,917104,893750,23354
1997-02-01,Nevada,1329603,926624,883885,42739
1997-02-01,Ohio,8539927,5689993,5403581,286412
1997-02-01,Oklahoma,2499236,1602824,1537996,64828
1997-02-01,Oregon,2529263,1729946,1628508,101438
1997-02-01,Pennsylvania,9418461,6043710,5723251,320459
1997-02-01,Tennessee,4195177,2781764,2628737,153027
1997-02-01,Texas,14246716,9861005,9296775,564230
1997-02-01,Utah,1477564,1058845,1024095,34750
1997-02-01,Vermont,457096,327684,313569,14115
1997-02-01,Virginia,5093978,3461445,3311228,150217
1997-02-01,Washington,4242915,2937816,2781978,155838
1997-02-01,Wisconsin,3976172,2930448,2823931,106517
1997-02-01,Wyoming,364847,255565,242450,13115
1997-03-01,Alabama,3302781,2123294,2015220,108074
1997-03-01,Alaska,423250,311268,288670,22598
1997-03-01,Arizona,3551190,2292360,2178046,114314
1997-03-01,Arkansas,1956824,1238454,1174772,63682
1997-03-01,California,23703963,15680435,14634967,1045468
1997-03-01,Colorado,3022043,2183120,2106429,76691
1997-03-01,Connecticut,2564288,1758243,1669001,89242
1997-03-01,Delaware,570618,390869,372512,18357
1997-03-01,Florida,11748904,7318632,6946428,372204
1997-03-01,Georgia,5687946,3912784,3729387,183397
1997-03-01,Hawaii,885411,601516,565322,36194
1997-03-01,Idaho,893011,629435,596129,33306
1997-03-01,Illinois,9142656,6271910,5962689,309221
1997-03-01,Indiana,4501363,3105925,3000701,105224
1997-03-01,Iowa,2200545,1603710,1550005,53705
1997-03-01,Kansas,1952028,1377729,1322684,55045
1997-03-01,Kentucky,2999331,1907202,1800548,106654
1997-03-01,Louisiana,3236853,2001606,1879419,122187
1997-03-01,Maine,967984,659674,623708,35966
1997-03-01,Maryland,3880746,2769946,2635564,134382
1997-03-01,Massachusetts,4808136,3298009,3157189,140820
1997-03-01,Michigan,7391880,4934323,4714922,219401
1997-03-01,Minnesota,3572600,2669715,2578320,91395
1997-03-01,Mississippi,2040864,1270775,1197697,73078
1997-03-01,Missouri,4120595,2921676,2791739,129937
1997-03-01,Montana,672065,450362,425297,25065
1997-03-01,Nebraska,1254207,917402,894544,22858
1997-03-01,Nevada,1334528,931123,889000,42123
1997-03-01,Ohio,8539856,5696494,5416850,279644
1997-03-01,Oklahoma,2501425,1603765,1539398,64367
1997-03-01,Oregon,2532533,1732231,1632358,99873
1997-03-01,Pennsylvania,9417071,6046416,5726875,319541
1997-03-01,Tennessee,4199772,2782361,2630083,152278
1997-03-01,Texas,14267318,9873434,9313064,560370
1997-03-01,Utah,1481013,1061136,1027071,34065
1997-03-01,Vermont,457120,328079,314251,13828
1997-03-01,Virginia,5099105,3463678,3316310,147368
1997-03-01,Washington,4249159,2945081,2792364,152717
1997-03-01,Wisconsin,3978627,2934064,2827691,106373
1997-03-01,Wyoming,364869,255600,242681,12919
1997-04-01,Alabama,3303583,2126031,2018538,107493
1997-04-01,Alaska,423241,311654,289360,22294
1997-04-01,Arizona,3560974,2292434,2182243,110191
1997-04-01,Arkansas,1958236,1239305,1175769,63536
1997-04-01,California,23735055,15717198,14687711,1029487
1997-04-01,Colorado,3028020,2191865,2117439,74426
1997-04-01,Connecticut,2564751,1759648,1672122,87526
1997-04-01,Delaware,571694,390197,372877,17320
1997-04-01,Florida,11768259,7341282,6972024,369258
1997-04-01,Georgia,5698957,3923810,3743378,180432
1997-04-01,Hawaii,886542,601598,565495,36103
1997-04-01,Idaho,895011,630686,597592,33094
1997-04-01,Illinois,9145905,6277711,5975522,302189
1997-04-01,Indiana,4502930,3113224,3007930,105294
1997-04-01,Iowa,2200873,1602941,1550783,52158
1997-04-01,Kansas,1953040,1378668,1325074,53594
1997-04-01,Kentucky,3000381,1908130,1803770,104360
1997-04-01,Louisiana,3238874,2003229,1881402,121827
1997-04-01,Maine,968961,659763,623988,35775
1997-04-01,Maryland,3882571,2772448,2638587,133861
1997-04-01,Massachusetts,4811126,3304528,3165396,139132
1997-04-01,Michigan,7393579,4939894,4725944,213950
1997-04-01,Minnesota,3575285,2673857,2583835,90022
1997-04-01,Mississippi,2041966,1270939,1198595,72344
1997-04-01,Missouri,4124177,2923148,2797228,125920
1997-04-01,Montana,672032,450843,425795,25048
1997-04-01,Nebraska,1255451,918020,895547,22473
1997-04-01,Nevada,1340454,935972,894359,41613
1997-04-01,Ohio,8540785,5703263,5432665,270598
1997-04-01,Oklahoma,2503614,1604942,1540977,63965
1997-04-01,Oregon,2535804,1735351,1637268,98083
1997-04-01,Pennsylvania,9415681,6050606,5731995,318611
1997-04-01,Tennessee,4205367,2782808,2631078,151730
1997-04-01,Texas,14288919,9887198,9333095,554103
1997-04-01,Utah,1483461,1063727,1030277,33450
1997-04-01,Vermont,457145,328704,315192,13512
1997-04-01,Virginia,5103233,3465934,3322492,143442
1997-04-01,Washington,4255402,2953900,2803914,149986
1997-04-01,Wisconsin,3980083,2939364,2833844,105520
1997-04-01,Wyoming,364890,255758,243084,12674
1997-05-01,Alabama,3305385,2129081,2021980,107101
1997-05-01,Alaska,423233,312060,290045,22015
1997-05-01,Arizona,3570757,2294349,2187693,106656
1997-05-01,Arkansas,1960648,1240235,1176572,63663
1997-05-01,California,23767146,15756329,14739373,1016956
1997-05-01,Colorado,3033998,2200988,2128332,72656
1997-05-01,Connecticut,2565214,1761075,1675263,85812
1997-05-01,Delaware,572770,389814,373312,16502
1997-05-01,Florida,11788614,7365742,6998972,366770
1997-05-01,Georgia,5709968,3934853,3757018,177835
1997-05-01,Hawaii,887673,601876,565722,36154
1997-05-01,Idaho,897011,632047,599041,33006
1997-05-01,Illinois,9150154,6284406,5988515,295891
1997-05-01,Indiana,4505497,3120426,3014419,106007
1997-05-01,Iowa,2202201,1602425,1551600,50825
1997-05-01,Kansas,1954052,1379795,1327388,52407
1997-05-01,Kentucky,3001431,1909191,1806843,102348
1997-05-01,Louisiana,3240895,2005067,1883717,121350
1997-05-01,Maine,969938,659809,624528,35281
1997-05-01,Maryland,3884396,2774594,2641130,133464
1997-05-01,Massachusetts,4814116,3309324,3171707,137617
1997-05-01,Michigan,7396279,4947401,4737350,210051
1997-05-01,Minnesota,3578970,2679536,2590667,88869
1997-05-01,Mississippi,2044068,1271298,1199142,72156
1997-05-01,Missouri,4126758,2925433,2801910,123523
1997-05-01,Montana,672998,451435,426451,24984
1997-05-01,Nebraska,1256694,918722,896403,22319
1997-05-01,Nevada,1346380,940971,899692,41279
1997-05-01,Ohio,8541715,5710346,5448411,261935
1997-05-01,Oklahoma,2505802,1606117,1542258,63859
1997-05-01,Oregon,2539074,1739234,1642592,96642
1997-05-01,Pennsylvania,9416291,6055667,5737790,317877
1997-05-01,Tennessee,4210962,2782297,2630826,151471
1997-05-01,Texas,14311520,9901467,9354030,547437
1997-05-01,Utah,1486909,1066376,1033353,33023
1997-05-01,Vermont,458169,329444,316230,13214
1997-05-01,Virginia,5108361,3467296,3328730,138566
1997-05-01,Washington,4262645,2963097,2815203,147894
1997-05-01,Wisconsin,3982538,2945606,2841183,104423
1997-05-01,Wyoming,364912,255976,243546,12430
1997-06-01,Alabama,3307188,2132077,2025352,106725
1997-06-01,Alaska,423224,312368,290596,21772
1997-06-01,Arizona,3581541,2297834,2193876,103958
1997-06-01,Arkansas,1962060,1240741,1176917,63824
1997-06-01,California,23800238,15793951,14786936,1007015
1997-06-01,Colorado,3039975,2210180,2138778,71402
1997-06-01,Connecticut,2565677,1761521,1677488,84033
1997-06-01,Delaware,572846,389527,373734,15793
1997-06-01,Florida,11808970,7388676,7024202,364474
1997-06-01,Georgia,5720979,3944698,3769149,175549
1997-06-01,Hawaii,888804,602240,566046,36194
1997-06-01,Idaho,898011,633239,600269,32970
1997-06-01,Illinois,9154402,6291179,5999569,291610
1997-06-01,Indiana,4508065,3125898,3018751,107147
1997-06-01,Iowa,2202529,1601582,1551829,49753
1997-06-01,Kansas,1955063,1380771,1329251,51520
1997-06-01,Kentucky,3002480,1910137,1809509,100628
1997-06-01,Louisiana,3242916,2006695,1886218,120477
1997-06-01,Maine,969915,659618,625061,34557
1997-06-01,Maryland,3886221,2775358,2642153,133205
1997-06-01,Massachusetts,4817106,3312067,3175941,136126
1997-06-01,Michigan,7398979,4955792,4747773,208019
1997-06-01,Minnesota,3582655,2685760,2597999,87761
1997-06-01,Mississippi,2045170,1271812,1199371,72441
1997-06-01,Missouri,4130340,2928290,2805367,122923
1997-06-01,Montana,672964,452010,427125,24885
1997-06-01,Nebraska,1256938,919303,896977,22326
1997-06-01,Nevada,1351305,945915,904846,41069
1997-06-01,Ohio,8543644,5717775,5462080,255695
1997-06-01,Oklahoma,2507991,1607301,1543367,63934
1997-06-01,Oregon,2542345,1743469,1647767,95702
1997-06-01,Pennsylvania,9415902,6060359,5743768,316591
1997-06-01,Tennessee,4216557,2780344,2629537,150807
1997-06-01,Texas,14335122,9914223,9373715,540508
1997-06-01,Utah,1489358,1068918,1036101,32817
1997-06-01,Vermont,458193,330190,317253,12937
1997-06-01,Virginia,5113488,3467186,3334336,132850
1997-06-01,Washington,4268888,2971415,2825224,146191
1997-06-01,Wisconsin,3984994,2952171,2848818,103353
1997-06-01,Wyoming,365933,256159,243972,12187
1997-07-01,Alabama,3308990,2135036,2028916,106120
1997-07-01,Alaska,423215,312583,291037,21546
1997-07-01,Arizona,3591325,2302301,2200052,102249
1997-07-01,Arkansas,1964471,1240710,1176922,63788
1997-07-01,California,23834329,15829660,14831156,998504
1997-07-01,Colorado,3045953,2219388,2148620,70768
1997-07-01,Connecticut,2566140,1760405,1678333,82072
1997-07-01,Delaware,573922,389258,374172,15086
1997-07-01,Florida,11830325,7408235,7046210,362025
1997-07-01,Georgia,5732990,3953152,3779669,173483
1997-07-01,Hawaii,888936,602516,566432,36084
1997-07-01,Idaho,900011,634005,601152,32853
1997-07-01,Illinois,9159651,6298301,6008300,290001
1997-07-01,Indiana,4510632,3128918,3020679,108239
1997-07-01,Iowa,2203857,1600300,1551327,48973
1997-07-01,Kansas,1957075,1381540,1330644,50896
1997-07-01,Kentucky,3003530,1911087,1812136,98951
1997-07-01,Louisiana,3244938,2008268,1889121,119147
1997-07-01,Maine,970892,659107,625360,33747
1997-07-01,Maryland,3889045,2774724,2641735,132989
1997-07-01,Massachusetts,4820096,3313129,3178710,134419
1997-07-01,Michigan,7402679,4964552,4757095,207457
1997-07-01,Minnesota,3586340,2691638,2605197,86441
1997-07-01,Mississippi,2047272,1272612,1199747,72865
1997-07-01,Missouri,4133921,2931550,2807999,123551
1997-07-01,Montana,673930,452550,427816,24734
1997-07-01,Nebraska,1258182,919765,897425,22340
1997-07-01,Nevada,1357231,950694,909828,40866
1997-07-01,Ohio,8545573,5725602,5472738,252864
1997-07-01,Oklahoma,2510180,1608721,1544752,63969
1997-07-01,Oregon,2545615,1747614,1652513,95101
1997-07-01,Pennsylvania,9416512,6065143,5750912,314231
1997-07-01,Tennessee,4222152,2778029,2628727,149302
1997-07-01,Texas,14358723,9925211,9392271,532940
1997-07-01,Utah,1492806,1071323,1038538,32785
1997-07-01,Vermont,459218,330871,318179,12692
1997-07-01,Virginia,5118616,3466373,3339792,126581
1997-07-01,Washington,4276131,2978354,2834007,144347
1997-07-01,Wisconsin,3987449,2959233,2856765,102468
1997-07-01,Wyoming,365955,256268,244324,11944
1997-08-01,Alabama,3312792,2137759,2032565,105194
1997-08-01,Alaska,424207,312779,291451,21328
1997-08-01,Arizona,3600109,2307350,2206009,101341
1997-08-01,Arkansas,1965883,1240441,1176892,63549
1997-08-01,California,23876421,15864185,14873058,991127
1997-08-01,Colorado,3051930,2228441,2157705,70736
1997-08-01,Connecticut,2567603,1757599,1677747,79852
1997-08-01,Delaware,573998,388999,374654,14345
1997-08-01,Florida,11851680,7423771,7064165,359606
1997-08-01,Georgia,5744000,3960463,3788777,171686
1997-08-01,Hawaii,890067,602580,566736,35844
1997-08-01,Idaho,901012,634363,601655,32708
1997-08-01,Illinois,9166900,6306211,6014670,291541
1997-08-01,Indiana,4513200,3129672,3020766,108906
1997-08-01,Iowa,2205185,1598794,1550351,48443
1997-08-01,Kansas,1958087,1382203,1331667,50536
1997-08-01,Kentucky,3007580,1912055,1814971,97084
1997-08-01,Louisiana,3246959,2010017,1892532,117485
1997-08-01,Maine,970869,658319,625208,33111
1997-08-01,Maryland,3891870,2773287,2640461,132826
1997-08-01,Massachusetts,4824086,3313013,3180682,132331
1997-08-01,Michigan,7406378,4973640,4766042,207598
1997-08-01,Minnesota,3590025,2696605,2611770,84835
1997-08-01,Mississippi,2049374,1273681,1200583,73098
1997-08-01,Missouri,4137503,2934933,2810136,124797
1997-08-01,Montana,673897,453180,428588,24592
1997-08-01,Nebraska,1259426,920144,897893,22251
1997-08-01,Nevada,1363156,955336,914660,40676
1997-08-01,Ohio,8549503,5733377,5480094,253283
1997-08-01,Oklahoma,2512369,1610250,1546525,63725
1997-08-01,Oregon,2549886,1751650,1656828,94822
1997-08-01,Pennsylvania,9420122,6069922,5759164,310758
1997-08-01,Tennessee,4227747,2776940,2630092,146848
1997-08-01,Texas,14384324,9935474,9409748,525726
1997-08-01,Utah,1496255,1073668,1040727,32941
1997-08-01,Vermont,459242,331412,318904,12508
1997-08-01,Virginia,5123744,3465521,3345371,120150
1997-08-01,Washington,4283375,2984024,2841523,142501
1997-08-01,Wisconsin,3990905,2966453,2864663,101790
1997-08-01,Wyoming,365976,256323,244601,11722
1997-09-01,Alabama,3316594,2139990,2036259,103731
1997-09-01,Alaska,424198,312999,291919,21080
1997-09-01,Arizona,3607892,2312853,2212081,100772
1997-09-01,Arkansas,1968295,1240208,1177093,63115
1997-09-01,California,23918512,15897303,14913798,983505
1997-09-01,Colorado,3057908,2237410,2166242,71168
1997-09-01,Connecticut,2568066,1753472,1676153,77319
1997-09-01,Delaware,575074,388801,375210,13591
1997-09-01,Florida,11874035,7436138,7078940,357198
1997-09-01,Georgia,5756011,3967368,3797199,170169
1997-09-01,Hawaii,891198,602322,566866,35456
1997-09-01,Idaho,903012,634644,602032,32612
1997-09-01,Illinois,9175149,6314785,6019376,295409
1997-09-01,Indiana,4516767,3128714,3020022,108692
1997-09-01,Iowa,2206513,1597489,1549576,47913
1997-09-01,Kansas,1960099,1382860,1332613,50247
1997-09-01,Kentucky,3010630,1913009,1818221,94788
1997-09-01,Louisiana,3248980,2011964,1896422,115542
1997-09-01,Maine,971845,657344,624603,32741
1997-09-01,Maryland,3895695,2771728,2639194,132534
1997-09-01,Massachusetts,4828076,3312180,3182457,129723
1997-09-01,Michigan,7410078,4983084,4775294,207790
1997-09-01,Minnesota,3593710,2700416,2617366,83050
1997-09-01,Mississippi,2051476,1274877,1202046,72831
1997-09-01,Missouri,4140085,2938122,2812125,125997
1997-09-01,Montana,674863,454047,429511,24536
1997-09-01,Nebraska,1259669,920515,898555,21960
1997-09-01,Nevada,1368082,960054,919458,40596
1997-09-01,Ohio,8553432,5739428,5484337,255091
1997-09-01,Oklahoma,2514557,1611704,1548671,63033
1997-09-01,Oregon,2553156,1755509,1660852,94657
1997-09-01,Pennsylvania,9423732,6073668,5767454,306214
1997-09-01,Tennessee,4232342,2777793,2634641,143152
1997-09-01,Texas,14411926,9945353,9427183,518170
1997-09-01,Utah,1498703,1076163,1042864,33299
1997-09-01,Vermont,460266,331741,319370,12371
1997-09-01,Virginia,5129871,3464869,3350888,113981
1997-09-01,Washington,4290618,2988892,2847901,140991
1997-09-01,Wisconsin,3993360,2972840,2871851,100989
1997-09-01,Wyoming,365998,256389,244849,11540
1997-10-01,Alabama,3320396,2141619,2039774,101845
1997-10-01,Alaska,424190,313258,292455,20803
1997-10-01,Arizona,3616676,2318914,2218421,100493
1997-10-01,Arkansas,1969707,1240097,1177409,62688
1997-10-01,California,23960604,15930015,14953209,976806
1997-10-01,Colorado,3063885,2246228,2173997,72231
1997-10-01,Connecticut,2569529,1748830,1674186,74644
1997-10-01,Delaware,576150,389233,375866,13367
1997-10-01,Florida,11895391,7447231,7091793,355438
1997-10-01,Georgia,5767022,3974695,3805350,169345
1997-10-01,Hawaii,891329,601793,566738,35055
1997-10-01,Idaho,905012,635314,602618,32696
1997-10-01,Illinois,9182398,6323166,6023137,300029
1997-10-01,Indiana,4520334,3126836,3019268,107568
1997-10-01,Iowa,2206841,1596569,1549321,47248
1997-10-01,Kansas,1962111,1383701,1333640,50061
1997-10-01,Kentucky,3013679,1913994,1821766,92228
1997-10-01,Louisiana,3251002,2013588,1900210,113378
1997-10-01,Maine,972822,656276,623641,32635
1997-10-01,Maryland,3898519,2770636,2638531,132105
1997-10-01,Massachusetts,4832066,3311342,3184475,126867
1997-10-01,Michigan,7413778,4992520,4784469,208051
1997-10-01,Minnesota,3598396,2702924,2621521,81403
1997-10-01,Mississippi,2053578,1275952,1203903,72049
1997-10-01,Missouri,4143666,2941012,2814020,126992
1997-10-01,Montana,674829,455169,430528,24641
1997-10-01,Nebraska,1260913,920942,899357,21585
1997-10-01,Nevada,1373008,960651,919924,40727
1997-10-01,Ohio,8557362,5742602,5485675,256927
1997-10-01,Oklahoma,2517746,1613210,1551032,62178
1997-10-01,Oregon,2556427,1759069,1664660,94409
1997-10-01,Pennsylvania,9427342,6075970,5774209,301761
1997-10-01,Tennessee,4237937,2780132,2641504,138628
1997-10-01,Texas,14438527,9955367,9445349,510018
1997-10-01,Utah,1502151,1078919,1045028,33891
1997-10-01,Vermont,460291,331865,319580,12285
1997-10-01,Virginia,5134999,3464572,3355802,108770
1997-10-01,Washington,4296861,2993178,2853099,140079
1997-10-01,Wisconsin,3996816,2977652,2877487,100165
1997-10-01,Wyoming,366019,256557,245100,11457
1997-11-01,Alabama,3323198,2142520,2042801,99719
1997-11-01,Alaska,425181,313536,293057,20479
1997-11-01,Arizona,3624460,2325409,2224755,100654
1997-11-01,Arkansas,1971118,1240018,1177516,62502
1997-11-01,California,23998695,15961294,14989426,971868
1997-11-01,Colorado,3069863,2254519,2180579,73940
1997-11-01,Connecticut,2569992,1744275,1672296,71979
1997-11-01,Delaware,576226,388951,376609,12342
1997-11-01,Florida,11914746,7457775,7103497,354278
1997-11-01,Georgia,5777033,3982696,3813395,169301
1997-11-01,Hawaii,892460,601101,566392,34709
1997-11-01,Idaho,906012,636531,603552,32979
1997-11-01,Illinois,9188647,6329141,6025883,303258
1997-11-01,Indiana,4522902,3124546,3019035,105511
1997-11-01,Iowa,2208170,1595848,1549353,46495
1997-11-01,Kansas,1964122,1384720,1334702,50018
1997-11-01,Kentucky,3016729,1914942,1825219,89723
1997-11-01,Louisiana,3252023,2014585,1903170,111415
1997-11-01,Maine,972799,655097,622486,32611
1997-11-01,Maryland,3901344,2769961,2638602,131359
1997-11-01,Massachusetts,4835056,3310633,3186619,124014
1997-11-01,Michigan,7416478,5000520,4792998,207522
1997-11-01,Minnesota,3601081,2704114,2624320,79794
1997-11-01,Mississippi,2055680,1276691,1205733,70958
1997-11-01,Missouri,4146248,2943278,2815504,127774
1997-11-01,Montana,674796,456363,431489,24874
1997-11-01,Nebraska,1261157,921398,900079,21319
1997-11-01,Nevada,1377933,961403,920340,41063
1997-11-01,Ohio,8560291,5741597,5484169,257428
1997-11-01,Oklahoma,2519935,1614891,1553384,61507
1997-11-01,Oregon,2559697,1761986,1667988,93998
1997-11-01,Pennsylvania,9428952,6076342,5778258,298084
1997-11-01,Tennessee,4242532,2782544,2648499,134045
1997-11-01,Texas,14463129,9966380,9464033,502347
1997-11-01,Utah,1504600,1081836,1047113,34723
1997-11-01,Vermont,460315,331838,319620,12218
1997-11-01,Virginia,5139126,3464316,3359589,104727
1997-11-01,Washington,4304104,2996792,2857048,139744
1997-11-01,Wisconsin,3999271,2980073,2880962,99111
1997-11-01,Wyoming,366041,256817,245332,11485
1997-12-01,Alabama,3326000,2142893,2045347,97546
1997-12-01,Alaska,425172,313765,293661,20104
1997-12-01,Arizona,3632244,2332401,2231370,101031
1997-12-01,Arkansas,1972530,1239993,1177331,62662
1997-12-01,California,24034787,15991346,15023125,968221
1997-12-01,Colorado,3074840,2262706,2186529,76177
1997-12-01,Connecticut,2570455,1740475,1671088,69387
1997-12-01,Delaware,577302,390232,377424,12808
1997-12-01,Florida,11934101,7468254,7115230,353024
1997-12-01,Georgia,5787044,3991679,3821967,169712
1997-12-01,Hawaii,892591,600490,566061,34429
1997-12-01,Idaho,908012,638320,604976,33344
1997-12-01,Illinois,9193896,6330910,6027846,303064
1997-12-01,Indiana,4524469,3122311,3019734,102577
1997-12-01,Iowa,2208498,1595164,1549410,45754
1997-12-01,Kansas,1965134,1385972,1335938,50034
1997-12-01,Kentucky,3018779,1915940,1828420,87520
1997-12-01,Louisiana,3254044,2015474,1905472,110002
1997-12-01,Maine,972776,653929,621536,32393
1997-12-01,Maryland,3903169,2769503,2639459,130044
1997-12-01,Massachusetts,4837046,3310247,3188956,121291
1997-12-01,Michigan,7418177,5006184,4800926,205258
1997-12-01,Minnesota,3604766,2704832,2626809,78023
1997-12-01,Mississippi,2056782,1277164,1207345,69819
1997-12-01,Missouri,4148829,2944931,2816644,128287
1997-12-01,Montana,674762,457460,432307,25153
1997-12-01,Nebraska,1262401,921903,900642,21261
1997-12-01,Nevada,1382859,962307,920829,41478
1997-12-01,Ohio,8561220,5736876,5481285,255591
1997-12-01,Oklahoma,2522124,1617010,1555748,61262
1997-12-01,Oregon,2562968,1764435,1670729,93706
1997-12-01,Pennsylvania,9430562,6074933,5780001,294932
1997-12-01,Tennessee,4246127,2784454,2654335,130119
1997-12-01,Texas,14485730,9979944,9483987,495957
1997-12-01,Utah,1508048,1084883,1049205,35678
1997-12-01,Vermont,461339,331770,319632,12138
1997-12-01,Virginia,5143254,3464718,3363158,101560
1997-12-01,Washington,4310347,3000120,2860365,139755
1997-12-01,Wisconsin,4000727,2979934,2882349,97585
1997-12-01,Wyoming,366062,257173,245592,11581
1998-01-01,Alabama,3328802,2143042,2047388,95654
1998-01-01,Alaska,425164,314023,294243,19780
1998-01-01,Arizona,3639028,2339726,2238444,101282
1998-01-01,Arkansas,1973942,1240130,1177088,63042
1998-01-01,California,24070878,16020412,15055216,965196
1998-01-01,Colorado,3079818,2271029,2192414,78615
1998-01-01,Connecticut,2570918,1737973,1671067,66906
1998-01-01,Delaware,578379,391557,378280,13277
1998-01-01,Florida,11953456,7478800,7127702,351098
1998-01-01,Georgia,5797055,4001341,3831181,170160
1998-01-01,Hawaii,892722,600156,565890,34266
1998-01-01,Idaho,909012,640515,606845,33670
1998-01-01,Illinois,9200145,6327855,6028679,299176
1998-01-01,Indiana,4527036,3120317,3021351,98966
1998-01-01,Iowa,2209826,1594477,1549330,45147
1998-01-01,Kansas,1967146,1387473,1337401,50072
1998-01-01,Kentucky,3021829,1917027,1831108,85919
1998-01-01,Louisiana,3255066,2016848,1907729,109119
1998-01-01,Maine,973753,652978,621133,31845
1998-01-01,Maryland,3905993,2768820,2640756,128064
1998-01-01,Massachusetts,4840037,3310093,3191322,118771
1998-01-01,Michigan,7420877,5009309,4807782,201527
1998-01-01,Minnesota,3607451,2706235,2629983,76252
1998-01-01,Mississippi,2058883,1277437,1208646,68791
1998-01-01,Missouri,4151411,2945984,2817535,128449
1998-01-01,Montana,675728,458362,432923,25439
1998-01-01,Nebraska,1262644,922344,901019,21325
1998-01-01,Nevada,1387785,963366,921525,41841
1998-01-01,Ohio,8563150,5729660,5477855,251805
1998-01-01,Oklahoma,2524313,1619495,1558055,61440
1998-01-01,Oregon,2565238,1766909,1672966,93943
1998-01-01,Pennsylvania,9431172,6072218,5780079,292139
1998-01-01,Tennessee,4250722,2786249,2659131,127118
1998-01-01,Texas,14509331,9996709,9505297,491412
1998-01-01,Utah,1510497,1088022,1051405,36617
1998-01-01,Vermont,461364,331806,319746,12060
1998-01-01,Virginia,5147382,3466463,3367410,99053
1998-01-01,Washington,4315591,3003634,2863641,139993
1998-01-01,Wisconsin,4003182,2977562,2881877,95685
1998-01-01,Wyoming,366083,257656,245928,11728
1998-02-01,Alabama,3330604,2143140,2048758,94382
1998-02-01,Alaska,425155,314319,294736,19583
1998-02-01,Arizona,3646811,2347301,2246083,101218
1998-02-01,Arkansas,1974354,1240558,1177202,63356
1998-02-01,California,24102970,16049015,15086351,962664
1998-02-01,Colorado,3084795,2279115,2198125,80990
1998-02-01,Connecticut,2570381,1736847,1672278,64569
1998-02-01,Delaware,578455,392837,379133,13704
1998-02-01,Florida,11969811,7489695,7141241,348454
1998-02-01,Georgia,5807066,4011182,3840607,170575
1998-02-01,Hawaii,893854,600167,565913,34254
1998-02-01,Idaho,910012,642874,608953,33921
1998-02-01,Illinois,9204394,6321417,6028974,292443
1998-02-01,Indiana,4528604,3118417,3023126,95291
1998-02-01,Iowa,2210154,1593924,1549132,44792
1998-02-01,Kansas,1968158,1389273,1339017,50256
1998-02-01,Kentucky,3022879,1918015,1832901,85114
1998-02-01,Louisiana,3256087,2019311,1910303,109008
1998-02-01,Maine,973730,652357,621351,31006
1998-02-01,Maryland,3907818,2767677,2641927,125750
1998-02-01,Massachusetts,4841027,3310222,3193665,116557
1998-02-01,Michigan,7421577,5010213,4813318,196895
1998-02-01,Minnesota,3610136,2708574,2633991,74583
1998-02-01,Mississippi,2059985,1277531,1209490,68041
1998-02-01,Missouri,4152992,2946645,2818328,128317
1998-02-01,Montana,675694,459095,433414,25681
1998-02-01,Nebraska,1262888,922765,901274,21491
1998-02-01,Nevada,1392710,964544,922479,42065
1998-02-01,Ohio,8564079,5721402,5473668,247734
1998-02-01,Oklahoma,2525501,1622364,1560147,62217
1998-02-01,Oregon,2568509,1769554,1674781,94773
1998-02-01,Pennsylvania,9430782,6068764,5779255,289509
1998-02-01,Tennessee,4254317,2788313,2663495,124818
1998-02-01,Texas,14529933,10017045,9527707,489338
1998-02-01,Utah,1512945,1091250,1053748,37502
1998-02-01,Vermont,461388,332016,320018,11998
1998-02-01,Virginia,5150509,3469732,3372649,97083
1998-02-01,Washington,4321834,3007669,2867310,140359
1998-02-01,Wisconsin,4003638,2974202,2880232,93970
1998-02-01,Wyoming,366105,258232,246331,11901
1998-03-01,Alabama,3333406,2142936,2049134,93802
1998-03-01,Alaska,425146,314531,295005,19526
1998-03-01,Arizona,3653595,2354960,2254071,100889
1998-03-01,Arkansas,1975766,1241121,1177712,63409
1998-03-01,California,24137061,16076033,15115208,960825
1998-03-01,Colorado,3089773,2286442,2203449,82993
1998-03-01,Connecticut,2570844,1736765,1674396,62369
1998-03-01,Delaware,579531,393985,379925,14060
1998-03-01,Florida,11987167,7499969,7154711,345258
1998-03-01,Georgia,5816077,4020354,3849489,170865
1998-03-01,Hawaii,893985,600467,566101,34366
1998-03-01,Idaho,912012,645121,611079,34042
1998-03-01,Illinois,9208643,6313773,6029421,284352
1998-03-01,Indiana,4530171,3116233,3024014,92219
1998-03-01,Iowa,2210482,1593416,1548675,44741
1998-03-01,Kansas,1969170,1391279,1340571,50708
1998-03-01,Kentucky,3025928,1918741,1833727,85014
1998-03-01,Louisiana,3257108,2023005,1913082,109923
1998-03-01,Maine,973706,652046,621959,30087
1998-03-01,Maryland,3909643,2766106,2642338,123768
1998-03-01,Massachusetts,4843017,3311154,3196482,114672
1998-03-01,Michigan,7422277,5009273,4816828,192445
1998-03-01,Minnesota,3612821,2711064,2638158,72906
1998-03-01,Mississippi,2062087,1277258,1209641,67617
1998-03-01,Missouri,4154574,2947065,2819017,128048
1998-03-01,Montana,675661,459676,433842,25834
1998-03-01,Nebraska,1264132,923240,901435,21805
1998-03-01,Nevada,1396636,965702,923573,42129
1998-03-01,Ohio,8565008,5713352,5468349,245003
1998-03-01,Oklahoma,2526690,1625433,1561770,63663
1998-03-01,Oregon,2570779,1772036,1675996,96040
1998-03-01,Pennsylvania,9431392,6064558,5777637,286921
1998-03-01,Tennessee,4257912,2791071,2667993,123078
1998-03-01,Texas,14551534,10039917,9549579,490338
1998-03-01,Utah,1515394,1094439,1056111,38328
1998-03-01,Vermont,462413,332402,320448,11954
1998-03-01,Virginia,5153637,3474137,3378505,95632
1998-03-01,Washington,4327077,3012155,2871357,140798
1998-03-01,Wisconsin,4006093,2970936,2877909,93027
1998-03-01,Wyoming,366126,258807,246729,12078
1998-04-01,Alabama,3336208,2142385,2048713,93672
1998-04-01,Alaska,426138,314649,295077,19572
1998-04-01,Arizona,3661379,2363059,2262590,100469
1998-04-01,Arkansas,1977177,1241784,1178613,63171
1998-04-01,California,24175153,16101890,15142786,959104
1998-04-01,Colorado,3095750,2293058,2208651,84407
1998-04-01,Connecticut,2571308,1737357,1677110,60247
1998-04-01,Delaware,579607,394970,380683,14287
1998-04-01,Florida,12007522,7509363,7167971,341392
1998-04-01,Georgia,5826087,4028511,3857869,170642
1998-04-01,Hawaii,894116,601017,566451,34566
1998-04-01,Idaho,913013,647156,613170,33986
1998-04-01,Illinois,9214892,6308268,6031298,276970
1998-04-01,Indiana,4532739,3114296,3024086,90210
1998-04-01,Iowa,2210810,1593101,1548264,44837
1998-04-01,Kansas,1971182,1393435,1342178,51257
1998-04-01,Kentucky,3027978,1919548,1834229,85319
1998-04-01,Louisiana,3258129,2027854,1916063,111791
1998-04-01,Maine,974683,652019,622728,29291
1998-04-01,Maryland,3911467,2764293,2642141,122152
1998-04-01,Massachusetts,4846007,3313710,3200673,113037
1998-04-01,Michigan,7424976,5007596,4818433,189163
1998-04-01,Minnesota,3616506,2713223,2641816,71407
1998-04-01,Mississippi,2063189,1276679,1209345,67334
1998-04-01,Missouri,4157155,2947282,2820120,127162
1998-04-01,Montana,675627,460187,434324,25863
1998-04-01,Nebraska,1264376,923832,901691,22141
1998-04-01,Nevada,1402561,968803,926834,41969
1998-04-01,Ohio,8567938,5706691,5462809,243882
1998-04-01,Oklahoma,2529879,1628557,1563091,65466
1998-04-01,Oregon,2574050,1774188,1676689,97499
1998-04-01,Pennsylvania,9433002,6060516,5776248,284268
1998-04-01,Tennessee,4261508,2794942,2673222,121720
1998-04-01,Texas,14576135,10064726,9570244,494482
1998-04-01,Utah,1517842,1097519,1058480,39039
1998-04-01,Vermont,462437,332966,321059,11907
1998-04-01,Virginia,5157765,3480180,3385486,94694
1998-04-01,Washington,4333320,3017192,2875859,141333
1998-04-01,Wisconsin,4007549,2968396,2875367,93029
1998-04-01,Wyoming,366148,259339,247102,12237
1998-05-01,Alabama,3339010,2141884,2047919,93965
1998-05-01,Alaska,426129,314745,295036,19709
1998-05-01,Arizona,3669163,2372072,2271841,100231
1998-05-01,Arkansas,1978589,1242776,1179908,62868
1998-05-01,California,24211244,16129830,15170968,958862
1998-05-01,Colorado,3100728,2299483,2213985,85498
1998-05-01,Connecticut,2571771,1738261,1679988,58273
1998-05-01,Delaware,580683,395885,381487,14398
1998-05-01,Florida,12026877,7519936,7182224,337712
1998-05-01,Georgia,5836098,4036397,3866185,170212
1998-05-01,Hawaii,895247,601843,566948,34895
1998-05-01,Idaho,914013,649061,615193,33868
1998-05-01,Illinois,9220141,6309017,6036283,272734
1998-05-01,Indiana,4534306,3113346,3023721,89625
1998-05-01,Iowa,2212138,1593131,1548111,45020
1998-05-01,Kansas,1972193,1395909,1344113,51796
1998-05-01,Kentucky,3031028,1920728,1834861,85867
1998-05-01,Louisiana,3260151,2033150,1919030,114120
1998-05-01,Maine,974660,652405,623573,28832
1998-05-01,Maryland,3914292,2762667,2641936,120731
1998-05-01,Massachusetts,4848997,3318187,3206369,111818
1998-05-01,Michigan,7427676,5007138,4819210,187928
1998-05-01,Minnesota,3619191,2714847,2644318,70529
1998-05-01,Mississippi,2065291,1276162,1209030,67132
1998-05-01,Missouri,4159737,2947537,2822199,125338
1998-05-01,Montana,675593,460797,434964,25833
1998-05-01,Nebraska,1264619,924666,902220,22446
1998-05-01,Nevada,1406487,967598,925982,41616
1998-05-01,Ohio,8569867,5702787,5458356,244431
1998-05-01,Oklahoma,2531068,1631779,1564462,67317
1998-05-01,Oregon,2577320,1776171,1677113,99058
1998-05-01,Pennsylvania,9434612,6058186,5775968,282218
1998-05-01,Tennessee,4266103,2800115,2679306,120809
1998-05-01,Texas,14599737,10091522,9590282,501240
1998-05-01,Utah,1521290,1100531,1060904,39627
1998-05-01,Vermont,462461,333653,321795,11858
1998-05-01,Virginia,5161892,3488292,3393675,94617
1998-05-01,Washington,4339563,3023126,2880723,142403
1998-05-01,Wisconsin,4010004,2967088,2872940,94148
1998-05-01,Wyoming,366169,259827,247451,12376
1998-06-01,Alabama,3341813,2141637,2046918,94719
1998-06-01,Alaska,426121,314947,295026,19921
1998-06-01,Arizona,3676947,2381871,2281558,100313
1998-06-01,Arkansas,1980001,1244120,1181368,62752
1998-06-01,California,24249336,16161125,15199560,961565
1998-06-01,Colorado,3106705,2305772,2219338,86434
1998-06-01,Connecticut,2572234,1739265,1682740,56525
1998-06-01,Delaware,580759,396726,382277,14449
1998-06-01,Florida,12046232,7533239,7197974,335265
1998-06-01,Georgia,5847109,4044437,3874235,170202
1998-06-01,Hawaii,895378,602796,567446,35350
1998-06-01,Idaho,916013,650977,617144,33833
1998-06-01,Illinois,9226389,6316947,6043702,273245
1998-06-01,Indiana,4536873,3113932,3023396,90536
1998-06-01,Iowa,2212466,1593434,1548176,45258
1998-06-01,Kansas,1974205,1398677,1346340,52337
1998-06-01,Kentucky,3033078,1922136,1835563,86573
1998-06-01,Louisiana,3261172,2037278,1921216,116062
1998-06-01,Maine,974637,653322,624491,28831
1998-06-01,Maryland,3917117,2761513,2641992,119521
1998-06-01,Massachusetts,4851987,3324392,3213227,111165
1998-06-01,Michigan,7429376,5009284,4820253,189031
1998-06-01,Minnesota,3622876,2715894,2645378,70516
1998-06-01,Mississippi,2067393,1275846,1208831,67015
1998-06-01,Missouri,4162319,2947890,2824966,122924
1998-06-01,Montana,675559,461631,435769,25862
1998-06-01,Nebraska,1265863,925725,902928,22797
1998-06-01,Nevada,1411413,972729,931512,41217
1998-06-01,Ohio,8571797,5702210,5455660,246550
1998-06-01,Oklahoma,2533257,1634873,1565963,68910
1998-06-01,Oregon,2579591,1777991,1677324,100667
1998-06-01,Pennsylvania,9436222,6058038,5776457,281581
1998-06-01,Tennessee,4270698,2806184,2685713,120471
1998-06-01,Texas,14623338,10118364,9609464,508900
1998-06-01,Utah,1523739,1103385,1063320,40065
1998-06-01,Vermont,463486,334319,322519,11800
1998-06-01,Virginia,5166020,3497375,3401813,95562
1998-06-01,Washington,4345807,3029648,2885227,144421
1998-06-01,Wisconsin,4012460,2966613,2870282,96331
1998-06-01,Wyoming,367191,260287,247766,12521
1998-07-01,Alabama,3344615,2141431,2045672,95759
1998-07-01,Alaska,426112,315238,295090,20148
1998-07-01,Arizona,3684730,2392194,2291444,100750
1998-07-01,Arkansas,1981413,1245540,1182653,62887
1998-07-01,California,24286428,16193744,15227742,966002
1998-07-01,Colorado,3111683,2311565,2224574,86991
1998-07-01,Connecticut,2572697,1740286,1685295,54991
1998-07-01,Delaware,581835,397381,382939,14442
1998-07-01,Florida,12065588,7549448,7215568,333880
1998-07-01,Georgia,5857120,4052507,3882007,170500
1998-07-01,Hawaii,896509,603659,567868,35791
1998-07-01,Idaho,917013,652996,619014,33982
1998-07-01,Illinois,9232638,6329871,6052083,277788
1998-07-01,Indiana,4539441,3116461,3023836,92625
1998-07-01,Iowa,2213794,1593919,1548456,45463
1998-07-01,Kansas,1975217,1401480,1348633,52847
1998-07-01,Kentucky,3036127,1923442,1836210,87232
1998-07-01,Louisiana,3263193,2038860,1921925,116935
1998-07-01,Maine,975614,654711,625579,29132
1998-07-01,Maryland,3918941,2760794,2642589,118205
1998-07-01,Massachusetts,4854977,3332005,3220989,111016
1998-07-01,Michigan,7432076,4979160,4745637,233523
1998-07-01,Minnesota,3625561,2716661,2645299,71362
1998-07-01,Mississippi,2068495,1275623,1208629,66994
1998-07-01,Missouri,4164900,2948122,2827848,120274
1998-07-01,Montana,676526,462725,436714,26011
1998-07-01,Nebraska,1266107,926918,903630,23288
1998-07-01,Nevada,1416338,977761,936882,40879
1998-07-01,Ohio,8573726,5704868,5455407,249461
1998-07-01,Oklahoma,2535445,1637493,1567582,69911
1998-07-01,Oregon,2582861,1779566,1677361,102205
1998-07-01,Pennsylvania,9437832,6059297,5777102,282195
1998-07-01,Tennessee,4274293,2812514,2692034,120480
1998-07-01,Texas,14647939,10142571,9627400,515171
1998-07-01,Utah,1526187,1105990,1065655,40335
1998-07-01,Vermont,463510,334864,323164,11700
1998-07-01,Virginia,5170148,3506102,3408878,97224
1998-07-01,Washington,4353050,3036139,2888825,147314
1998-07-01,Wisconsin,4013915,2965905,2866954,98951
1998-07-01,Wyoming,367212,260703,248052,12651
1998-08-01,Alabama,3346417,2141496,2044872,96624
1998-08-01,Alaska,427103,315551,295260,20291
1998-08-01,Arizona,3691514,2403044,2301473,101571
1998-08-01,Arkansas,1983824,1246904,1183779,63125
1998-08-01,California,24326519,16225922,15257102,968820
1998-08-01,Colorado,3119660,2316791,2229897,86894
1998-08-01,Connecticut,2573160,1741524,1687975,53549
1998-08-01,Delaware,582911,397826,383510,14316
1998-08-01,Florida,12085943,7568241,7235880,332361
1998-08-01,Georgia,5868131,4060920,3890472,170448
1998-08-01,Hawaii,896641,604333,568279,36054
1998-08-01,Idaho,919013,654956,620769,34187
1998-08-01,Illinois,9238887,6345473,6062120,283353
1998-08-01,Indiana,4542008,3120931,3026004,94927
1998-08-01,Iowa,2214122,1594464,1548812,45652
1998-08-01,Kansas,1977229,1404032,1350963,53069
1998-08-01,Kentucky,3038177,1924829,1837170,87659
1998-08-01,Louisiana,3265215,2037809,1921421,116388
1998-08-01,Maine,976591,656352,627023,29329
1998-08-01,Maryland,3922766,2760627,2644420,116207
1998-08-01,Massachusetts,4857967,3340295,3229203,111092
1998-08-01,Michigan,7435776,5022617,4826928,195689
1998-08-01,Minnesota,3631246,2717879,2645321,72558
1998-08-01,Mississippi,2070597,1275662,1208693,66969
1998-08-01,Missouri,4168482,2947973,2830846,117127
1998-08-01,Montana,676492,463926,437734,26192
1998-08-01,Nebraska,1267351,928200,904319,23881
1998-08-01,Nevada,1421264,982659,942138,40521
1998-08-01,Ohio,8576655,5709791,5457965,251826
1998-08-01,Oklahoma,2538634,1639860,1569705,70155
1998-08-01,Oregon,2586132,1780897,1677482,103415
1998-08-01,Pennsylvania,9441442,6061663,5778427,283236
1998-08-01,Tennessee,4278888,2818788,2698245,120543
1998-08-01,Texas,14673541,10162921,9645403,517518
1998-08-01,Utah,1528636,1108415,1067983,40432
1998-08-01,Vermont,464534,335332,323800,11532
1998-08-01,Virginia,5177275,3513986,3415142,98844
1998-08-01,Washington,4358293,3042244,2892135,150109
1998-08-01,Wisconsin,4017371,2965044,2863841,101203
1998-08-01,Wyoming,367234,261075,248354,12721
1998-09-01,Alabama,3348219,2142100,2044910,97190
1998-09-01,Alaska,427095,315921,295561,20360
1998-09-01,Arizona,3699298,2414525,2311749,102776
1998-09-01,Arkansas,1986236,1248337,1185046,63291
1998-09-01,California,24366611,16256955,15288403,968552
1998-09-01,Colorado,3126638,2321189,2235298,85891
1998-09-01,Connecticut,2574623,1743017,1690862,52155
1998-09-01,Delaware,582987,398078,384022,14056
1998-09-01,Florida,12105298,7588751,7258379,330372
1998-09-01,Georgia,5879142,4069995,3900046,169949
1998-09-01,Hawaii,896772,604728,568655,36073
1998-09-01,Idaho,920013,656607,622278,34329
1998-09-01,Illinois,9246136,6361241,6073939,287302
1998-09-01,Indiana,4545576,3126488,3029840,96648
1998-09-01,Iowa,2215451,1594932,1549048,45884
1998-09-01,Kansas,1978241,1406182,1353296,52886
1998-09-01,Kentucky,3041227,1926663,1838697,87966
1998-09-01,Louisiana,3267236,2035414,1920619,114795
1998-09-01,Maine,977567,658050,628870,29180
1998-09-01,Maryland,3926591,2761136,2647697,113439
1998-09-01,Massachusetts,4862957,3348186,3236949,111237
1998-09-01,Michigan,7440475,5032502,4833601,198901
1998-09-01,Minnesota,3635931,2720080,2646511,73569
1998-09-01,Mississippi,2071699,1275832,1209124,66708
1998-09-01,Missouri,4172063,2947318,2833971,113347
1998-09-01,Montana,677458,465058,438721,26337
1998-09-01,Nebraska,1268594,929417,904967,24450
1998-09-01,Nevada,1426189,987398,947296,40102
1998-09-01,Ohio,8579585,5715893,5462883,253010
1998-09-01,Oklahoma,2540823,1642299,1572521,69778
1998-09-01,Oregon,2589402,1782215,1677993,104222
1998-09-01,Pennsylvania,9445052,6065569,5781637,283932
1998-09-01,Tennessee,4283483,2825037,2704261,120776
1998-09-01,Texas,14699142,10179313,9663832,515481
1998-09-01,Utah,1531084,1110756,1070328,40428
1998-09-01,Vermont,464559,335827,324496,11331
1998-09-01,Virginia,5183403,3521024,3421380,99644
1998-09-01,Washington,4363536,3047995,2895899,152096
1998-09-01,Wisconsin,4020826,2964536,2861874,102662
1998-09-01,Wyoming,367255,261444,248688,12756
1998-10-01,Alabama,3350021,2143068,2045738,97330
1998-10-01,Alaska,428086,316366,295990,20376
1998-10-01,Arizona,3707082,2425980,2322033,103947
1998-10-01,Arkansas,1987648,1249624,1186622,63002
1998-10-01,California,24405702,16283158,15320806,962352
1998-10-01,Colorado,3133615,2324291,2240675,83616
1998-10-01,Connecticut,2576086,1744301,1693662,50639
1998-10-01,Delaware,584063,398144,384474,13670
1998-10-01,Florida,12125653,7608367,7281208,327159
1998-10-01,Georgia,5890153,4078974,3910174,168800
1998-10-01,Hawaii,896903,604686,568931,35755
1998-10-01,Idaho,922013,657706,623392,34314
1998-10-01,Illinois,9252385,6374446,6087261,287185
1998-10-01,Indiana,4548143,3131295,3034564,96731
1998-10-01,Iowa,2216779,1595085,1549161,45924
1998-10-01,Kansas,1980252,1407777,1355597,52180
1998-10-01,Kentucky,3044277,1928764,1840731,88033
1998-10-01,Louisiana,3269257,2032895,1920402,112493
1998-10-01,Maine,977544,659607,630966,28641
1998-10-01,Maryland,3929415,2761955,2651941,110014
1998-10-01,Massachusetts,4866947,3354428,3243374,111054
1998-10-01,Michigan,7444175,5042713,4841840,200873
1998-10-01,Minnesota,3640616,2722955,2649177,73778
1998-10-01,Mississippi,2073800,1275934,1209896,66038
1998-10-01,Missouri,4175645,2946015,2837202,108813
1998-10-01,Montana,677425,465927,439559,26368
1998-10-01,Nebraska,1268838,930311,905516,24795
1998-10-01,Nevada,1431115,991864,952300,39564
1998-10-01,Ohio,8582514,5721347,5469359,251988
1998-10-01,Oklahoma,2544012,1644758,1575962,68796
1998-10-01,Oregon,2591673,1783725,1679159,104566
1998-10-01,Pennsylvania,9448662,6070281,5787362,282919
1998-10-01,Tennessee,4287078,2830903,2710037,120866
1998-10-01,Texas,14724743,10190794,9682154,508640
1998-10-01,Utah,1534533,1112980,1072635,40345
1998-10-01,Vermont,464583,336387,325252,11135
1998-10-01,Virginia,5190531,3526668,3427634,99034
1998-10-01,Washington,4368779,3053126,2900395,152731
1998-10-01,Wisconsin,4024282,2963996,2861309,102687
1998-10-01,Wyoming,367277,261807,249052,12755
1998-11-01,Alabama,3351823,2144105,2046835,97270
1998-11-01,Alaska,429077,316821,296444,20377
1998-11-01,Arizona,3714866,2436877,2331824,105053
1998-11-01,Arkansas,1990060,1250504,1188432,62072
1998-11-01,California,24445794,16302073,15351428,950645
1998-11-01,Colorado,3141593,2326015,2245785,80230
1998-11-01,Connecticut,2576549,1744995,1695937,49058
1998-11-01,Delaware,584139,398061,384819,13242
1998-11-01,Florida,12145008,7624544,7301630,322914
1998-11-01,Georgia,5900164,4086788,3919545,167243
1998-11-01,Hawaii,898034,604214,569017,35197
1998-11-01,Idaho,923013,658077,623923,34154
1998-11-01,Illinois,9259634,6383802,6101211,282591
1998-11-01,Indiana,4551710,3133576,3038601,94975
1998-11-01,Iowa,2218107,1594968,1549349,45619
1998-11-01,Kansas,1981264,1408581,1357494,51087
1998-11-01,Kentucky,3046327,1930837,1842915,87922
1998-11-01,Louisiana,3270278,2030873,1920977,109896
1998-11-01,Maine,978521,660806,633006,27800
1998-11-01,Maryland,3933240,2762615,2656142,106473
1998-11-01,Massachusetts,4870937,3358407,3247800,110607
1998-11-01,Michigan,7448875,5051752,4849893,201859
1998-11-01,Minnesota,3645301,2725732,2652803,72929
1998-11-01,Mississippi,2074902,1275768,1210737,65031
1998-11-01,Missouri,4179226,2943923,2839967,103956
1998-11-01,Montana,678391,466456,440209,26247
1998-11-01,Nebraska,1270082,930599,905743,24856
1998-11-01,Nevada,1435041,995975,956983,38992
1998-11-01,Ohio,8585443,5725153,5475697,249456
1998-11-01,Oklahoma,2546201,1646896,1579474,67422
1998-11-01,Oregon,2594943,1785330,1681001,104329
1998-11-01,Pennsylvania,9451272,6074761,5794514,280247
1998-11-01,Tennessee,4291673,2835742,2715218,120524
1998-11-01,Texas,14750345,10197118,9698755,498363
1998-11-01,Utah,1536981,1114958,1074724,40234
1998-11-01,Vermont,465608,336971,325989,10982
1998-11-01,Virginia,5196658,3530602,3433272,97330
1998-11-01,Washington,4374023,3057025,2905240,151785
1998-11-01,Wisconsin,4026737,2962609,2861529,101080
1998-11-01,Wyoming,368298,262157,249427,12730
1998-12-01,Alabama,3353625,2145047,2047579,97468
1998-12-01,Alaska,429069,317241,296793,20448
1998-12-01,Arizona,3721649,2447015,2340441,106574
1998-12-01,Arkansas,1991471,1250945,1190253,60692
1998-12-01,California,24481885,16314638,15378088,936550
1998-12-01,Colorado,3148570,2326640,2250216,76424
1998-12-01,Connecticut,2578012,1745040,1697404,47636
1998-12-01,Delaware,585215,397927,385026,12901
1998-12-01,Florida,12163364,7636382,7317505,318877
1998-12-01,Georgia,5910174,4092818,3927083,165735
1998-12-01,Hawaii,898165,603509,568931,34578
1998-12-01,Idaho,925014,657684,623701,33983
1998-12-01,Illinois,9264883,6390685,6114453,276232
1998-12-01,Indiana,4554278,3132859,3040477,92382
1998-12-01,Iowa,2219435,1594581,1549553,45028
1998-12-01,Kansas,1982276,1408446,1358526,49920
1998-12-01,Kentucky,3048376,1932908,1844969,87939
1998-12-01,Louisiana,3272300,2029105,1921640,107465
1998-12-01,Maine,979498,661538,634572,26966
1998-12-01,Maryland,3936065,2763048,2659495,103553
1998-12-01,Massachusetts,4873927,3360348,3250033,110315
1998-12-01,Michigan,7451575,5059051,4856451,202600
1998-12-01,Minnesota,3649986,2727728,2656349,71379
1998-12-01,Mississippi,2076004,1275206,1211176,64030
1998-12-01,Missouri,4181808,2941316,2841687,99629
1998-12-01,Montana,678357,466647,440614,26033
1998-12-01,Nebraska,1270326,930164,905414,24750
1998-12-01,Nevada,1439966,999743,961152,38591
1998-12-01,Ohio,8587373,5727531,5480409,247122
1998-12-01,Oklahoma,2548389,1648520,1582502,66018
1998-12-01,Oregon,2597214,1786482,1682949,103533
1998-12-01,Pennsylvania,9453882,6078670,5801518,277152
1998-12-01,Tennessee,4295268,2838879,2719000,119879
1998-12-01,Texas,14773946,10200471,9711967,488504
1998-12-01,Utah,1539429,1116584,1076388,40196
1998-12-01,Vermont,465632,337529,326638,10891
1998-12-01,Virginia,5202786,3532765,3437251,95514
1998-12-01,Washington,4379266,3059091,2909204,149887
1998-12-01,Wisconsin,4030193,2960141,2861555,98586
1998-12-01,Wyoming,368320,262468,249742,12726
1999-01-01,Alabama,3354427,2145883,2047925,97958
1999-01-01,Alaska,430060,317506,296955,20551
1999-01-01,Arizona,3729433,2456251,2347725,108526
1999-01-01,Arkansas,1993883,1251062,1191937,59125
1999-01-01,California,24517977,16323209,15402202,921007
1999-01-01,Colorado,3155548,2326817,2253833,72984
1999-01-01,Connecticut,2578475,1744288,1697878,46410
1999-01-01,Delaware,586291,397786,385087,12699
1999-01-01,Florida,12181719,7645106,7330040,315066
1999-01-01,Georgia,5920185,4097159,3933171,163988
1999-01-01,Hawaii,898296,602787,568864,33923
1999-01-01,Idaho,926014,656653,622828,33825
1999-01-01,Illinois,9270132,6396961,6126346,270615
1999-01-01,Indiana,4555845,3129901,3039983,89918
1999-01-01,Iowa,2219763,1594190,1549965,44225
1999-01-01,Kansas,1983288,1407550,1358695,48855
1999-01-01,Kentucky,3050426,1935358,1847211,88147
1999-01-01,Louisiana,3273321,2027133,1921887,105246
1999-01-01,Maine,980475,661916,635521,26395
1999-01-01,Maryland,3938889,2763253,2661901,101352
1999-01-01,Massachusetts,4876917,3360938,3250723,110215
1999-01-01,Michigan,7455274,5064723,4861891,202832
1999-01-01,Minnesota,3654671,2728597,2658938,69659
1999-01-01,Mississippi,2078106,1274385,1211180,63205
1999-01-01,Missouri,4185389,2939130,2842540,96590
1999-01-01,Montana,678323,466542,440805,25737
1999-01-01,Nebraska,1271569,929210,904604,24606
1999-01-01,Nevada,1444892,1003285,964841,38444
1999-01-01,Ohio,8589302,5728281,5482706,245575
1999-01-01,Oklahoma,2550578,1649706,1585001,64705
1999-01-01,Oregon,2600484,1786516,1684299,102217
1999-01-01,Pennsylvania,9455492,6082056,5808045,274011
1999-01-01,Tennessee,4298863,2839899,2721154,118745
1999-01-01,Texas,14797547,10203530,9722444,481086
1999-01-01,Utah,1540878,1117910,1077674,40236
1999-01-01,Vermont,466656,337996,327174,10822
1999-01-01,Virginia,5208914,3533720,3439676,94044
1999-01-01,Washington,4383509,3059237,2911412,147825
1999-01-01,Wisconsin,4032648,2956895,2861202,95693
1999-01-01,Wyoming,368341,262720,249972,12748
1999-02-01,Alabama,3355229,2146853,2048086,98767
1999-02-01,Alaska,430052,317628,296974,20654
1999-02-01,Arizona,3735217,2464632,2353853,110779
1999-02-01,Arkansas,1995295,1251256,1193443,57813
1999-02-01,California,24549068,16333134,15426805,906329
1999-02-01,Colorado,3161525,2327515,2256884,70631
1999-02-01,Connecticut,2578938,1742869,1697421,45448
1999-02-01,Delaware,586367,397686,385038,12648
1999-02-01,Florida,12197074,7653316,7341549,311767
1999-02-01,Georgia,5929196,4100694,3938692,162002
1999-02-01,Hawaii,898428,602286,568957,33329
1999-02-01,Idaho,927014,655382,621686,33696
1999-02-01,Illinois,9273381,6405177,6136810,268367
1999-02-01,Indiana,4557413,3125995,3037775,88220
1999-02-01,Iowa,2220091,1594329,1550861,43468
1999-02-01,Kansas,1984300,1406407,1358254,48153
1999-02-01,Kentucky,3052476,1938495,1849929,88566
1999-02-01,Louisiana,3274342,2024930,1921718,103212
1999-02-01,Maine,980452,662245,636044,26201
1999-02-01,Maryland,3940714,2763463,2663667,99796
1999-02-01,Massachusetts,4879907,3361175,3250730,110445
1999-02-01,Michigan,7455974,5069566,4867018,202548
1999-02-01,Minnesota,3658356,2729460,2660671,68789
1999-02-01,Mississippi,2078208,1273838,1211104,62734
1999-02-01,Missouri,4186971,2938186,2842884,95302
1999-02-01,Montana,679290,466319,440891,25428
1999-02-01,Nebraska,1271813,928127,903570,24557
1999-02-01,Nevada,1448817,1006835,968187,38648
1999-02-01,Ohio,8588232,5729075,5483653,245422
1999-02-01,Oklahoma,2551767,1650714,1587351,63363
1999-02-01,Oregon,2601755,1785533,1684773,100760
1999-02-01,Pennsylvania,9456102,6085549,5813808,271741
1999-02-01,Tennessee,4301458,2839759,2722599,117160
1999-02-01,Texas,14818149,10209003,9731758,477245
1999-02-01,Utah,1543326,1119080,1078735,40345
1999-02-01,Vermont,466681,338352,327579,10773
1999-02-01,Virginia,5213041,3534749,3441525,93224
1999-02-01,Washington,4387752,3058412,2911961,146451
1999-02-01,Wisconsin,4034104,2953342,2860504,92838
1999-02-01,Wyoming,368363,262937,250151,12786
1999-03-01,Alabama,3356031,2148065,2048175,99890
1999-03-01,Alaska,431043,317707,296946,20761
1999-03-01,Arizona,3742001,2472128,2359117,113011
1999-03-01,Arkansas,1996707,1251918,1194867,57051
1999-03-01,California,24580160,16348582,15454688,893894
1999-03-01,Colorado,3167503,2329367,2259711,69656
1999-03-01,Connecticut,2579401,1741264,1696520,44744
1999-03-01,Delaware,587443,397717,384999,12718
1999-03-01,Florida,12213429,7662750,7353397,309353
1999-03-01,Georgia,5938207,4104732,3944593,160139
1999-03-01,Hawaii,898559,602170,569291,32879
1999-03-01,Idaho,929014,654277,620644,33633
1999-03-01,Illinois,9277630,6417500,6146025,271475
1999-03-01,Indiana,4558980,3122345,3034932,87413
1999-03-01,Iowa,2220419,1595270,1552207,43063
1999-03-01,Kansas,1985311,1405451,1357519,47932
1999-03-01,Kentucky,3053526,1941999,1852879,89120
1999-03-01,Louisiana,3275364,2022821,1921446,101375
1999-03-01,Maine,981428,662807,636486,26321
1999-03-01,Maryland,3942539,2763965,2665320,98645
1999-03-01,Massachusetts,4881897,3361595,3250598,110997
1999-03-01,Michigan,7457674,5074625,4873380,201245
1999-03-01,Minnesota,3662042,2731786,2662312,69474
1999-03-01,Mississippi,2079310,1273926,1211276,62650
1999-03-01,Missouri,4189553,2938792,2843138,95654
1999-03-01,Montana,679256,466179,440991,25188
1999-03-01,Nebraska,1272057,927273,902640,24633
1999-03-01,Nevada,1452743,1010585,971380,39205
1999-03-01,Ohio,8589161,5732170,5485492,246678
1999-03-01,Oklahoma,2553956,1651770,1589924,61846
1999-03-01,Oregon,2604025,1784155,1684579,99576
1999-03-01,Pennsylvania,9456712,6089976,5818845,271131
1999-03-01,Tennessee,4304053,2839943,2724561,115382
1999-03-01,Texas,14838750,10218114,9741519,476595
1999-03-01,Utah,1545775,1120226,1079771,40455
1999-03-01,Vermont,466705,338602,327866,10736
1999-03-01,Virginia,5218169,3536891,3443641,93250
1999-03-01,Washington,4390995,3057849,2911706,146143
1999-03-01,Wisconsin,4036559,2950389,2859948,90441
1999-03-01,Wyoming,369384,263150,250321,12829
1999-04-01,Alabama,3357833,2149267,2048045,101222
1999-04-01,Alaska,431034,317788,296968,20820
1999-04-01,Arizona,3748784,2478412,2363724,114688
1999-04-01,Arkansas,1999119,1253075,1196248,56827
1999-04-01,California,24617251,16370149,15486567,883582
1999-04-01,Colorado,3174480,2332261,2262405,69856
1999-04-01,Connecticut,2579864,1740067,1695908,44159
1999-04-01,Delaware,587520,397939,385080,12859
1999-04-01,Florida,12231784,7673412,7365693,307719
1999-04-01,Georgia,5948218,4110383,3951562,158821
1999-04-01,Hawaii,898690,602415,569885,32530
1999-04-01,Idaho,930014,653510,619903,33607
1999-04-01,Illinois,9283879,6433561,6154607,278954
1999-04-01,Indiana,4561547,3119332,3031771,87561
1999-04-01,Iowa,2221747,1596517,1553407,43110
1999-04-01,Kansas,1986323,1405022,1356786,48236
1999-04-01,Kentucky,3055576,1945190,1855549,89641
1999-04-01,Louisiana,3277385,2021184,1921299,99885
1999-04-01,Maine,982405,663831,637186,26645
1999-04-01,Maryland,3946363,2765009,2667289,97720
1999-04-01,Massachusetts,4885888,3362195,3250546,111649
1999-04-01,Michigan,7461374,5080471,4882253,198218
1999-04-01,Minnesota,3666727,2735663,2664230,71433
1999-04-01,Mississippi,2081412,1274852,1211877,62975
1999-04-01,Missouri,4192134,2941037,2843748,97289
1999-04-01,Montana,679222,466222,441167,25055
1999-04-01,Nebraska,1273301,927011,902128,24883
1999-04-01,Nevada,1457669,1014556,974531,40025
1999-04-01,Ohio,8591090,5738243,5489153,249090
1999-04-01,Oklahoma,2556144,1653029,1592811,60218
1999-04-01,Oregon,2607296,1782669,1683753,98916
1999-04-01,Pennsylvania,9458322,6094932,5822647,272285
1999-04-01,Tennessee,4307648,2841150,2727502,113648
1999-04-01,Texas,14863352,10229711,9752200,477511
1999-04-01,Utah,1548223,1121410,1080886,40524
1999-04-01,Vermont,466729,338731,328054,10677
1999-04-01,Virginia,5224296,3540243,3446170,94073
1999-04-01,Washington,4396239,3058180,2911381,146799
1999-04-01,Wisconsin,4039015,2949008,2860114,88894
1999-04-01,Wyoming,369406,263365,250516,12849
1999-05-01,Alabama,3359635,2150068,2047678,102390
1999-05-01,Alaska,432026,317871,297095,20776
1999-05-01,Arizona,3756568,2483008,2367577,115431
1999-05-01,Arkansas,2000530,1254437,1197474,56963
1999-05-01,California,24653343,16395775,15521145,874630
1999-05-01,Colorado,3181458,2335349,2264653,70696
1999-05-01,Connecticut,2580328,1739678,1696098,43580
1999-05-01,Delaware,588596,398332,385340,12992
1999-05-01,Florida,12250140,7683876,7377601,306275
1999-05-01,Georgia,5958229,4117680,3959716,157964
1999-05-01,Hawaii,898821,602896,570704,32192
1999-05-01,Idaho,931014,653066,619504,33562
1999-05-01,Illinois,9289128,6450641,6162657,287984
1999-05-01,Indiana,4564115,3117246,3028696,88550
1999-05-01,Iowa,2223075,1597224,1553772,43452
1999-05-01,Kansas,1987335,1405102,1356296,48806
1999-05-01,Kentucky,3058625,1947810,1857833,89977
1999-05-01,Louisiana,3278406,2020679,1921495,99184
1999-05-01,Maine,982382,665353,638343,27010
1999-05-01,Maryland,3949188,2766674,2669794,96880
1999-05-01,Massachusetts,4888878,3362702,3250534,112168
1999-05-01,Michigan,7464073,5087246,4893218,194028
1999-05-01,Minnesota,3670412,2740602,2666778,73824
1999-05-01,Mississippi,2082514,1276644,1212929,63715
1999-05-01,Missouri,4195716,2944121,2845079,99042
1999-05-01,Montana,680188,466387,441383,25004
1999-05-01,Nebraska,1273544,927430,902189,25241
1999-05-01,Nevada,1461594,1018568,977626,40942
1999-05-01,Ohio,8592020,5746303,5494585,251718
1999-05-01,Oklahoma,2558333,1654310,1595759,58551
1999-05-01,Oregon,2609566,1781289,1682493,98796
1999-05-01,Pennsylvania,9460932,6099229,5824692,274537
1999-05-01,Tennessee,4311244,2843291,2731099,112192
1999-05-01,Texas,14886953,10242502,9763252,479250
1999-05-01,Utah,1549671,1122560,1082031,40529
1999-05-01,Vermont,467754,338784,328191,10593
1999-05-01,Virginia,5230424,3544632,3449315,95317
1999-05-01,Washington,4401482,3059358,2911396,147962
1999-05-01,Wisconsin,4041470,2949497,2861261,88236
1999-05-01,Wyoming,369427,263572,250743,12829
1999-06-01,Alabama,3360438,2150499,2047450,103049
1999-06-01,Alaska,433017,317958,297314,20644
1999-06-01,Arizona,3763352,2486175,2371025,115150
1999-06-01,Arkansas,2002942,1255837,1198611,57226
1999-06-01,California,24691434,16423832,15557372,866460
1999-06-01,Colorado,3188435,2338146,2266537,71609
1999-06-01,Connecticut,2581791,1740207,1697201,43006
1999-06-01,Delaware,588672,398952,385868,13084
1999-06-01,Florida,12269495,7693780,7389066,304714
1999-06-01,Georgia,5969240,4126138,3968809,157329
1999-06-01,Hawaii,898952,603524,571680,31844
1999-06-01,Idaho,933014,652947,619482,33465
1999-06-01,Illinois,9295376,6466707,6171178,295529
1999-06-01,Indiana,4566682,3116455,3026200,90255
1999-06-01,Iowa,2223403,1596850,1553110,43740
1999-06-01,Kansas,1989347,1405585,1356314,49271
1999-06-01,Kentucky,3060675,1949843,1859917,89926
1999-06-01,Louisiana,3280428,2022019,1922532,99487
1999-06-01,Maine,983359,667214,639973,27241
1999-06-01,Maryland,3952013,2768889,2672943,95946
1999-06-01,Massachusetts,4892868,3362703,3250245,112458
1999-06-01,Michigan,7467773,5095342,4905256,190086
1999-06-01,Minnesota,3675097,2746084,2670074,76010
1999-06-01,Mississippi,2083616,1279277,1214587,64690
1999-06-01,Missouri,4199297,2947220,2847628,99592
1999-06-01,Montana,680155,466581,441612,24969
1999-06-01,Nebraska,1274788,928428,902880,25548
1999-06-01,Nevada,1466520,1022457,980739,41718
1999-06-01,Ohio,8594949,5754854,5501339,253515
1999-06-01,Oklahoma,2560522,1655612,1598610,57002
1999-06-01,Oregon,2612837,1780774,1681820,98954
1999-06-01,Pennsylvania,9463542,6101749,5824846,276903
1999-06-01,Tennessee,4314839,2846014,2734705,111309
1999-06-01,Texas,14910554,10256398,9774929,481469
1999-06-01,Utah,1552120,1123698,1083244,40454
1999-06-01,Vermont,467778,338858,328373,10485
1999-06-01,Virginia,5236552,3550388,3453816,96572
1999-06-01,Washington,4405725,3061314,2912278,149036
1999-06-01,Wisconsin,4043926,2952013,2863548,88465
1999-06-01,Wyoming,369449,263765,251005,12760
1999-07-01,Alabama,3362240,2150635,2047462,103173
1999-07-01,Alaska,433008,318123,297644,20479
1999-07-01,Arizona,3771136,2488302,2374361,113941
1999-07-01,Arkansas,2004354,1257269,1199867,57402
1999-07-01,California,24728526,16452009,15592715,859294
1999-07-01,Colorado,3195413,2340426,2268208,72218
1999-07-01,Connecticut,2582254,1741333,1698865,42468
1999-07-01,Delaware,589748,399788,386623,13165
1999-07-01,Florida,12287850,7703110,7400015,303095
1999-07-01,Georgia,5979251,4134702,3977754,156948
1999-07-01,Hawaii,899083,604114,572659,31455
1999-07-01,Idaho,934014,653033,619780,33253
1999-07-01,Illinois,9300625,6479976,6180454,299522
1999-07-01,Indiana,4569249,3116764,3024386,92378
1999-07-01,Iowa,2224732,1595320,1551668,43652
1999-07-01,Kansas,1990359,1406323,1356755,49568
1999-07-01,Kentucky,3062725,1951098,1861696,89402
1999-07-01,Louisiana,3281449,2024641,1924376,100265
1999-07-01,Maine,984336,669229,641889,27340
1999-07-01,Maryland,3954837,2771230,2676266,94964
1999-07-01,Massachusetts,4895858,3361620,3249120,112500
1999-07-01,Michigan,7471473,5104568,4916811,187757
1999-07-01,Minnesota,3679782,2751047,2673677,77370
1999-07-01,Mississippi,2084717,1282566,1216887,65679
1999-07-01,Missouri,4201879,2949738,2851116,98622
1999-07-01,Montana,681121,466721,441825,24896
1999-07-01,Nebraska,1276032,929688,903964,25724
1999-07-01,Nevada,1471446,1026078,983909,42169
1999-07-01,Ohio,8596878,5762936,5508848,254088
1999-07-01,Oklahoma,2563711,1656970,1601156,55814
1999-07-01,Oregon,2615107,1782000,1682950,99050
1999-07-01,Pennsylvania,9466152,6101861,5823324,278537
1999-07-01,Tennessee,4318434,2848129,2736973,111156
1999-07-01,Texas,14935156,10270498,9786452,484046
1999-07-01,Utah,1554568,1124768,1084513,40255
1999-07-01,Vermont,468803,339024,328649,10375
1999-07-01,Virginia,5242679,3556857,3459202,97655
1999-07-01,Washington,4410968,3063373,2913910,149463
1999-07-01,Wisconsin,4047381,2955960,2866529,89431
1999-07-01,Wyoming,369470,263940,251287,12653
1999-08-01,Alabama,3364042,2150575,2047648,102927
1999-08-01,Alaska,434000,318383,298066,20317
1999-08-01,Arizona,3777920,2489693,2377601,112092
1999-08-01,Arkansas,2006766,1258654,1201406,57248
1999-08-01,California,24764617,16479001,15626585,852416
1999-08-01,Colorado,3202390,2341976,2269818,72158
1999-08-01,Connecticut,2583717,1742915,1700976,41939
1999-08-01,Delaware,590824,400723,387464,13259
1999-08-01,Florida,12308205,7712683,7411469,301214
1999-08-01,Georgia,5989261,4142038,3985368,156670
1999-08-01,Hawaii,900215,604492,573534,30958
1999-08-01,Idaho,936015,653243,620377,32866
1999-08-01,Illinois,9306874,6489669,6190525,299144
1999-08-01,Indiana,4572817,3117962,3023630,94332
1999-08-01,Iowa,2226060,1593056,1550060,42996
1999-08-01,Kansas,1991371,1407132,1357409,49723
1999-08-01,Kentucky,3065775,1951368,1863124,88244
1999-08-01,Louisiana,3282470,2027324,1926493,100831
1999-08-01,Maine,985313,671315,643970,27345
1999-08-01,Maryland,3958662,2773197,2679215,93982
1999-08-01,Massachusetts,4898848,3359688,3247524,112164
1999-08-01,Michigan,7475173,5114309,4927303,187006
1999-08-01,Minnesota,3685467,2754900,2677095,77805
1999-08-01,Mississippi,2086819,1286184,1219657,66527
1999-08-01,Missouri,4205460,2951407,2855064,96343
1999-08-01,Montana,681087,466835,442088,24747
1999-08-01,Nebraska,1276276,930926,905179,25747
1999-08-01,Nevada,1476371,1029422,987214,42208
1999-08-01,Ohio,8598808,5770475,5517274,253201
1999-08-01,Oklahoma,2564900,1658153,1603162,54991
1999-08-01,Oregon,2617378,1784932,1686307,98625
1999-08-01,Pennsylvania,9469762,6099773,5821493,278280
1999-08-01,Tennessee,4323029,2848550,2737172,111378
1999-08-01,Texas,14959757,10283849,9797733,486116
1999-08-01,Utah,1558017,1125649,1085871,39778
1999-08-01,Vermont,468827,339285,329027,10258
1999-08-01,Virginia,5248807,3563126,3464757,98369
1999-08-01,Washington,4416211,3064877,2915924,148953
1999-08-01,Wisconsin,4050837,2960130,2869519,90611
1999-08-01,Wyoming,370492,264097,251603,12494
1999-09-01,Alabama,3365844,2150783,2048264,102519
1999-09-01,Alaska,433991,318651,298501,20150
1999-09-01,Arizona,3785703,2490777,2380802,109975
1999-09-01,Arkansas,2009177,1259956,1203202,56754
1999-09-01,California,24802709,16506538,15661301,845237
1999-09-01,Colorado,3208368,2342993,2271583,71410
1999-09-01,Connecticut,2585180,1745152,1703728,41424
1999-09-01,Delaware,590900,401689,388329,13360
1999-09-01,Florida,12329561,7724791,7426068,298723
1999-09-01,Georgia,6000272,4147774,3991865,155909
1999-09-01,Hawaii,900346,604728,574375,30353
1999-09-01,Idaho,938015,653571,621221,32350
1999-09-01,Illinois,9313123,6497136,6202076,295060
1999-09-01,Indiana,4576384,3120249,3024545,95704
1999-09-01,Iowa,2226388,1590903,1548920,41983
1999-09-01,Kansas,1992382,1407813,1358048,49765
1999-09-01,Kentucky,3067824,1951091,1864529,86562
1999-09-01,Louisiana,3284491,2029205,1928384,100821
1999-09-01,Maine,986289,673444,646215,27229
1999-09-01,Maryland,3962487,2774786,2681730,93056
1999-09-01,Massachusetts,4902838,3357704,3246334,111370
1999-09-01,Michigan,7479872,5123995,4937539,186456
1999-09-01,Minnesota,3690152,2757917,2680302,77615
1999-09-01,Mississippi,2087921,1290148,1222810,67338
1999-09-01,Missouri,4210042,2952481,2859131,93350
1999-09-01,Montana,682053,467009,442505,24504
1999-09-01,Nebraska,1277519,932119,906424,25695
1999-09-01,Nevada,1481297,1032666,990777,41889
1999-09-01,Ohio,8601737,5777699,5526559,251140
1999-09-01,Oklahoma,2567088,1658881,1604482,54399
1999-09-01,Oregon,2620648,1788993,1691540,97453
1999-09-01,Pennsylvania,9473372,6096878,5821076,275802
1999-09-01,Tennessee,4326624,2847159,2735716,111443
1999-09-01,Texas,14986358,10298131,9810408,487723
1999-09-01,Utah,1560465,1126407,1087445,38962
1999-09-01,Vermont,469851,339634,329503,10131
1999-09-01,Virginia,5255935,3568909,3470304,98605
1999-09-01,Washington,4421455,3065841,2917999,147842
1999-09-01,Wisconsin,4055292,2963806,2872367,91439
1999-09-01,Wyoming,370513,264244,251989,12255
1999-10-01,Alabama,3366646,2151556,2049394,102162
1999-10-01,Alaska,433983,318904,298925,19979
1999-10-01,Arizona,3793487,2492121,2384179,107942
1999-10-01,Arkansas,2011589,1261451,1205287,56164
1999-10-01,California,24839800,16537657,15698952,838705
1999-10-01,Colorado,3215345,2344163,2273941,70222
1999-10-01,Connecticut,2586643,1748276,1707325,40951
1999-10-01,Delaware,591976,402673,389210,13463
1999-10-01,Florida,12349916,7741854,7445756,296098
1999-10-01,Georgia,6011283,4152731,3998280,154451
1999-10-01,Hawaii,901477,604953,575269,29684
1999-10-01,Idaho,939015,654015,622249,31766
1999-10-01,Illinois,9318372,6503959,6214182,289777
1999-10-01,Indiana,4578952,3123749,3027164,96585
1999-10-01,Iowa,2227716,1589927,1548936,40991
1999-10-01,Kansas,1994394,1408185,1358399,49786
1999-10-01,Kentucky,3070874,1951127,1866357,84770
1999-10-01,Louisiana,3285513,2030143,1929745,100398
1999-10-01,Maine,987266,675553,648577,26976
1999-10-01,Maryland,3966311,2776264,2683972,92292
1999-10-01,Massachusetts,4906828,3356051,3245871,110180
1999-10-01,Michigan,7484572,5132672,4948091,184581
1999-10-01,Minnesota,3695837,2760997,2683520,77477
1999-10-01,Mississippi,2090023,1294379,1226127,68252
1999-10-01,Missouri,4213623,2953499,2862854,90645
1999-10-01,Montana,683020,467390,443189,24201
1999-10-01,Nebraska,1278763,933259,907636,25623
1999-10-01,Nevada,1485222,1036115,994672,41443
1999-10-01,Ohio,8604667,5784427,5535431,248996
1999-10-01,Oklahoma,2569277,1659012,1605074,53938
1999-10-01,Oregon,2622919,1793453,1697730,95723
1999-10-01,Pennsylvania,9476982,6094244,5822734,271510
1999-10-01,Tennessee,4331219,2845332,2734311,111021
1999-10-01,Texas,15011960,10315484,9825287,490197
1999-10-01,Utah,1562914,1127292,1089341,37951
1999-10-01,Vermont,469876,334278,324306,9972
1999-10-01,Virginia,5263062,3574426,3476146,98280
1999-10-01,Washington,4426698,3067323,2920395,146928
1999-10-01,Wisconsin,4059748,2967059,2875169,91890
1999-10-01,Wyoming,371535,264415,252469,11946
1999-11-01,Alabama,3368448,2152910,2051106,101804
1999-11-01,Alaska,434974,319163,299319,19844
1999-11-01,Arizona,3800271,2493896,2387962,105934
1999-11-01,Arkansas,2014001,1263283,1207690,55593
1999-11-01,California,24875892,16575273,15742402,832871
1999-11-01,Colorado,3221323,2345972,2277248,68724
1999-11-01,Connecticut,2588106,1752270,1711817,40453
1999-11-01,Delaware,593052,403712,390166,13546
1999-11-01,Florida,12370271,7765366,7471727,293639
1999-11-01,Georgia,6022294,4158264,4005865,152399
1999-11-01,Hawaii,901608,605287,576323,28964
1999-11-01,Idaho,941015,654666,623506,31160
1999-11-01,Illinois,9323621,6511676,6226158,285518
1999-11-01,Indiana,4582519,3128145,3031099,97046
1999-11-01,Iowa,2229044,1590621,1550430,40191
1999-11-01,Kansas,1995406,1408447,1358567,49880
1999-11-01,Kentucky,3072924,1952037,1869023,83014
1999-11-01,Louisiana,3286534,2030516,1930813,99703
1999-11-01,Maine,988243,677647,651071,26576
1999-11-01,Maryland,3970136,2778193,2686508,91685
1999-11-01,Massachusetts,4909818,3355213,3246710,108503
1999-11-01,Michigan,7488272,5140720,4959876,180844
1999-11-01,Minnesota,3700522,2765098,2687323,77775
1999-11-01,Mississippi,2091125,1298702,1229568,69134
1999-11-01,Missouri,4217205,2955266,2866391,88875
1999-11-01,Montana,682986,468069,444195,23874
1999-11-01,Nebraska,1279007,934476,908917,25559
1999-11-01,Nevada,1490148,1040046,998984,41062
1999-11-01,Ohio,8606596,5790572,5543432,247140
1999-11-01,Oklahoma,2570466,1658877,1605476,53401
1999-11-01,Oregon,2625189,1797715,1703991,93724
1999-11-01,Pennsylvania,9479592,6093039,5827310,265729
1999-11-01,Tennessee,4334814,2844836,2734804,110032
1999-11-01,Texas,15036561,10336245,9843320,492925
1999-11-01,Utah,1565362,1128621,1091698,36923
1999-11-01,Vermont,470900,333060,323294,9766
1999-11-01,Virginia,5270190,3580343,3483107,97236
1999-11-01,Washington,4430941,3070647,2923835,146812
1999-11-01,Wisconsin,4063203,2970383,2878425,91958
1999-11-01,Wyoming,371556,264634,253065,11569
1999-12-01,Alabama,3369250,2154424,2053068,101356
1999-12-01,Alaska,434965,319396,299637,19759
1999-12-01,Arizona,3807055,2495657,2391791,103866
1999-12-01,Arkansas,2016413,1265026,1209961,55065
1999-12-01,California,24907984,16618488,15790087,828401
1999-12-01,Colorado,3227301,2348230,2281192,67038
1999-12-01,Connecticut,2588569,1756521,1716678,39843
1999-12-01,Delaware,593128,404848,391230,13618
1999-12-01,Florida,12389626,7793500,7501822,291678
1999-12-01,Georgia,6031305,4164990,4014723,150267
1999-12-01,Hawaii,902739,605731,577473,28258
1999-12-01,Idaho,942015,655557,624958,30599
1999-12-01,Illinois,9328870,6519925,6236937,282988
1999-12-01,Indiana,4585086,3132355,3035384,96971
1999-12-01,Iowa,2229372,1592386,1552614,39772
1999-12-01,Kansas,1996418,1408789,1358584,50205
1999-12-01,Kentucky,3074974,1953670,1872247,81423
1999-12-01,Louisiana,3287555,2030941,1931930,99011
1999-12-01,Maine,989220,679611,653612,25999
1999-12-01,Maryland,3972961,2780692,2689272,91420
1999-12-01,Massachusetts,4911808,3354839,3248582,106257
1999-12-01,Michigan,7490972,5147868,4972268,175600
1999-12-01,Minnesota,3705207,2770337,2691777,78560
1999-12-01,Mississippi,2092227,1303019,1233069,69950
1999-12-01,Missouri,4219787,2958058,2869683,88375
1999-12-01,Montana,683952,468978,445429,23549
1999-12-01,Nebraska,1280251,935840,910297,25543
1999-12-01,Nevada,1495074,1044374,1003530,40844
1999-12-01,Ohio,8607525,5794999,5549577,245422
1999-12-01,Oklahoma,2572655,1658655,1606004,52651
1999-12-01,Oregon,2627459,1801707,1709679,92028
1999-12-01,Pennsylvania,9481202,6093199,5833571,259628
1999-12-01,Tennessee,4338409,2845968,2737221,108747
1999-12-01,Texas,15059162,10357299,9863294,494005
1999-12-01,Utah,1567810,1130412,1094342,36070
1999-12-01,Vermont,470924,333097,323556,9541
1999-12-01,Virginia,5275318,3586341,3490979,95362
1999-12-01,Washington,4436184,3075931,2928358,147573
1999-12-01,Wisconsin,4066658,2973678,2882035,91643
1999-12-01,Wyoming,371577,264879,253736,11143
2000-01-01,Alabama,3370052,2155396,2054501,100895
2000-01-01,Alaska,434957,319633,299870,19763
2000-01-01,Arizona,3813839,2497340,2395317,102023
2000-01-01,Arkansas,2017825,1266292,1211679,54613
2000-01-01,California,24941075,16664807,15837398,827409
2000-01-01,Colorado,3232278,2350618,2285246,65372
2000-01-01,Connecticut,2590032,1760389,1721240,39149
2000-01-01,Delaware,594204,406118,392385,13733
2000-01-01,Florida,12407981,7822185,7531066,291119
2000-01-01,Georgia,6041316,4172874,4023896,148978
2000-01-01,Hawaii,902870,606243,578581,27662
2000-01-01,Idaho,943015,656618,626419,30199
2000-01-01,Illinois,9333119,6526981,6244525,282456
2000-01-01,Indiana,4587654,3135118,3038427,96691
2000-01-01,Iowa,2229700,1593903,1554073,39830
2000-01-01,Kansas,1997430,1409187,1358376,50811
2000-01-01,Kentucky,3077024,1955366,1875237,80129
2000-01-01,Louisiana,3287577,2031853,1932931,98922
2000-01-01,Maine,990197,681190,655933,25257
2000-01-01,Maryland,3975785,2783617,2691746,91871
2000-01-01,Massachusetts,4914798,3354162,3250508,103654
2000-01-01,Michigan,7493672,5153554,4983267,170287
2000-01-01,Minnesota,3708892,2776344,2696809,79535
2000-01-01,Mississippi,2093329,1307058,1236272,70786
2000-01-01,Missouri,4223368,2961435,2872340,89095
2000-01-01,Montana,683919,470003,446727,23276
2000-01-01,Nebraska,1280495,937258,911648,25610
2000-01-01,Nevada,1499999,1048870,1007988,40882
2000-01-01,Ohio,8608455,5797908,5553680,244228
2000-01-01,Oklahoma,2573844,1658242,1606427,51815
2000-01-01,Oregon,2629730,1805513,1714341,91172
2000-01-01,Pennsylvania,9482812,6094090,5839250,254840
2000-01-01,Tennessee,4341004,2848463,2740564,107899
2000-01-01,Texas,15081764,10374888,9882205,492683
2000-01-01,Utah,1570259,1132480,1096923,35557
2000-01-01,Vermont,470949,333451,324117,9334
2000-01-01,Virginia,5281445,3591840,3498977,92863
2000-01-01,Washington,4440427,3082251,2933306,148945
2000-01-01,Wisconsin,4070114,2976661,2885231,91430
2000-01-01,Wyoming,372599,265096,254385,10711
2000-02-01,Alabama,3370854,2155360,2055016,100344
2000-02-01,Alaska,435948,319868,300021,19847
2000-02-01,Arizona,3820622,2498683,2398154,100529
2000-02-01,Arkansas,2019236,1266602,1212498,54104
2000-02-01,California,24967167,16709195,15880102,829093
2000-02-01,Colorado,3238256,2352798,2288901,63897
2000-02-01,Connecticut,2590495,1763187,1724811,38376
2000-02-01,Delaware,594280,407498,393590,13908
2000-02-01,Florida,12424337,7847658,7555736,291922
2000-02-01,Georgia,6049327,4180891,4032279,148612
2000-02-01,Hawaii,903001,606667,579529,27138
2000-02-01,Idaho,945015,657658,627655,30003
2000-02-01,Illinois,9334368,6529947,6246588,283359
2000-02-01,Indiana,4588221,3135810,3039102,96708
2000-02-01,Iowa,2230028,1593990,1553843,40147
2000-02-01,Kansas,1997441,1409276,1357876,51400
2000-02-01,Kentucky,3078073,1956533,1877374,79159
2000-02-01,Louisiana,3287598,2032546,1933151,99395
2000-02-01,Maine,991173,682105,657687,24418
2000-02-01,Maryland,3977610,2786471,2693546,92925
2000-02-01,Massachusetts,4916788,3352184,3251345,100839
2000-02-01,Michigan,7495371,5157825,4990893,166932
2000-02-01,Minnesota,3712577,2781831,2701685,80146
2000-02-01,Mississippi,2093431,1310521,1238908,71613
2000-02-01,Missouri,4224950,2964402,2874153,90249
2000-02-01,Montana,684885,470860,447794,23066
2000-02-01,Nebraska,1281738,938453,912768,25685
2000-02-01,Nevada,1503925,1053251,1012120,41131
2000-02-01,Ohio,8607384,5798706,5555505,243201
2000-02-01,Oklahoma,2575032,1657431,1606463,50968
2000-02-01,Oregon,2632000,1808765,1717663,91102
2000-02-01,Pennsylvania,9482422,6094604,5842749,251855
2000-02-01,Tennessee,4343599,2851078,2743359,107719
2000-02-01,Texas,15101365,10385344,9897422,487922
2000-02-01,Utah,1572707,1134577,1099168,35409
2000-02-01,Vermont,471973,333755,324594,9161
2000-02-01,Virginia,5286573,3596089,3505996,90093
2000-02-01,Washington,4443671,3087622,2937092,150530
2000-02-01,Wisconsin,4072569,2979133,2887250,91883
2000-02-01,Wyoming,372620,265239,254918,10321
2000-03-01,Alabama,3371656,2154461,2054647,99814
2000-03-01,Alaska,435940,320075,300110,19965
2000-03-01,Arizona,3826406,2499507,2399905,99602
2000-03-01,Arkansas,2021648,1265831,1212273,53558
2000-03-01,California,24998258,16748830,15915844,832986
2000-03-01,Colorado,3243233,2354449,2291441,63008
2000-03-01,Connecticut,2590958,1764456,1726813,37643
2000-03-01,Delaware,595356,408910,394744,14166
2000-03-01,Florida,12441692,7869137,7575359,293778
2000-03-01,Georgia,6059337,4188003,4039056,148947
2000-03-01,Hawaii,903133,606814,580108,26706
2000-03-01,Idaho,946016,658517,628488,30029
2000-03-01,Illinois,9338617,6527138,6242216,284922
2000-03-01,Indiana,4590789,3134968,3037517,97451
2000-03-01,Iowa,2231356,1592732,1552218,40514
2000-03-01,Kansas,1998453,1408777,1356943,51834
2000-03-01,Kentucky,3080123,1957158,1878502,78656
2000-03-01,Louisiana,3287619,2032404,1932080,100324
2000-03-01,Maine,992150,682282,658651,23631
2000-03-01,Maryland,3980435,2788961,2694531,94430
2000-03-01,Massachusetts,4918778,3348539,3250360,98179
2000-03-01,Michigan,7497071,5161206,4993328,167878
2000-03-01,Minnesota,3717262,2785765,2705435,80330
2000-03-01,Mississippi,2094533,1313326,1240963,72363
2000-03-01,Missouri,4227531,2966277,2874900,91377
2000-03-01,Montana,684851,471352,448406,22946
2000-03-01,Nebraska,1281982,939217,913464,25753
2000-03-01,Nevada,1508850,1057299,1015788,41511
2000-03-01,Ohio,8608314,5796621,5554077,242544
2000-03-01,Oklahoma,2576221,1656371,1606060,50311
2000-03-01,Oregon,2633271,1811429,1719558,91871
2000-03-01,Pennsylvania,9484032,6094109,5843115,250994
2000-03-01,Tennessee,4346194,2852691,2744529,108162
2000-03-01,Texas,15122966,10387976,9907586,480390
2000-03-01,Utah,1574156,1136540,1100892,35648
2000-03-01,Vermont,471997,333880,324816,9064
2000-03-01,Virginia,5291701,3598402,3511053,87349
2000-03-01,Washington,4447914,3090786,2938274,152512
2000-03-01,Wisconsin,4075025,2981108,2887713,93395
2000-03-01,Wyoming,372642,265312,255278,10034
2000-04-01,Alabama,3374388,2152933,2053544,99389
2000-04-01,Alaska,434498,320208,300087,20121
2000-04-01,Arizona,3821926,2500107,2400733,99374
2000-04-01,Arkansas,2022461,1264225,1211183,53042
2000-04-01,California,25034666,16782816,15944622,838194
2000-04-01,Colorado,3245428,2355634,2292619,63015
2000-04-01,Connecticut,2589182,1764216,1727157,37059
2000-04-01,Delaware,594827,410285,395778,14507
2000-04-01,Florida,12431288,7886709,7590406,296303
2000-04-01,Georgia,6061556,4193495,4043703,149792
2000-04-01,Hawaii,898109,606544,580150,26394
2000-04-01,Idaho,946982,659204,628958,30246
2000-04-01,Illinois,9328045,6519408,6232675,286733
2000-04-01,Indiana,4591689,3133462,3034967,98495
2000-04-01,Iowa,2230938,1590764,1549882,40882
2000-04-01,Kansas,1997350,1407475,1355365,52110
2000-04-01,Kentucky,3080332,1957215,1878639,78576
2000-04-01,Louisiana,3287478,2030975,1929509,101466
2000-04-01,Maine,991786,681689,658698,22991
2000-04-01,Maryland,3981648,2791240,2694918,96322
2000-04-01,Massachusetts,4916613,3343298,3247355,95943
2000-04-01,Michigan,7502107,5163621,4989797,173824
2000-04-01,Minnesota,3719417,2788458,2707937,80521
2000-04-01,Mississippi,2092736,1315163,1242351,72812
2000-04-01,Missouri,4225858,2966814,2874298,92516
2000-04-01,Montana,685731,471489,448564,22925
2000-04-01,Nebraska,1281742,939417,913616,25801
2000-04-01,Nevada,1508246,1060995,1019028,41967
2000-04-01,Ohio,8611098,5792324,5549896,242428
2000-04-01,Oklahoma,2575814,1655441,1605448,49993
2000-04-01,Oregon,2634245,1813558,1720353,93205
2000-04-01,Pennsylvania,9475946,6093113,5840938,252175
2000-04-01,Tennessee,4346560,2853015,2743803,109212
2000-04-01,Texas,15133460,10384688,9912894,471794
2000-04-01,Utah,1574374,1138282,1102093,36189
2000-04-01,Vermont,473116,333850,324776,9074
2000-04-01,Virginia,5282458,3598550,3513704,84846
2000-04-01,Washington,4450803,3091286,2936523,154763
2000-04-01,Wisconsin,4077259,2982659,2886607,96052
2000-04-01,Wyoming,372257,265339,255457,9882
2000-05-01,Alabama,3376115,2150985,2051877,99108
2000-05-01,Alaska,434753,320231,299944,20287
2000-05-01,Arizona,3830993,2501145,2401520,99625
2000-05-01,Arkansas,2023966,1262138,1209613,52525
2000-05-01,California,25062445,16810519,15968867,841652
2000-05-01,Colorado,3252117,2356442,2292707,63735
2000-05-01,Connecticut,2590914,1762879,1726282,36597
2000-05-01,Delaware,595635,411530,396680,14850
2000-05-01,Florida,12448757,7900636,7602166,298470
2000-05-01,Georgia,6073419,4197324,4046670,150654
2000-05-01,Hawaii,898282,605902,579744,26158
2000-05-01,Idaho,948495,659726,629190,30536
2000-05-01,Illinois,9332844,6508674,6220982,287692
2000-05-01,Indiana,4595044,3131375,3032532,98843
2000-05-01,Iowa,2231626,1589019,1547705,41314
2000-05-01,Kansas,1998658,1405410,1353073,52337
2000-05-01,Kentucky,3082558,1956725,1877920,78805
2000-05-01,Louisiana,3288084,2028038,1925659,102379
2000-05-01,Maine,992520,680306,657796,22510
2000-05-01,Maryland,3985656,2793520,2695235,98285
2000-05-01,Massachusetts,4920344,3337096,3243031,94065
2000-05-01,Michigan,7507302,5164344,4981678,182666
2000-05-01,Minnesota,3723374,2790458,2709344,81114
2000-05-01,Mississippi,2094047,1315641,1243022,72619
2000-05-01,Missouri,4228880,2966631,2872430,94201
2000-05-01,Montana,686136,471303,448365,22938
2000-05-01,Nebraska,1282421,939063,913191,25872
2000-05-01,Nevada,1513401,1064454,1022010,42444
2000-05-01,Ohio,8614966,5786537,5544176,242361
2000-05-01,Oklahoma,2577332,1654880,1604931,49949
2000-05-01,Oregon,2636789,1814860,1720191,94669
2000-05-01,Pennsylvania,9477978,6092670,5838132,254538
2000-05-01,Tennessee,4350842,2851807,2741330,110477
2000-05-01,Texas,15156739,10378041,9915154,462887
2000-05-01,Utah,1577260,1139792,1102966,36826
2000-05-01,Vermont,473441,333746,324580,9166
2000-05-01,Virginia,5289327,3597380,3514656,82724
2000-05-01,Washington,4455649,3089352,2932549,156803
2000-05-01,Wisconsin,4080284,2983667,2884394,99273
2000-05-01,Wyoming,372357,265327,255504,9823
2000-06-01,Alabama,3378019,2148644,2049598,99046
2000-06-01,Alaska,435039,320117,299705,20412
2000-06-01,Arizona,3840218,2503023,2402986,100037
2000-06-01,Arkansas,2025602,1260023,1207919,52104
2000-06-01,California,25092141,16832375,15990881,841494
2000-06-01,Colorado,3258979,2356916,2292065,64851
2000-06-01,Connecticut,2592835,1761016,1724784,36232
2000-06-01,Delaware,596507,412534,397439,15095
2000-06-01,Florida,12467007,7911818,7612311,299507
2000-06-01,Georgia,6085633,4199914,4048982,150932
2000-06-01,Hawaii,898329,605064,579163,25901
2000-06-01,Idaho,950082,660119,629321,30798
2000-06-01,Illinois,9338109,6496583,6209465,287118
2000-06-01,Indiana,4598621,3127934,3030118,97816
2000-06-01,Iowa,2232483,1588514,1546565,41949
2000-06-01,Kansas,2000089,1402858,1350204,52654
2000-06-01,Kentucky,3084920,1955907,1876553,79354
2000-06-01,Louisiana,3288851,2024062,1920886,103176
2000-06-01,Maine,993373,678347,656162,22185
2000-06-01,Maryland,3989864,2795968,2695979,99989
2000-06-01,Massachusetts,4924321,3330999,3238498,92501
2000-06-01,Michigan,7512817,5162449,4971024,191425
2000-06-01,Minnesota,3727522,2792365,2709868,82497
2000-06-01,Mississippi,2095521,1314761,1242805,71956
2000-06-01,Missouri,4232096,2966275,2869637,96638
2000-06-01,Montana,686656,470868,447929,22939
2000-06-01,Nebraska,1283175,938411,912365,26046
2000-06-01,Nevada,1518690,1067871,1024845,43026
2000-06-01,Ohio,8619180,5779685,5537918,241767
2000-06-01,Oklahoma,2578950,1654551,1604477,50074
2000-06-01,Oregon,2639540,1815031,1718994,96037
2000-06-01,Pennsylvania,9480412,6093849,5836466,257383
2000-06-01,Tennessee,4355320,2849076,2737554,111522
2000-06-01,Texas,15181172,10371237,9916003,455234
2000-06-01,Utah,1580225,1141131,1103675,37456
2000-06-01,Vermont,473872,333622,324309,9313
2000-06-01,Virginia,5296457,3596215,3515274,80941
2000-06-01,Washington,4460652,3086127,2927485,158642
2000-06-01,Wisconsin,4083497,2983956,2881710,102246
2000-06-01,Wyoming,372540,265322,255494,9828
2000-07-01,Alabama,3379852,2145873,2046851,99022
2000-07-01,Alaska,435275,319867,299400,20467
2000-07-01,Arizona,3849529,2505807,2405631,100176
2000-07-01,Arkansas,2027169,1258163,1206327,51836
2000-07-01,California,25122108,16850862,16014170,836692
2000-07-01,Colorado,3265808,2357347,2291457,65890
2000-07-01,Connecticut,2594750,1759361,1723398,35963
2000-07-01,Delaware,597308,413349,398153,15196
2000-07-01,Florida,12485621,7922274,7623143,299131
2000-07-01,Georgia,6097791,4202076,4052099,149977
2000-07-01,Hawaii,898534,604284,578724,25560
2000-07-01,Idaho,951580,660540,629507,31033
2000-07-01,Illinois,9343505,6484866,6199132,285734
2000-07-01,Indiana,4602084,3123279,3028049,95230
2000-07-01,Iowa,2233194,1589606,1546820,42786
2000-07-01,Kansas,2001437,1400182,1347260,52922
2000-07-01,Kentucky,3087202,1955213,1875040,80173
2000-07-01,Louisiana,3289553,2020359,1916191,104168
2000-07-01,Maine,994123,676253,654293,21960
2000-07-01,Maryland,3994146,2799124,2697863,101261
2000-07-01,Massachusetts,4928325,3326572,3235403,91169
2000-07-01,Michigan,7518317,5157929,4960549,197380
2000-07-01,Minnesota,3731556,2795292,2710585,84707
2000-07-01,Mississippi,2096871,1312718,1241709,71009
2000-07-01,Missouri,4235242,2966424,2866872,99552
2000-07-01,Montana,687074,470286,447403,22883
2000-07-01,Nebraska,1283867,937760,911486,26274
2000-07-01,Nevada,1523973,1071444,1027679,43765
2000-07-01,Ohio,8623387,5772636,5532446,240190
2000-07-01,Oklahoma,2580531,1654254,1604129,50125
2000-07-01,Oregon,2642201,1814162,1717235,96927
2000-07-01,Pennsylvania,9482949,6097040,5837145,259895
2000-07-01,Tennessee,4359743,2845950,2733879,112071
2000-07-01,Texas,15205794,10367924,9918859,449065
2000-07-01,Utah,1583044,1142501,1104443,38058
2000-07-01,Vermont,474208,333546,324086,9460
2000-07-01,Virginia,5303617,3596648,3517376,79272
2000-07-01,Washington,4465758,3083380,2923136,160244
2000-07-01,Wisconsin,4086610,2984042,2879561,104481
2000-07-01,Wyoming,372630,265364,255502,9862
2000-08-01,Alabama,3381310,2143247,2044264,98983
2000-08-01,Alaska,435991,319621,299149,20472
2000-08-01,Arizona,3858859,2510014,2410099,99915
2000-08-01,Arkansas,2028445,1256863,1205114,51749
2000-08-01,California,25159823,16871299,16042831,828468
2000-08-01,Colorado,3273219,2358354,2292079,66275
2000-08-01,Connecticut,2596443,1758398,1722515,35883
2000-08-01,Delaware,597988,414252,399036,15216
2000-08-01,Florida,12508314,7934744,7636668,298076
2000-08-01,Georgia,6109604,4205615,4057671,147944
2000-08-01,Hawaii,899321,603799,578655,25144
2000-08-01,Idaho,953178,661239,630013,31226
2000-08-01,Illinois,9350076,6475245,6190137,285108
2000-08-01,Indiana,4604966,3118838,3026609,92229
2000-08-01,Iowa,2234016,1592249,1548545,43704
2000-08-01,Kansas,2002725,1398066,1344863,53203
2000-08-01,Kentucky,3089097,1955481,1874187,81294
2000-08-01,Louisiana,3290371,2018573,1913044,105529
2000-08-01,Maine,995112,674473,652725,21748
2000-08-01,Maryland,3999344,2803670,2701581,102089
2000-08-01,Massachusetts,4932825,3325514,3235303,90211
2000-08-01,Michigan,7523894,5152974,4952767,200207
2000-08-01,Minnesota,3736180,2800080,2712853,87227
2000-08-01,Mississippi,2097691,1310023,1240298,69725
2000-08-01,Missouri,4238910,2968461,2865279,103182
2000-08-01,Montana,687647,469716,446969,22747
2000-08-01,Nebraska,1284599,937517,911017,26500
2000-08-01,Nevada,1528991,1075476,1030790,44686
2000-08-01,Ohio,8628086,5767570,5529744,237826
2000-08-01,Oklahoma,2581871,1654069,1604248,49821
2000-08-01,Oregon,2645715,1812964,1715989,96975
2000-08-01,Pennsylvania,9486837,6102682,5841097,261585
2000-08-01,Tennessee,4363746,2844279,2732157,112122
2000-08-01,Texas,15232085,10371545,9927737,443808
2000-08-01,Utah,1586352,1144356,1105608,38748
2000-08-01,Vermont,474629,333652,324092,9560
2000-08-01,Virginia,5310692,3600535,3522749,77786
2000-08-01,Washington,4472133,3082534,2921222,161312
2000-08-01,Wisconsin,4090566,2984888,2879078,105810
2000-08-01,Wyoming,372824,265527,255633,9894
2000-09-01,Alabama,3382833,2141123,2042203,98920
2000-09-01,Alaska,436686,319468,299035,20433
2000-09-01,Arizona,3868349,2515959,2416580,99379
2000-09-01,Arkansas,2029809,1256360,1204522,51838
2000-09-01,California,25198907,16896624,16077742,818882
2000-09-01,Colorado,3280778,2360216,2294416,65800
2000-09-01,Connecticut,2598235,1757954,1721890,36064
2000-09-01,Delaware,598716,415453,400210,15243
2000-09-01,Florida,12531514,7950023,7652740,297283
2000-09-01,Georgia,6121592,4211500,4065922,145578
2000-09-01,Hawaii,900064,603783,579065,24718
2000-09-01,Idaho,954816,662304,631007,31297
2000-09-01,Illinois,9357007,6468288,6181872,286416
2000-09-01,Indiana,4607960,3115798,3025630,90168
2000-09-01,Iowa,2234909,1595899,1551361,44538
2000-09-01,Kansas,2004079,1397072,1343392,53680
2000-09-01,Kentucky,3091067,1956925,1874369,82556
2000-09-01,Louisiana,3291271,2019258,1912209,107049
2000-09-01,Maine,996165,673290,651738,21552
2000-09-01,Maryland,4004683,2809536,2707058,102478
2000-09-01,Massachusetts,4937430,3328808,3238983,89825
2000-09-01,Michigan,7529670,5150327,4948522,201805
2000-09-01,Minnesota,3740906,2806769,2717481,89288
2000-09-01,Mississippi,2098577,1307260,1239098,68162
2000-09-01,Missouri,4242677,2973070,2865361,107709
2000-09-01,Montana,688280,469254,446734,22520
2000-09-01,Nebraska,1285348,937888,911207,26681
2000-09-01,Nevada,1534032,1080030,1034296,45734
2000-09-01,Ohio,8633000,5766307,5531574,234733
2000-09-01,Oklahoma,2583304,1654299,1605173,49126
2000-09-01,Oregon,2649251,1812271,1716020,96251
2000-09-01,Pennsylvania,9490931,6110966,5848728,262238
2000-09-01,Tennessee,4367858,2844773,2732966,111807
2000-09-01,Texas,15259194,10382274,9943815,438459
2000-09-01,Utah,1589727,1146846,1107285,39561
2000-09-01,Vermont,475082,334008,324405,9603
2000-09-01,Virginia,5317939,3608457,3531752,76705
2000-09-01,Washington,4478629,3083855,2922175,161680
2000-09-01,Wisconsin,4094607,2987106,2880752,106354
2000-09-01,Wyoming,373051,265833,255942,9891
2000-10-01,Alabama,3384211,2139926,2041001,98925
2000-10-01,Alaska,437393,319403,299064,20339
2000-10-01,Arizona,3877696,2523954,2424942,99012
2000-10-01,Arkansas,2031078,1256632,1204595,52037
2000-10-01,California,25237042,16928452,16118306,810146
2000-10-01,Colorado,3288185,2362855,2298209,64646
2000-10-01,Connecticut,2599904,1757803,1721221,36582
2000-10-01,Delaware,599406,417048,401740,15308
2000-10-01,Florida,12554196,7968603,7671035,297568
2000-10-01,Georgia,6133273,4219708,4076029,143679
2000-10-01,Hawaii,900855,604311,579968,24343
2000-10-01,Idaho,956410,663771,632528,31243
2000-10-01,Illinois,9363515,6464848,6174523,290325
2000-10-01,Indiana,4610768,3115383,3025371,90012
2000-10-01,Iowa,2235750,1599621,1554252,45369
2000-10-01,Kansas,2005362,1397470,1343090,54380
2000-10-01,Kentucky,3092897,1959159,1875394,83765
2000-10-01,Louisiana,3292007,2022328,1913866,108462
2000-10-01,Maine,997202,672805,651444,21361
2000-10-01,Maryland,4009824,2816124,2713711,102413
2000-10-01,Massachusetts,4941860,3336722,3246473,90249
2000-10-01,Michigan,7535127,5152050,4947870,204180
2000-10-01,Minnesota,3745484,2815217,2724744,90473
2000-10-01,Mississippi,2099379,1305140,1238459,66681
2000-10-01,Missouri,4246319,2979947,2867305,112642
2000-10-01,Montana,688837,468924,446711,22213
2000-10-01,Nebraska,1286070,939042,912185,26857
2000-10-01,Nevada,1539014,1085010,1038180,46830
2000-10-01,Ohio,8637548,5769815,5539184,230631
2000-10-01,Oklahoma,2584571,1655384,1607005,48379
2000-10-01,Oregon,2652736,1812447,1717292,95155
2000-10-01,Pennsylvania,9494633,6122435,5860231,262204
2000-10-01,Tennessee,4371798,2846916,2735645,111271
2000-10-01,Texas,15285623,10398969,9966658,432311
2000-10-01,Utah,1593001,1149844,1109406,40438
2000-10-01,Vermont,475507,334594,324966,9628
2000-10-01,Virginia,5324945,3619961,3543654,76307
2000-10-01,Washington,4484987,3086855,2925177,161678
2000-10-01,Wisconsin,4098514,2991135,2884542,106593
2000-10-01,Wyoming,373242,266267,256419,9848
2000-11-01,Alabama,3385253,2139965,2040616,99349
2000-11-01,Alaska,438096,319460,299264,20196
2000-11-01,Arizona,3886639,2533900,2434431,99469
2000-11-01,Arkansas,2032150,1257547,1205079,52468
2000-11-01,California,25273037,16965953,16159985,805968
2000-11-01,Colorado,3295378,2365926,2302455,63471
2000-11-01,Connecticut,2601325,1757617,1720029,37588
2000-11-01,Delaware,600063,418924,403523,15401
2000-11-01,Florida,12575102,7989957,7689671,300286
2000-11-01,Georgia,6144529,4229457,4086197,143260
2000-11-01,Hawaii,901673,605309,581121,24188
2000-11-01,Idaho,957933,665633,634432,31201
2000-11-01,Illinois,9369166,6465149,6167385,297764
2000-11-01,Indiana,4613209,3118498,3025931,92567
2000-11-01,Iowa,2236321,1602761,1556340,46421
2000-11-01,Kansas,2006433,1398926,1343708,55218
2000-11-01,Kentucky,3094531,1961786,1876498,85288
2000-11-01,Louisiana,3292484,2026957,1917107,109850
2000-11-01,Maine,998094,672955,651688,21267
2000-11-01,Maryland,4014613,2822425,2720153,102272
2000-11-01,Massachusetts,4945759,3347925,3256027,91898
2000-11-01,Michigan,7539934,5158205,4949225,208980
2000-11-01,Minnesota,3749779,2824617,2733488,91129
2000-11-01,Mississippi,2099967,1304138,1238350,65788
2000-11-01,Missouri,4249529,2987904,2870358,117546
2000-11-01,Montana,689364,468687,446762,21925
2000-11-01,Nebraska,1286643,940867,913784,27083
2000-11-01,Nevada,1543911,1090188,1042157,48031
2000-11-01,Ohio,8641255,5777788,5551334,226454
2000-11-01,Oklahoma,2585631,1657371,1609291,48080
2000-11-01,Oregon,2655969,1813369,1718860,94509
2000-11-01,Pennsylvania,9497174,6136761,5874011,262750
2000-11-01,Tennessee,4375368,2850056,2739133,110923
2000-11-01,Texas,15310947,10419981,9992279,427702
2000-11-01,Utah,1596218,1153064,1111619,41445
2000-11-01,Vermont,475918,335315,325599,9716
2000-11-01,Virginia,5331526,3633438,3556205,77233
2000-11-01,Washington,4490922,3090504,2928278,162226
2000-11-01,Wisconsin,4102043,2996986,2889490,107496
2000-11-01,Wyoming,373446,266782,256975,9807
2000-12-01,Alabama,3386178,2140886,2040648,100238
2000-12-01,Alaska,438773,319644,299627,20017
2000-12-01,Arizona,3895390,2544844,2443973,100871
2000-12-01,Arkansas,2033134,1258869,1205680,53189
2000-12-01,California,25308044,17004221,16196430,807791
2000-12-01,Colorado,3302410,2369212,2306123,63089
2000-12-01,Connecticut,2602613,1757049,1717973,39076
2000-12-01,Delaware,600688,420792,405350,15442
2000-12-01,Florida,12595548,8011808,7706178,305630
2000-12-01,Georgia,6155531,4238961,4094380,144581
2000-12-01,Hawaii,902472,606510,582193,24317
2000-12-01,Idaho,959424,667767,636497,31270
2000-12-01,Illinois,9374457,6468207,6159884,308323
2000-12-01,Indiana,4615419,3124584,3026991,97593
2000-12-01,Iowa,2236772,1605280,1557642,47638
2000-12-01,Kansas,2007415,1400629,1344631,55998
2000-12-01,Kentucky,3096008,1964112,1876903,87209
2000-12-01,Louisiana,3292838,2031573,1920444,111129
2000-12-01,Maine,998941,673545,652145,21400
2000-12-01,Maryland,4019283,2827342,2725038,102304
2000-12-01,Massachusetts,4949449,3359793,3264889,94904
2000-12-01,Michigan,7544386,5167109,4950193,216916
2000-12-01,Minnesota,3753858,2833661,2741840,91821
2000-12-01,Mississippi,2100492,1304068,1238504,65564
2000-12-01,Missouri,4252557,2994981,2873210,121771
2000-12-01,Montana,689849,468491,446766,21725
2000-12-01,Nebraska,1287185,942907,915594,27313
2000-12-01,Nevada,1548738,1095217,1045870,49347
2000-12-01,Ohio,8644649,5788181,5564923,223258
2000-12-01,Oklahoma,2586577,1659710,1611353,48357
2000-12-01,Oregon,2659061,1814335,1719456,94879
2000-12-01,Pennsylvania,9499379,6151654,5887290,264364
2000-12-01,Tennessee,4378754,2854088,2743055,111033
2000-12-01,Texas,15335573,10442177,10015120,427057
2000-12-01,Utah,1599387,1156115,1113525,42590
2000-12-01,Vermont,476283,336031,326139,9892
2000-12-01,Virginia,5337913,3646707,3566772,79935
2000-12-01,Washington,4496757,3093714,2929874,163840
2000-12-01,Wisconsin,4105382,3004094,2894396,109698
2000-12-01,Wyoming,373611,267287,257505,9782
2001-01-01,Alabama,3387039,2141777,2040374,101403
2001-01-01,Alaska,439457,319846,300030,19816
2001-01-01,Arizona,3904061,2555178,2452258,102920
2001-01-01,Arkansas,2034063,1260049,1205911,54138
2001-01-01,California,25342675,17036516,16221805,814711
2001-01-01,Colorado,3309347,2372165,2308140,64025
2001-01-01,Connecticut,2603831,1755847,1714969,40878
2001-01-01,Delaware,601304,422324,406976,15348
2001-01-01,Florida,12615545,8031163,7718636,312527
2001-01-01,Georgia,6166480,4246253,4099176,147077
2001-01-01,Hawaii,903274,607571,582914,24657
2001-01-01,Idaho,960888,669930,638460,31470
2001-01-01,Illinois,9379497,6472722,6152750,319972
2001-01-01,Indiana,4617526,3131784,3027860,103924
2001-01-01,Iowa,2237196,1607287,1558411,48876
2001-01-01,Kansas,2008356,1401731,1345113,56618
2001-01-01,Kentucky,3097382,1965224,1875942,89282
2001-01-01,Louisiana,3293186,2034561,1922697,111864
2001-01-01,Maine,999732,674292,652495,21797
2001-01-01,Maryland,4023848,2830333,2727705,102628
2001-01-01,Massachusetts,4952972,3369977,3270951,99026
2001-01-01,Michigan,7548639,5175795,4948660,227135
2001-01-01,Minnesota,3757861,2841094,2748164,92930
2001-01-01,Mississippi,2100994,1304179,1238457,65722
2001-01-01,Missouri,4255432,2999349,2874567,124782
2001-01-01,Montana,690313,468240,446626,21614
2001-01-01,Nebraska,1287664,944664,917123,27541
2001-01-01,Nevada,1553524,1099598,1048953,50645
2001-01-01,Ohio,8647714,5798294,5576671,221623
2001-01-01,Oklahoma,2587395,1662044,1612914,49130
2001-01-01,Oregon,2662042,1814809,1718469,96340
2001-01-01,Pennsylvania,9501193,6164882,5897777,267105
2001-01-01,Tennessee,4381992,2857893,2746172,111721
2001-01-01,Texas,15360003,10462250,10030817,431433
2001-01-01,Utah,1602535,1158505,1114739,43766
2001-01-01,Vermont,476597,336609,326466,10143
2001-01-01,Virginia,5344116,3657773,3573374,84399
2001-01-01,Washington,4502401,3095476,2928958,166518
2001-01-01,Wisconsin,4108549,3011189,2898040,113149
2001-01-01,Wyoming,373775,267697,257920,9777
2001-02-01,Alabama,3387682,2141500,2038930,102570
2001-02-01,Alaska,440088,320026,300387,19639
2001-02-01,Arizona,3912564,2563946,2458846,105100
2001-02-01,Arkansas,2034883,1260761,1205527,55234
2001-02-01,California,25376427,17058192,16232819,825373
2001-02-01,Colorado,3316218,2374647,2308334,66313
2001-02-01,Connecticut,2604874,1754010,1711268,42742
2001-02-01,Delaware,601855,423256,408164,15092
2001-02-01,Florida,12634814,8045552,7725933,319619
2001-02-01,Georgia,6177204,4250445,4100338,150107
2001-02-01,Hawaii,903961,608291,583184,25107
2001-02-01,Idaho,962324,671958,640170,31788
2001-02-01,Illinois,9384194,6477254,6147239,330015
2001-02-01,Indiana,4619366,3137878,3027812,110066
2001-02-01,Iowa,2237469,1608759,1558748,50011
2001-02-01,Kansas,2009179,1401763,1344731,57032
2001-02-01,Kentucky,3098647,1964621,1873278,91343
2001-02-01,Louisiana,3293361,2035264,1923373,111891
2001-02-01,Maine,1000503,674993,652554,22439
2001-02-01,Maryland,4028165,2831516,2728083,103433
2001-02-01,Massachusetts,4956302,3376930,3273162,103768
2001-02-01,Michigan,7552510,5180402,4943477,236925
2001-02-01,Minnesota,3761681,2846314,2751524,94790
2001-02-01,Mississippi,2101429,1303459,1237565,65894
2001-02-01,Missouri,4258133,3000391,2873793,126598
2001-02-01,Montana,690759,467916,446355,21561
2001-02-01,Nebraska,1288101,945847,918063,27784
2001-02-01,Nevada,1558251,1103074,1051286,51788
2001-02-01,Ohio,8650413,5806144,5584368,221776
2001-02-01,Oklahoma,2588181,1664211,1613887,50324
2001-02-01,Oregon,2664923,1814784,1716005,98779
2001-02-01,Pennsylvania,9502499,6174916,5904081,270835
2001-02-01,Tennessee,4385065,2860066,2746928,113138
2001-02-01,Texas,15384055,10479048,10037850,441198
2001-02-01,Utah,1605693,1160008,1115153,44855
2001-02-01,Vermont,476959,337020,326597,10423
2001-02-01,Virginia,5350121,3665728,3575695,90033
2001-02-01,Washington,4507825,3095569,2925810,169759
2001-02-01,Wisconsin,4111573,3016984,2899630,117354
2001-02-01,Wyoming,373943,267992,258178,9814
2001-03-01,Alabama,3388360,2139257,2035813,103444
2001-03-01,Alaska,440714,320242,300708,19534
2001-03-01,Arizona,3920943,2570663,2463767,106896
2001-03-01,Arkansas,2035722,1260887,1204622,56265
2001-03-01,California,25408416,17067462,16229316,838146
2001-03-01,Colorado,3323001,2376838,2307202,69636
2001-03-01,Connecticut,2605932,1751602,1707158,44444
2001-03-01,Delaware,602431,423429,408737,14692
2001-03-01,Florida,12653862,8053803,7728117,325686
2001-03-01,Georgia,6187800,4251021,4098047,152974
2001-03-01,Hawaii,904557,608571,583097,25474
2001-03-01,Idaho,963750,673742,641583,32159
2001-03-01,Illinois,9388724,6479113,6142766,336347
2001-03-01,Indiana,4621335,3140939,3026034,114905
2001-03-01,Iowa,2237792,1609527,1558694,50833
2001-03-01,Kansas,2010010,1400671,1343513,57158
2001-03-01,Kentucky,3099936,1962263,1868983,93280
2001-03-01,Louisiana,3293479,2033367,1922359,111008
2001-03-01,Maine,1001284,675405,652184,23221
2001-03-01,Maryland,4032468,2831057,2726306,104751
2001-03-01,Massachusetts,4959688,3380386,3271755,108631
2001-03-01,Michigan,7556439,5178441,4934622,243819
2001-03-01,Minnesota,3765569,2848984,2751722,97262
2001-03-01,Mississippi,2101776,1301372,1235470,65902
2001-03-01,Missouri,4260879,2998294,2870983,127311
2001-03-01,Montana,691172,467435,445940,21495
2001-03-01,Nebraska,1288559,946352,918311,28041
2001-03-01,Nevada,1562928,1105674,1052888,52786
2001-03-01,Ohio,8653257,5810671,5587139,223532
2001-03-01,Oklahoma,2588891,1665929,1614117,51812
2001-03-01,Oregon,2667795,1814100,1712458,101642
2001-03-01,Pennsylvania,9504003,6180184,5905154,275030
2001-03-01,Tennessee,4388151,2859771,2744562,115209
2001-03-01,Texas,15407081,10492222,10037198,455024
2001-03-01,Utah,1608787,1160651,1114848,45803
2001-03-01,Vermont,477290,337288,326607,10681
2001-03-01,Virginia,5356063,3670733,3574644,96089
2001-03-01,Washington,4513254,3093906,2921179,172727
2001-03-01,Wisconsin,4114656,3020474,2898934,121540
2001-03-01,Wyoming,374064,268171,258287,9884
2001-04-01,Alabama,3389260,2135072,2030986,104086
2001-04-01,Alaska,441403,320488,300987,19501
2001-04-01,Arizona,3929648,2575436,2467052,108384
2001-04-01,Arkansas,2036681,1260413,1203276,57137
2001-04-01,California,25442952,17066003,16213500,852503
2001-04-01,Colorado,3330031,2379022,2305575,73447
2001-04-01,Connecticut,2607177,1748846,1702915,45931
2001-04-01,Delaware,603034,422887,408637,14250
2001-04-01,Florida,12673851,8057451,7726938,330513
2001-04-01,Georgia,6198801,4248265,4092954,155311
2001-04-01,Hawaii,905292,608338,582822,25516
2001-04-01,Idaho,965243,675268,642708,32560
2001-04-01,Illinois,9393943,6475826,6137057,338769
2001-04-01,Indiana,4623507,3140459,3022219,118240
2001-04-01,Iowa,2238220,1610026,1558753,51273
2001-04-01,Kansas,2010999,1398726,1341682,57044
2001-04-01,Kentucky,3101406,1958517,1863501,95016
2001-04-01,Louisiana,3293852,2029478,1920030,109448
2001-04-01,Maine,1002123,675436,651441,23995
2001-04-01,Maryland,4037045,2829251,2722683,106568
2001-04-01,Massachusetts,4963354,3381432,3268013,113419
2001-04-01,Michigan,7560859,5169900,4922437,247463
2001-04-01,Minnesota,3769673,2848906,2749027,99879
2001-04-01,Mississippi,2102305,1298215,1232251,65964
2001-04-01,Missouri,4263899,2993694,2866523,127171
2001-04-01,Montana,691662,466697,445317,21380
2001-04-01,Nebraska,1289076,946186,917886,28300
2001-04-01,Nevada,1567733,1107606,1053881,53725
2001-04-01,Ohio,8656582,5811816,5585021,226795
2001-04-01,Oklahoma,2589817,1666892,1613465,53427
2001-04-01,Oregon,2670864,1813028,1708533,104495
2001-04-01,Pennsylvania,9506024,6180288,5901257,279031
2001-04-01,Tennessee,4391508,2857284,2739708,117576
2001-04-01,Texas,15431594,10502031,10031118,470913
2001-04-01,Utah,1612034,1160695,1114003,46692
2001-04-01,Vermont,477637,337429,326558,10871
2001-04-01,Virginia,5362396,3673465,3571404,102061
2001-04-01,Washington,4518982,3090758,2915751,175007
2001-04-01,Wisconsin,4117964,3021235,2896277,124958
2001-04-01,Wyoming,374225,268260,258279,9981
2001-05-01,Alabama,3390258,2130035,2025197,104838
2001-05-01,Alaska,442100,320814,301260,19554
2001-05-01,Arizona,3938383,2579399,2469093,110306
2001-05-01,Arkansas,2037739,1259729,1201821,57908
2001-05-01,California,25477019,17061915,16191476,870439
2001-05-01,Colorado,3337135,2381894,2304342,77552
2001-05-01,Connecticut,2608492,1746614,1699291,47323
2001-05-01,Delaware,603678,421954,408021,13933
2001-05-01,Florida,12694136,8060205,7724967,335238
2001-05-01,Georgia,6209942,4244522,4086701,157821
2001-05-01,Hawaii,905953,607700,582487,25213
2001-05-01,Idaho,966791,676697,643669,33028
2001-05-01,Illinois,9399314,6468552,6129446,339106
2001-05-01,Indiana,4625967,3138280,3017196,121084
2001-05-01,Iowa,2238858,1610648,1559211,51437
2001-05-01,Kansas,2012049,1396636,1339756,56880
2001-05-01,Kentucky,3103053,1954385,1857689,96696
2001-05-01,Louisiana,3294280,2025314,1917313,108001
2001-05-01,Maine,1003074,675353,650651,24702
2001-05-01,Maryland,4041659,2827494,2718303,109191
2001-05-01,Massachusetts,4967224,3382048,3263771,118277
2001-05-01,Michigan,7565542,5157214,4907941,249273
2001-05-01,Minnesota,3774037,2847221,2744908,102313
2001-05-01,Mississippi,2102875,1294852,1228504,66348
2001-05-01,Missouri,4267104,2988304,2861336,126968
2001-05-01,Montana,692184,465819,444567,21252
2001-05-01,Nebraska,1289688,945687,917143,28544
2001-05-01,Nevada,1572539,1109352,1054604,54748
2001-05-01,Ohio,8660283,5812072,5580007,232065
2001-05-01,Oklahoma,2590836,1667424,1612236,55188
2001-05-01,Oregon,2674062,1812473,1705200,107273
2001-05-01,Pennsylvania,9508525,6177356,5894367,282989
2001-05-01,Tennessee,4395078,2854355,2734072,120283
2001-05-01,Texas,15456099,10511424,10023661,487763
2001-05-01,Utah,1615352,1160718,1112990,47728
2001-05-01,Vermont,478054,337553,326566,10987
2001-05-01,Virginia,5368787,3675170,3567108,108062
2001-05-01,Washington,4524913,3087259,2910430,176829
2001-05-01,Wisconsin,4121525,3020351,2892795,127556
2001-05-01,Wyoming,374421,268332,258220,10112
2001-06-01,Alabama,3391415,2125294,2019160,106134
2001-06-01,Alaska,442790,321252,301545,19707
2001-06-01,Arizona,3947379,2583941,2470488,113453
2001-06-01,Arkansas,2038912,1259197,1200558,58639
2001-06-01,California,25512789,17062514,16168434,894080
2001-06-01,Colorado,3344448,2386088,2303819,82269
2001-06-01,Connecticut,2609938,1745327,1696540,48787
2001-06-01,Delaware,604340,421064,407191,13873
2001-06-01,Florida,12715218,8064197,7722943,341254
2001-06-01,Georgia,6221345,4242516,4080730,161786
2001-06-01,Hawaii,906693,606975,582108,24867
2001-06-01,Idaho,968401,678132,644538,33594
2001-06-01,Illinois,9405189,6459192,6119367,339825
2001-06-01,Indiana,4628628,3137043,3012271,124772
2001-06-01,Iowa,2239580,1611094,1559480,51614
2001-06-01,Kansas,2013249,1395029,1338024,57005
2001-06-01,Kentucky,3104831,1950891,1852210,98681
2001-06-01,Louisiana,3294875,2022275,1914852,107423
2001-06-01,Maine,1004055,675346,650029,25317
2001-06-01,Maryland,4046455,2827207,2714274,112933
2001-06-01,Massachusetts,4971387,3383349,3259884,123465
2001-06-01,Michigan,7570642,5143387,4891453,251934
2001-06-01,Minnesota,3778582,2845315,2740838,104477
2001-06-01,Mississippi,2103548,1291859,1224684,67175
2001-06-01,Missouri,4270528,2983912,2855975,127937
2001-06-01,Montana,692756,464970,443817,21153
2001-06-01,Nebraska,1290397,945107,916309,28798
2001-06-01,Nevada,1577431,1111300,1055337,55963
2001-06-01,Ohio,8664455,5814261,5574358,239903
2001-06-01,Oklahoma,2591986,1668255,1611000,57255
2001-06-01,Oregon,2677372,1812656,1702502,110154
2001-06-01,Pennsylvania,9511507,6173797,5886204,287593
2001-06-01,Tennessee,4398768,2852236,2728708,123528
2001-06-01,Texas,15481630,10522773,10017556,505217
2001-06-01,Utah,1618754,1161120,1112080,49040
2001-06-01,Vermont,478500,337764,326706,11058
2001-06-01,Virginia,5375521,3677022,3562305,114717
2001-06-01,Washington,4531055,3084091,2905333,178758
2001-06-01,Wisconsin,4125319,3018999,2889072,129927
2001-06-01,Wyoming,374643,268413,258166,10247
2001-07-01,Alabama,3392436,2122119,2013716,108403
2001-07-01,Alaska,443480,321790,301846,19944
2001-07-01,Arizona,3956253,2590486,2472036,118450
2001-07-01,Arkansas,2040000,1259269,1199744,59525
2001-07-01,California,25547539,17073157,16148575,924582
2001-07-01,Colorado,3351629,2392144,2303968,88176
2001-07-01,Connecticut,2611305,1745050,1694574,50476
2001-07-01,Delaware,604959,420520,406419,14101
2001-07-01,Florida,12735879,8070383,7720797,349586
2001-07-01,Georgia,6232538,4244587,4076332,168255
2001-07-01,Hawaii,907380,606588,581723,24865
2001-07-01,Idaho,969962,679601,645370,34231
2001-07-01,Illinois,9410722,6450244,6107545,342699
2001-07-01,Indiana,4631127,3138321,3008039,130282
2001-07-01,Iowa,2240220,1611270,1559066,52204
2001-07-01,Kansas,2014364,1394452,1336746,57706
2001-07-01,Kentucky,3106501,1948804,1847523,101281
2001-07-01,Louisiana,3295346,2021385,1912999,108386
2001-07-01,Maine,1004970,675381,649543,25838
2001-07-01,Maryland,4051099,2829195,2711499,117696
2001-07-01,Massachusetts,4975374,3385812,3256581,129231
2001-07-01,Michigan,7575452,5131220,4873266,257954
2001-07-01,Minnesota,3782985,2844372,2737689,106683
2001-07-01,Mississippi,2104112,1289905,1221187,68718
2001-07-01,Missouri,4273800,2981618,2850902,130716
2001-07-01,Montana,693281,464267,443137,21130
2001-07-01,Nebraska,1291022,944777,915576,29201
2001-07-01,Nevada,1582281,1113746,1056285,57461
2001-07-01,Ohio,8668225,5819450,5569288,250162
2001-07-01,Oklahoma,2593022,1670245,1610316,59929
2001-07-01,Oregon,2680623,1813351,1699586,113765
2001-07-01,Pennsylvania,9514118,6171901,5878583,293318
2001-07-01,Tennessee,4402350,2851637,2724207,127430
2001-07-01,Texas,15506619,10537755,10013363,524392
2001-07-01,Utah,1622108,1162087,1111452,50635
2001-07-01,Vermont,478876,338109,326965,11144
2001-07-01,Virginia,5381987,3680168,3557698,122470
2001-07-01,Washington,4537005,3081703,2900044,181659
2001-07-01,Wisconsin,4128936,3018019,2885334,132685
2001-07-01,Wyoming,374826,268525,258174,10351
2001-08-01,Alabama,3393842,2120291,2008675,111616
2001-08-01,Alaska,444285,322275,302019,20256
2001-08-01,Arizona,3966230,2598978,2473638,125340
2001-08-01,Arkansas,2041352,1259971,1199157,60814
2001-08-01,California,25579419,17091666,16129846,961820
2001-08-01,Colorado,3356755,2399781,2303806,95975
2001-08-01,Connecticut,2613460,1745456,1692990,52466
2001-08-01,Delaware,605731,420277,405713,14564
2001-08-01,Florida,12760563,8076689,7716575,360114
2001-08-01,Georgia,6243529,4250549,4073248,177301
2001-08-01,Hawaii,908102,606629,581236,25393
2001-08-01,Idaho,971636,680932,645959,34973
2001-08-01,Illinois,9416565,6442403,6093093,349310
2001-08-01,Indiana,4633815,3141688,3003900,137788
2001-08-01,Iowa,2241032,1611115,1557650,53465
2001-08-01,Kansas,2015802,1394856,1335748,59108
2001-08-01,Kentucky,3108740,1947770,1843171,104599
2001-08-01,Louisiana,3296898,2022156,1911061,111095
2001-08-01,Maine,1006027,675280,648922,26358
2001-08-01,Maryland,4056512,2833098,2709783,123315
2001-08-01,Massachusetts,4978736,3388682,3253013,135669
2001-08-01,Michigan,7580334,5120998,4852419,268579
2001-08-01,Minnesota,3786891,2844775,2735241,109534
2001-08-01,Mississippi,2105002,1289104,1217850,71254
2001-08-01,Missouri,4277491,2980711,2845723,134988
2001-08-01,Montana,693935,463726,442516,21210
2001-08-01,Nebraska,1291856,944642,914791,29851
2001-08-01,Nevada,1587031,1116526,1057209,59317
2001-08-01,Ohio,8672828,5825748,5563407,262341
2001-08-01,Oklahoma,2594977,1673342,1609938,63404
2001-08-01,Oregon,2684522,1814343,1695571,118772
2001-08-01,Pennsylvania,9519305,6172531,5871636,300895
2001-08-01,Tennessee,4406467,2852352,2720048,132304
2001-08-01,Texas,15532102,10554649,10007996,546653
2001-08-01,Utah,1625142,1163273,1110823,52450
2001-08-01,Vermont,479322,338468,327180,11288
2001-08-01,Virginia,5388977,3684038,3552829,131209
2001-08-01,Washington,4543227,3080051,2893570,186481
2001-08-01,Wisconsin,4133051,3017389,2880946,136443
2001-08-01,Wyoming,375274,268596,258172,10424
2001-09-01,Alabama,3395327,2119126,2003790,115336
2001-09-01,Alaska,445086,322657,302053,20604
2001-09-01,Arizona,3976343,2608688,2475140,133548
2001-09-01,Arkansas,2042763,1261044,1198568,62476
2001-09-01,California,25612457,17114525,16111501,1003024
2001-09-01,Colorado,3362033,2408440,2302903,105537
2001-09-01,Connecticut,2615702,1746455,1691752,54703
2001-09-01,Delaware,606500,420226,405065,15161
2001-09-01,Florida,12785780,8080994,7709589,371405
2001-09-01,Georgia,6254668,4259318,4071269,188049
2001-09-01,Hawaii,908840,606885,580511,26374
2001-09-01,Idaho,973376,682023,646139,35884
2001-09-01,Illinois,9422769,6436126,6076326,359800
2001-09-01,Indiana,4636658,3146603,2999956,146647
2001-09-01,Iowa,2241912,1610881,1555541,55340
2001-09-01,Kansas,2017324,1396032,1334938,61094
2001-09-01,Kentucky,3111061,1947289,1838988,108301
2001-09-01,Louisiana,3298599,2023510,1908467,115043
2001-09-01,Maine,1007135,674951,648073,26878
2001-09-01,Maryland,4062032,2838500,2709147,129353
2001-09-01,Massachusetts,4982192,3391514,3248977,142537
2001-09-01,Michigan,7585464,5111382,4829210,282172
2001-09-01,Minnesota,3790917,2846603,2733236,113367
2001-09-01,Mississippi,2105990,1289177,1214659,74518
2001-09-01,Missouri,4281344,2980289,2840391,139898
2001-09-01,Montana,694619,463380,442031,21349
2001-09-01,Nebraska,1292727,944582,913864,30718
2001-09-01,Nevada,1591816,1119335,1057937,61398
2001-09-01,Ohio,8677675,5831547,5555756,275791
2001-09-01,Oklahoma,2596992,1676984,1609659,67325
2001-09-01,Oregon,2688495,1815624,1690500,125124
2001-09-01,Pennsylvania,9524726,6175610,5865302,310308
2001-09-01,Tennessee,4410746,2854605,2716455,138150
2001-09-01,Texas,15558281,10571682,10000407,571275
2001-09-01,Utah,1628218,1164418,1110022,54396
2001-09-01,Vermont,479777,338773,327299,11474
2001-09-01,Virginia,5396149,3688173,3547843,140330
2001-09-01,Washington,4549549,3079041,2886014,193027
2001-09-01,Wisconsin,4137216,3016955,2875462,141493
2001-09-01,Wyoming,375705,268547,258098,10449
2001-10-01,Alabama,3396655,2118136,1999094,119042
2001-10-01,Alaska,445888,323003,302033,20970
2001-10-01,Arizona,3986221,2618988,2476968,142020
2001-10-01,Arkansas,2044106,1262397,1198077,64320
2001-10-01,California,25644032,17139126,16095235,1043891
2001-10-01,Colorado,3367175,2417657,2301764,115893
2001-10-01,Connecticut,2617761,1748089,1691061,57028
2001-10-01,Delaware,607285,420247,404457,15790
2001-10-01,Florida,12809888,8007931,7610061,397870
2001-10-01,Georgia,6265646,4269917,4070697,199220
2001-10-01,Hawaii,909486,607057,579538,27519
2001-10-01,Idaho,975049,682863,645956,36907
2001-10-01,Illinois,9428484,6431162,6058843,372319
2001-10-01,Indiana,4639299,3151903,2996271,155632
2001-10-01,Iowa,2242738,1611068,1553561,57507
2001-10-01,Kansas,2018770,1397804,1334393,63411
2001-10-01,Kentucky,3113301,1947067,1835318,111749
2001-10-01,Louisiana,3300144,2024273,1905047,119226
2001-10-01,Maine,1008157,674462,647105,27357
2001-10-01,Maryland,4067332,2845034,2710063,134971
2001-10-01,Massachusetts,4985426,3394609,3245271,149338
2001-10-01,Michigan,7590159,5101413,4805317,296096
2001-10-01,Minnesota,3794796,2849487,2731592,117895
2001-10-01,Mississippi,2106910,1289626,1211802,77824
2001-10-01,Missouri,4284972,2980040,2835353,144687
2001-10-01,Montana,695276,463330,441818,21512
2001-10-01,Nebraska,1293543,944631,912954,31677
2001-10-01,Nevada,1596483,1122018,1058611,63407
2001-10-01,Ohio,8682072,5836269,5546560,289709
2001-10-01,Oklahoma,2598867,1680495,1609570,70925
2001-10-01,Oregon,2692299,1817205,1685269,131936
2001-10-01,Pennsylvania,9529554,6180689,5860262,320427
2001-10-01,Tennessee,4414767,2858509,2713982,144527
2001-10-01,Texas,15583700,10588115,9992389,595726
2001-10-01,Utah,1631320,1165570,1109225,56345
2001-10-01,Vermont,480215,339046,327378,11668
2001-10-01,Virginia,5403027,3692646,3543843,148803
2001-10-01,Washington,4555657,3078364,2878269,200095
2001-10-01,Wisconsin,4141269,3016564,2869184,147380
2001-10-01,Wyoming,376150,268424,257994,10430
2001-11-01,Alabama,3397377,2116512,1994393,122119
2001-11-01,Alaska,446603,323344,301982,21362
2001-11-01,Arizona,3995539,2628928,2479380,149548
2001-11-01,Arkansas,2045037,1263950,1197823,66127
2001-11-01,California,25672349,17161602,16081351,1080251
2001-11-01,Colorado,3371794,2426577,2300730,125847
2001-11-01,Connecticut,2619402,1750196,1690859,59337
2001-11-01,Delaware,607953,420223,403827,16396
2001-11-01,Florida,12831933,8010652,7600865,409787
2001-11-01,Georgia,6275466,4280798,4071417,209381
2001-11-01,Hawaii,910197,606823,578420,28403
2001-11-01,Idaho,976561,683401,645460,37941
2001-11-01,Illinois,9432664,6425773,6041133,384640
2001-11-01,Indiana,4641180,3155789,2992463,163326
2001-11-01,Iowa,2243111,1611932,1552302,59630
2001-11-01,Kansas,2019873,1399944,1334154,65790
2001-11-01,Kentucky,3115007,1946442,1832265,114177
2001-11-01,Louisiana,3301094,2023422,1900945,122477
2001-11-01,Maine,1009049,673926,646143,27783
2001-11-01,Maryland,4071927,2852049,2712532,139517
2001-11-01,Massachusetts,4987817,3398382,3242751,155631
2001-11-01,Michigan,7593576,5090268,4782389,307879
2001-11-01,Minnesota,3798068,2852819,2730169,122650
2001-11-01,Mississippi,2107407,1289887,1209224,80663
2001-11-01,Missouri,4287890,2979828,2830930,148898
2001-11-01,Montana,695802,463540,441864,21676
2001-11-01,Nebraska,1294148,944797,912172,32625
2001-11-01,Nevada,1600992,1124320,1059301,65019
2001-11-01,Ohio,8684968,5838599,5535574,303025
2001-11-01,Oklahoma,2600322,1683462,1609645,73817
2001-11-01,Oregon,2695721,1819144,1681041,138103
2001-11-01,Pennsylvania,9532737,6186948,5856987,329961
2001-11-01,Tennessee,4418100,2863235,2712599,150636
2001-11-01,Texas,15607012,10603199,9985772,617427
2001-11-01,Utah,1634134,1166683,1108531,58152
2001-11-01,Vermont,480606,339308,327472,11836
2001-11-01,Virginia,5409044,3697251,3541607,155644
2001-11-01,Washington,4561056,3078060,2871302,206758
2001-11-01,Wisconsin,4144622,3015925,2862532,153393
2001-11-01,Wyoming,376559,268296,257882,10414
2001-12-01,Alabama,3398108,2114191,1989957,124234
2001-12-01,Alaska,447347,323723,301961,21762
2001-12-01,Arizona,4004764,2638369,2482908,155461
2001-12-01,Arkansas,2046024,1265827,1198152,67675
2001-12-01,California,25700341,17181811,16071997,1109814
2001-12-01,Colorado,3376403,2434221,2300238,133983
2001-12-01,Connecticut,2621052,1752945,1691304,61641
2001-12-01,Delaware,608616,420130,403168,16962
2001-12-01,Florida,12853859,8009023,7594519,414504
2001-12-01,Georgia,6285374,4291293,4073637,217656
2001-12-01,Hawaii,910871,606078,577372,28706
2001-12-01,Idaho,978096,683725,644867,38858
2001-12-01,Illinois,9436821,6418978,6023568,395410
2001-12-01,Indiana,4643062,3158003,2989096,168907
2001-12-01,Iowa,2243507,1613910,1552463,61447
2001-12-01,Kansas,2020944,1402498,1334524,67974
2001-12-01,Kentucky,3116719,1945384,1830063,115321
2001-12-01,Louisiana,3302065,2021105,1896856,124249
2001-12-01,Maine,1009929,673557,645444,28113
2001-12-01,Maryland,4076605,2858910,2716339,142571
2001-12-01,Massachusetts,4990241,3404004,3242834,161170
2001-12-01,Michigan,7597070,5078323,4762583,315740
2001-12-01,Minnesota,3801321,2856276,2729268,127008
2001-12-01,Mississippi,2107926,1289822,1207000,82822
2001-12-01,Missouri,4290818,2979944,2827722,152222
2001-12-01,Montana,696333,463919,442104,21815
2001-12-01,Nebraska,1294719,945235,911738,33497
2001-12-01,Nevada,1605494,1126262,1060173,66089
2001-12-01,Ohio,8687916,5838840,5523828,315012
2001-12-01,Oklahoma,2601753,1686131,1610012,76119
2001-12-01,Oregon,2699120,1821580,1679028,142552
2001-12-01,Pennsylvania,9535917,6194821,5856844,337977
2001-12-01,Tennessee,4421453,2868147,2712678,155469
2001-12-01,Texas,15630107,10618828,9983496,635332
2001-12-01,Utah,1636921,1167932,1108131,59801
2001-12-01,Vermont,480956,339657,327689,11968
2001-12-01,Virginia,5415147,3702599,3542212,160387
2001-12-01,Washington,4566506,3078787,2866396,212391
2001-12-01,Wisconsin,4147972,3015244,2856597,158647
2001-12-01,Wyoming,376925,268265,257803,10462
2002-01-01,Alabama,3399005,2111713,1986380,125333
2002-01-01,Alaska,448136,324206,302056,22150
2002-01-01,Arizona,4014110,2647457,2487794,159663
2002-01-01,Arkansas,2047083,1268139,1199349,68790
2002-01-01,California,25729038,17200139,16068216,1131923
2002-01-01,Colorado,3381106,2440155,2300818,139337
2002-01-01,Connecticut,2622807,1756478,1692498,63980
2002-01-01,Delaware,609322,419914,402426,17488
2002-01-01,Florida,12876040,8008565,7593564,415001
2002-01-01,Georgia,6295616,4301092,4077221,223871
2002-01-01,Hawaii,911557,604976,576624,28352
2002-01-01,Idaho,979698,684000,644462,39538
2002-01-01,Illinois,9441311,6409946,6005946,404000
2002-01-01,Indiana,4645046,3159154,2987071,172083
2002-01-01,Iowa,2243962,1617279,1554488,62791
2002-01-01,Kansas,2022069,1405363,1335675,69688
2002-01-01,Kentucky,3118507,1944328,1828934,115394
2002-01-01,Louisiana,3303232,2017989,1893384,124605
2002-01-01,Maine,1010842,673611,645223,28388
2002-01-01,Maryland,4081417,2864897,2720786,144111
2002-01-01,Massachusetts,4992707,3411826,3246003,165823
2002-01-01,Michigan,7600764,5066583,4747137,319446
2002-01-01,Minnesota,3804678,2859285,2728922,130363
2002-01-01,Mississippi,2108546,1289645,1205447,84198
2002-01-01,Missouri,4293808,2980576,2825930,154646
2002-01-01,Montana,696879,464367,442450,21917
2002-01-01,Nebraska,1295374,946025,911808,34217
2002-01-01,Nevada,1609988,1127970,1061341,66629
2002-01-01,Ohio,8691057,5837148,5512148,325000
2002-01-01,Oklahoma,2603219,1688351,1610625,77726
2002-01-01,Oregon,2702531,1824184,1679563,144621
2002-01-01,Pennsylvania,9539280,6203483,5859751,343732
2002-01-01,Tennessee,4424888,2873062,2714853,158209
2002-01-01,Texas,15653763,10636473,9987112,649361
2002-01-01,Utah,1639828,1169481,1108155,61326
2002-01-01,Vermont,481315,340182,328107,12075
2002-01-01,Virginia,5421363,3708958,3545878,163080
2002-01-01,Washington,4571991,3080706,2864282,216424
2002-01-01,Wisconsin,4151392,3014685,2852321,162364
2002-01-01,Wyoming,377308,268360,257785,10575
2002-02-01,Alabama,3399402,2109535,1983890,125645
2002-02-01,Alaska,448798,324749,302240,22509
2002-02-01,Arizona,4022929,2655925,2493370,162555
2002-02-01,Arkansas,2047798,1270680,1201300,69380
2002-02-01,California,25755035,17215556,16068377,1147179
2002-02-01,Colorado,3385487,2443835,2302077,141758
2002-02-01,Connecticut,2624141,1760683,1694261,66422
2002-02-01,Delaware,609922,419539,401598,17941
2002-02-01,Florida,12896372,8011118,7598085,413033
2002-02-01,Georgia,6305144,4309744,4081734,228010
2002-02-01,Hawaii,912110,603721,576285,27436
2002-02-01,Idaho,981094,684249,644343,39906
2002-02-01,Illinois,9444668,6397958,5987195,410763
2002-02-01,Indiana,4646491,3159571,2986676,172895
2002-02-01,Iowa,2244055,1621675,1557984,63691
2002-02-01,Kansas,2022953,1408286,1337401,70885
2002-02-01,Kentucky,3119948,1943276,1828696,114580
2002-02-01,Louisiana,3303952,2014815,1890945,123870
2002-02-01,Maine,1011593,674227,645539,28688
2002-02-01,Maryland,4085716,2869442,2725106,144336
2002-02-01,Massachusetts,4994638,3420825,3251186,169639
2002-02-01,Michigan,7603498,5056176,4735820,320356
2002-02-01,Minnesota,3807582,2861594,2729260,132334
2002-02-01,Mississippi,2108953,1289529,1204671,84858
2002-02-01,Missouri,4296276,2981362,2824957,156405
2002-02-01,Montana,697360,464775,442794,21981
2002-02-01,Nebraska,1295829,947085,912326,34759
2002-02-01,Nevada,1614350,1129405,1062671,66734
2002-02-01,Ohio,8693156,5833268,5500685,332583
2002-02-01,Oklahoma,2604437,1689439,1610980,78459
2002-02-01,Oregon,2705630,1826495,1682135,144360
2002-02-01,Pennsylvania,9541334,6211418,5864420,346998
2002-02-01,Tennessee,4427865,2878124,2719470,158654
2002-02-01,Texas,15675829,10655526,9995460,660066
2002-02-01,Utah,1642558,1171223,1108460,62763
2002-02-01,Vermont,481654,340842,328669,12173
2002-02-01,Virginia,5427008,3715839,3551649,164190
2002-02-01,Washington,4577007,3083538,2864747,218791
2002-02-01,Wisconsin,4154323,3014014,2849862,164152
2002-02-01,Wyoming,377686,268531,257812,10719
2002-03-01,Alabama,3399942,2107910,1982330,125580
2002-03-01,Alaska,449530,325267,302442,22825
2002-03-01,Arizona,4031755,2663980,2499239,164741
2002-03-01,Arkansas,2048658,1273099,1203623,69476
2002-03-01,California,25780233,17227144,16069886,1157258
2002-03-01,Colorado,3389916,2445306,2303570,141736
2002-03-01,Connecticut,2625538,1765261,1696249,69012
2002-03-01,Delaware,610535,419073,400804,18269
2002-03-01,Florida,12916606,8016518,7606306,410212
2002-03-01,Georgia,6314817,4317457,4086971,230486
2002-03-01,Hawaii,912658,602580,576317,26263
2002-03-01,Idaho,982583,684479,644545,39934
2002-03-01,Illinois,9448199,6383575,5967568,416007
2002-03-01,Indiana,4648125,3159593,2987734,171859
2002-03-01,Iowa,2244254,1626062,1561775,64287
2002-03-01,Kansas,2023880,1411086,1339444,71642
2002-03-01,Kentucky,3121497,1942129,1828895,113234
2002-03-01,Louisiana,3304766,2012432,1889767,122665
2002-03-01,Maine,1012390,675390,646342,29048
2002-03-01,Maryland,4090119,2872651,2729044,143607
2002-03-01,Massachusetts,4996735,3429354,3256605,172749
2002-03-01,Michigan,7606496,5047529,4727781,319748
2002-03-01,Minnesota,3810635,2863548,2730645,132903
2002-03-01,Mississippi,2109384,1289263,1204384,84879
2002-03-01,Missouri,4298928,2981929,2824193,157736
2002-03-01,Montana,697821,465070,443095,21975
2002-03-01,Nebraska,1296333,948270,913155,35115
2002-03-01,Nevada,1618698,1130577,1064062,66515
2002-03-01,Ohio,8695571,5827892,5490075,337817
2002-03-01,Oklahoma,2605665,1689328,1610915,78413
2002-03-01,Oregon,2708829,1828427,1686101,142326
2002-03-01,Pennsylvania,9543727,6217942,5869958,347984
2002-03-01,Tennessee,4430974,2883280,2726126,157154
2002-03-01,Texas,15697510,10674926,10006541,668385
2002-03-01,Utah,1645359,1173064,1108928,64136
2002-03-01,Vermont,481999,341559,329266,12293
2002-03-01,Virginia,5432738,3722814,3558238,164576
2002-03-01,Washington,4582078,3087034,2867218,219816
2002-03-01,Wisconsin,4157408,3012899,2848653,164246
2002-03-01,Wyoming,378036,268700,257864,10836
2002-04-01,Alabama,3400511,2107382,1981979,125403
2002-04-01,Alaska,450277,325811,302703,23108
2002-04-01,Arizona,4040671,2672076,2505719,166357
2002-04-01,Arkansas,2049502,1275392,1206255,69137
2002-04-01,California,25806595,17236951,16073530,1163421
2002-04-01,Colorado,3394409,2445804,2305382,140422
2002-04-01,Connecticut,2627024,1769952,1698245,71707
2002-04-01,Delaware,611183,418664,400248,18416
2002-04-01,Florida,12937202,8024970,7617735,407235
2002-04-01,Georgia,6324507,4325366,4093644,231722
2002-04-01,Hawaii,913296,601922,576688,25234
2002-04-01,Idaho,984072,684753,645116,39637
2002-04-01,Illinois,9451880,6368422,5949351,419071
2002-04-01,Indiana,4649772,3160170,2990511,169659
2002-04-01,Iowa,2244508,1629632,1564963,64669
2002-04-01,Kansas,2024833,1413886,1341873,72013
2002-04-01,Kentucky,3123099,1941430,1829467,111963
2002-04-01,Louisiana,3305599,2011560,1890066,121494
2002-04-01,Maine,1013225,676912,647467,29445
2002-04-01,Maryland,4094526,2875219,2733014,142205
2002-04-01,Massachusetts,4998907,3436229,3260976,175253
2002-04-01,Michigan,7609548,5041205,4723168,318037
2002-04-01,Minnesota,3813741,2866169,2733848,132321
2002-04-01,Mississippi,2109787,1288839,1204581,84258
2002-04-01,Missouri,4301583,2982422,2823829,158593
2002-04-01,Montana,698307,465289,443450,21839
2002-04-01,Nebraska,1296857,949620,914323,35297
2002-04-01,Nevada,1623098,1131648,1065636,66012
2002-04-01,Ohio,8698086,5823063,5482432,340631
2002-04-01,Oklahoma,2606960,1688588,1610736,77852
2002-04-01,Oregon,2712033,1830284,1690967,139317
2002-04-01,Pennsylvania,9546247,6223297,5876225,347072
2002-04-01,Tennessee,4434095,2888581,2734191,154390
2002-04-01,Texas,15719749,10695524,10020652,674872
2002-04-01,Utah,1648148,1175078,1109675,65403
2002-04-01,Vermont,482348,342300,329847,12453
2002-04-01,Virginia,5438518,3730064,3565303,164761
2002-04-01,Washington,4587299,3091399,2871449,219950
2002-04-01,Wisconsin,4160519,3011789,2848650,163139
2002-04-01,Wyoming,378392,268859,257984,10875
2002-05-01,Alabama,3401328,2108221,1982996,125225
2002-05-01,Alaska,451047,326413,303052,23361
2002-05-01,Arizona,4049916,2679893,2512557,167336
2002-05-01,Arkansas,2050547,1277481,1209000,68481
2002-05-01,California,25833940,17246156,16079713,1166443
2002-05-01,Colorado,3399138,2446512,2307558,138954
2002-05-01,Connecticut,2628719,1774362,1699923,74439
2002-05-01,Delaware,611867,418337,399979,18358
2002-05-01,Florida,12959162,8036185,7632061,404124
2002-05-01,Georgia,6334589,4333843,4101879,231964
2002-05-01,Hawaii,913889,601851,577294,24557
2002-05-01,Idaho,985659,685086,646021,39065
2002-05-01,Illinois,9456254,6353351,5933361,419990
2002-05-01,Indiana,4651908,3161568,2994729,166839
2002-05-01,Iowa,2245018,1632129,1567238,64891
2002-05-01,Kansas,2026012,1416809,1344642,72167
2002-05-01,Kentucky,3125031,1941560,1830478,111082
2002-05-01,Louisiana,3306659,2012044,1891573,120471
2002-05-01,Maine,1014188,678458,648669,29789
2002-05-01,Maryland,4099229,2877225,2737013,140212
2002-05-01,Massachusetts,5001592,3441058,3263768,177290
2002-05-01,Michigan,7613320,5037273,4721769,315504
2002-05-01,Minnesota,3817273,2869777,2738822,130955
2002-05-01,Mississippi,2110317,1288593,1205341,83252
2002-05-01,Missouri,4304730,2982808,2823997,158811
2002-05-01,Montana,698870,465503,443942,21561
2002-05-01,Nebraska,1297541,951090,915764,35326
2002-05-01,Nevada,1627566,1132733,1067427,65306
2002-05-01,Ohio,8701460,5820418,5479111,341307
2002-05-01,Oklahoma,2608481,1687674,1610573,77101
2002-05-01,Oregon,2715529,1832213,1695980,136233
2002-05-01,Pennsylvania,9549866,6227212,5882425,344787
2002-05-01,Tennessee,4437612,2894186,2743111,151075
2002-05-01,Texas,15742777,10717572,10037909,679663
2002-05-01,Utah,1651119,1177223,1110738,66485
2002-05-01,Vermont,482761,343007,330354,12653
2002-05-01,Virginia,5444702,3737322,3572609,164713
2002-05-01,Washington,4592891,3096484,2876853,219631
2002-05-01,Wisconsin,4164122,3011225,2849894,161331
2002-05-01,Wyoming,378808,269012,258203,10809
2002-06-01,Alabama,3402356,2110206,1985266,124940
2002-06-01,Alaska,451808,327004,303460,23544
2002-06-01,Arizona,4059426,2686901,2519224,167677
2002-06-01,Arkansas,2051705,1279123,1211468,67655
2002-06-01,California,25863088,17254392,16088050,1166342
2002-06-01,Colorado,3404075,2447907,2310088,137819
2002-06-01,Connecticut,2630600,1778355,1701245,77110
2002-06-01,Delaware,612606,417966,399841,18125
2002-06-01,Florida,12981925,8048829,7648435,400394
2002-06-01,Georgia,6344978,4342259,4111004,231255
2002-06-01,Hawaii,914553,602060,577963,24097
2002-06-01,Idaho,987341,685432,647086,38346
2002-06-01,Illinois,9461164,6339698,5920394,419304
2002-06-01,Indiana,4654304,3163193,2999422,163771
2002-06-01,Iowa,2245696,1633682,1568717,64965
2002-06-01,Kansas,2027326,1419829,1347595,72234
2002-06-01,Kentucky,3127066,1942475,1832009,110466
2002-06-01,Louisiana,3307869,2013274,1893725,119549
2002-06-01,Maine,1015204,679698,649682,30016
2002-06-01,Maryland,4104114,2878361,2740615,137746
2002-06-01,Massachusetts,5004538,3444134,3265227,178907
2002-06-01,Michigan,7617506,5034600,4722820,311780
2002-06-01,Minnesota,3821031,2874032,2744983,129049
2002-06-01,Mississippi,2111014,1288848,1206658,82190
2002-06-01,Missouri,4308070,2982883,2824655,158228
2002-06-01,Montana,699484,465763,444586,21177
2002-06-01,Nebraska,1298295,952567,917366,35201
2002-06-01,Nevada,1632156,1133856,1069391,64465
2002-06-01,Ohio,8705279,5820023,5479885,340138
2002-06-01,Oklahoma,2610169,1686526,1610231,76295
2002-06-01,Oregon,2719230,1834422,1700621,133801
2002-06-01,Pennsylvania,9554009,6229197,5887715,341482
2002-06-01,Tennessee,4441378,2900132,2752527,147605
2002-06-01,Texas,15766911,10739964,10057469,682495
2002-06-01,Utah,1654153,1179393,1112082,67311
2002-06-01,Vermont,483209,343619,330746,12873
2002-06-01,Virginia,5451225,3743911,3579785,164126
2002-06-01,Washington,4598753,3101726,2882720,219006
2002-06-01,Wisconsin,4167960,3011622,2852461,159161
2002-06-01,Wyoming,379237,269166,258506,10660
2002-07-01,Alabama,3403420,2112596,1987969,124627
2002-07-01,Alaska,452597,327506,303837,23669
2002-07-01,Arizona,4068974,2692591,2524962,167629
2002-07-01,Arkansas,2052905,1280081,1213231,66850
2002-07-01,California,25892172,17260607,16095366,1165241
2002-07-01,Colorado,3409041,2449523,2312334,137189
2002-07-01,Connecticut,2632445,1781679,1701951,79728
2002-07-01,Delaware,613315,417436,399636,17800
2002-07-01,Florida,13004706,8060559,7664361,396198
2002-07-01,Georgia,6355530,4349470,4119340,230130
2002-07-01,Hawaii,915205,602074,578420,23654
2002-07-01,Idaho,988987,685732,647998,37734
2002-07-01,Illinois,9466124,6327972,5910199,417773
2002-07-01,Indiana,4656712,3164269,3003252,161017
2002-07-01,Iowa,2246337,1634265,1569350,64915
2002-07-01,Kansas,2028625,1422571,1350263,72308
2002-07-01,Kentucky,3129155,1943823,1833625,110198
2002-07-01,Louisiana,3309155,2014218,1895402,118816
2002-07-01,Maine,1016191,680428,650251,30177
2002-07-01,Maryland,4109054,2878111,2742834,135277
2002-07-01,Massachusetts,5007522,3445684,3265298,180386
2002-07-01,Michigan,7621745,5031493,4724391,307102
2002-07-01,Minnesota,3824792,2877941,2750961,126980
2002-07-01,Mississippi,2111700,1289511,1208173,81338
2002-07-01,Missouri,4311449,2982468,2825178,157290
2002-07-01,Montana,700089,466129,445329,20800
2002-07-01,Nebraska,1299061,953908,918901,35007
2002-07-01,Nevada,1636758,1134916,1071236,63680
2002-07-01,Ohio,8709127,5820692,5482728,337964
2002-07-01,Oklahoma,2611859,1684995,1609314,75681
2002-07-01,Oregon,2722882,1836586,1704155,132431
2002-07-01,Pennsylvania,9558096,6228505,5889692,338813
2002-07-01,Tennessee,4445160,2905747,2761269,144478
2002-07-01,Texas,15791186,10760392,10076730,683662
2002-07-01,Utah,1657216,1181394,1113419,67975
2002-07-01,Vermont,483617,344083,330964,13119
2002-07-01,Virginia,5457742,3748794,3585682,163112
2002-07-01,Washington,4604606,3106198,2887777,218421
2002-07-01,Wisconsin,4171808,3012919,2855666,157253
2002-07-01,Wyoming,379662,269315,258805,10510
2002-08-01,Alabama,3405507,2114858,1990399,124459
2002-08-01,Alaska,453243,327961,304190,23771
2002-08-01,Arizona,4078506,2696958,2529718,167240
2002-08-01,Arkansas,2054532,1280510,1214201,66309
2002-08-01,California,25923440,17265303,16099903,1165400
2002-08-01,Colorado,3413275,2451231,2314156,137075
2002-08-01,Connecticut,2634571,1784019,1701698,82321
2002-08-01,Delaware,614168,416806,399339,17467
2002-08-01,Florida,13027230,8070560,7678422,392138
2002-08-01,Georgia,6365990,4355484,4126146,229338
2002-08-01,Hawaii,915763,601792,578604,23188
2002-08-01,Idaho,990626,686082,648680,37402
2002-08-01,Illinois,9471904,6318598,5902542,416056
2002-08-01,Indiana,4660120,3164621,3005770,158851
2002-08-01,Iowa,2247235,1633924,1569033,64891
2002-08-01,Kansas,2030028,1424813,1352395,72418
2002-08-01,Kentucky,3132038,1945275,1834920,110355
2002-08-01,Louisiana,3311148,2014494,1896156,118338
2002-08-01,Maine,1017263,680726,650354,30372
2002-08-01,Maryland,4113818,2876523,2743404,133119
2002-08-01,Massachusetts,5010165,3446164,3264164,182000
2002-08-01,Michigan,7626953,5027686,4725022,302664
2002-08-01,Minnesota,3828391,2880766,2755464,125302
2002-08-01,Mississippi,2112746,1290526,1209520,81006
2002-08-01,Missouri,4315054,2981884,2825233,156651
2002-08-01,Montana,700879,466655,446100,20555
2002-08-01,Nebraska,1299957,955197,920328,34869
2002-08-01,Nevada,1641510,1135935,1072869,63066
2002-08-01,Ohio,8714246,5822931,5486972,335959
2002-08-01,Oklahoma,2613541,1683619,1607957,75662
2002-08-01,Oregon,2726154,1838336,1706157,132179
2002-08-01,Pennsylvania,9563962,6224755,5886632,338123
2002-08-01,Tennessee,4449931,2910334,2768269,142065
2002-08-01,Texas,15815630,10778290,10093709,684581
2002-08-01,Utah,1660075,1183190,1114653,68537
2002-08-01,Vermont,484042,344417,331009,13408
2002-08-01,Virginia,5463319,3752059,3589982,162077
2002-08-01,Washington,4609900,3109557,2891346,218211
2002-08-01,Wisconsin,4175782,3015304,2858986,156318
2002-08-01,Wyoming,379950,269529,259072,10457
2002-09-01,Alabama,3407668,2116974,1992438,124536
2002-09-01,Alaska,453876,328484,304566,23918
2002-09-01,Arizona,4088189,2700112,2533571,166541
2002-09-01,Arkansas,2056241,1280684,1214407,66277
2002-09-01,California,25955547,17268697,16099890,1168807
2002-09-01,Colorado,3417582,2453132,2315596,137536
2002-09-01,Connecticut,2636738,1785478,1700557,84921
2002-09-01,Delaware,615047,416098,398862,17236
2002-09-01,Florida,13050162,8078773,7689746,389027
2002-09-01,Georgia,6376576,4360866,4131553,229313
2002-09-01,Hawaii,916404,601409,578670,22739
2002-09-01,Idaho,992340,686570,649216,37354
2002-09-01,Illinois,9477986,6311232,5896080,415152
2002-09-01,Indiana,4663649,3164383,3006927,157456
2002-09-01,Iowa,2248220,1632768,1567716,65052
2002-09-01,Kansas,2031501,1426508,1353983,72525
2002-09-01,Kentucky,3135036,1946797,1835666,111131
2002-09-01,Louisiana,3313261,2014574,1896307,118267
2002-09-01,Maine,1018360,680833,650081,30752
2002-09-01,Maryland,4118710,2874021,2742430,131591
2002-09-01,Massachusetts,5012887,3445655,3261712,183943
2002-09-01,Michigan,7632348,5024354,4723612,300742
2002-09-01,Minnesota,3832098,2882351,2757782,124569
2002-09-01,Mississippi,2113865,1291902,1210628,81274
2002-09-01,Missouri,4318745,2981296,2824655,156641
2002-09-01,Montana,701723,467314,446788,20526
2002-09-01,Nebraska,1300847,956546,921663,34883
2002-09-01,Nevada,1646297,1136979,1074275,62704
2002-09-01,Ohio,8719586,5827378,5491953,335425
2002-09-01,Oklahoma,2615302,1682961,1606327,76634
2002-09-01,Oregon,2729478,1839579,1706691,132888
2002-09-01,Pennsylvania,9570058,6217593,5877648,339945
2002-09-01,Tennessee,4454783,2913326,2772574,140752
2002-09-01,Texas,15840524,10794488,10106672,687816
2002-09-01,Utah,1662991,1184766,1115744,69022
2002-09-01,Vermont,484500,344668,330912,13756
2002-09-01,Virginia,5469003,3754158,3592628,161530
2002-09-01,Washington,4615349,3112187,2893420,218767
2002-09-01,Wisconsin,4179843,3018972,2862220,156752
2002-09-01,Wyoming,380242,269879,259292,10587
2002-10-01,Alabama,3409782,2118563,1993897,124666
2002-10-01,Alaska,454550,329033,304907,24126
2002-10-01,Arizona,4097842,2701676,2536063,165613
2002-10-01,Arkansas,2057929,1280542,1213757,66785
2002-10-01,California,25987483,17268118,16092890,1175228
2002-10-01,Colorado,3421889,2454819,2316185,138634
2002-10-01,Connecticut,2638916,1786092,1698628,87464
2002-10-01,Delaware,615913,415257,398035,17222
2002-10-01,Florida,13072974,8084293,7697494,386799
2002-10-01,Georgia,6387104,4365598,4135682,229916
2002-10-01,Hawaii,916970,601047,578693,22354
2002-10-01,Idaho,993976,687096,649596,37500
2002-10-01,Illinois,9483893,6304651,5888844,415807
2002-10-01,Indiana,4667145,3163767,3006965,156802
2002-10-01,Iowa,2249163,1630876,1565447,65429
2002-10-01,Kansas,2032959,1427543,1354925,72618
2002-10-01,Kentucky,3137960,1948234,1835707,112527
2002-10-01,Louisiana,3315312,2014905,1896063,118842
2002-10-01,Maine,1019471,680949,649562,31387
2002-10-01,Maryland,4123542,2870999,2739807,131192
2002-10-01,Massachusetts,5015587,3443173,3257011,186162
2002-10-01,Michigan,7637675,5021939,4719012,302927
2002-10-01,Minnesota,3835796,2882473,2757696,124777
2002-10-01,Mississippi,2114928,1293356,1211458,81898
2002-10-01,Missouri,4322412,2980257,2823047,157210
2002-10-01,Montana,702522,467923,447239,20684
2002-10-01,Nebraska,1301784,957799,922727,35072
2002-10-01,Nevada,1651061,1137876,1075294,62582
2002-10-01,Ohio,8724813,5833088,5495762,337326
2002-10-01,Oklahoma,2617031,1682784,1604244,78540
2002-10-01,Oregon,2732802,1840350,1706094,134256
2002-10-01,Pennsylvania,9576039,6206961,5862924,344037
2002-10-01,Tennessee,4459606,2914147,2773397,140750
2002-10-01,Texas,15865366,10808640,10114032,694608
2002-10-01,Utah,1665919,1185876,1116475,69401
2002-10-01,Vermont,484964,344833,330700,14133
2002-10-01,Virginia,5474685,3755197,3593456,161741
2002-10-01,Washington,4620749,3114211,2894005,220206
2002-10-01,Wisconsin,4183908,3023489,2865025,158464
2002-10-01,Wyoming,380549,270285,259390,10895
2002-11-01,Alabama,3411574,2119803,1995132,124671
2002-11-01,Alaska,455168,329561,305214,24347
2002-11-01,Arizona,4107099,2702200,2537727,164473
2002-11-01,Arkansas,2059408,1280124,1212489,67635
2002-11-01,California,26017694,17264788,16082472,1182316
2002-11-01,Colorado,3425994,2456738,2316466,140272
2002-11-01,Connecticut,2640838,1786347,1696550,89797
2002-11-01,Delaware,616748,414331,396891,17440
2002-11-01,Florida,13094247,8087760,7702971,384789
2002-11-01,Georgia,6397237,4370581,4139819,230762
2002-11-01,Hawaii,917617,600874,578794,22080
2002-11-01,Idaho,995570,687674,649955,37719
2002-11-01,Illinois,9489084,6299115,5881874,417241
2002-11-01,Indiana,4670256,3163560,3006919,156641
2002-11-01,Iowa,2249894,1628403,1562380,66023
2002-11-01,Kansas,2034195,1428217,1355511,72706
2002-11-01,Kentucky,3140683,1949751,1835512,114239
2002-11-01,Louisiana,3317084,2016048,1895925,120123
2002-11-01,Maine,1020485,681308,649075,32233
2002-11-01,Maryland,4128063,2868616,2736752,131864
2002-11-01,Massachusetts,5017859,3438660,3250328,188332
2002-11-01,Michigan,7642325,5020648,4711670,308978
2002-11-01,Minnesota,3839158,2881948,2756295,125653
2002-11-01,Mississippi,2115799,1294795,1212275,82520
2002-11-01,Missouri,4325706,2978936,2820955,157981
2002-11-01,Montana,703286,468428,447486,20942
2002-11-01,Nebraska,1302594,959078,923669,35409
2002-11-01,Nevada,1655768,1138723,1076155,62568
2002-11-01,Ohio,8729243,5840339,5498811,341528
2002-11-01,Oklahoma,2618501,1682745,1601941,80804
2002-11-01,Oregon,2735886,1840953,1704920,136033
2002-11-01,Pennsylvania,9580992,6194252,5845199,349053
2002-11-01,Tennessee,4464120,2913309,2771330,141979
2002-11-01,Texas,15889181,10822271,10118547,703724
2002-11-01,Utah,1668693,1186629,1117065,69564
2002-11-01,Vermont,485392,344987,330485,14502
2002-11-01,Virginia,5479937,3756070,3593538,162532
2002-11-01,Washington,4625771,3115768,2893803,221965
2002-11-01,Wisconsin,4187575,3028698,2867607,161091
2002-11-01,Wyoming,380830,270700,259405,11295
2002-12-01,Alabama,3412910,2120743,1996169,124574
2002-12-01,Alaska,455741,330077,305512,24565
2002-12-01,Arizona,4115824,2702525,2539424,163101
2002-12-01,Arkansas,2060635,1279487,1210881,68606
2002-12-01,California,26044606,17259702,16072079,1187623
2002-12-01,Colorado,3429650,2459550,2317145,142405
2002-12-01,Connecticut,2642420,1786393,1694632,91761
2002-12-01,Delaware,617498,413430,395638,17792
2002-12-01,Florida,13113801,8089532,7707195,382337
2002-12-01,Georgia,6406507,4376391,4144964,231427
2002-12-01,Hawaii,918142,600976,579036,21940
2002-12-01,Idaho,997058,688330,650391,37939
2002-12-01,Illinois,9493053,6293961,5876027,417934
2002-12-01,Indiana,4672749,3163872,3007178,156694
2002-12-01,Iowa,2250292,1625147,1558284,66863
2002-12-01,Kansas,2035183,1428762,1355925,72837
2002-12-01,Kentucky,3142981,1951266,1835308,115958
2002-12-01,Louisiana,3318446,2017967,1896200,121767
2002-12-01,Maine,1021339,681961,648763,33198
2002-12-01,Maryland,4132076,2867840,2734613,133227
2002-12-01,Massachusetts,5019466,3432610,3242442,190168
2002-12-01,Michigan,7646000,5020290,4702396,317894
2002-12-01,Minnesota,3842000,2881762,2754830,126932
2002-12-01,Mississippi,2116412,1295935,1213122,82813
2002-12-01,Missouri,4328401,2977790,2818837,158953
2002-12-01,Montana,703932,468847,447631,21216
2002-12-01,Nebraska,1303218,960489,924626,35863
2002-12-01,Nevada,1660229,1139620,1077130,62490
2002-12-01,Ohio,8732536,5848913,5501775,347138
2002-12-01,Oklahoma,2619600,1682720,1599750,82970
2002-12-01,Oregon,2738585,1841458,1703299,138159
2002-12-01,Pennsylvania,9584675,6180604,5827257,353347
2002-12-01,Tennessee,4468035,2911657,2767381,144276
2002-12-01,Texas,15910931,10836094,10123165,712929
2002-12-01,Utah,1671298,1187177,1117801,69376
2002-12-01,Vermont,485718,345139,330307,14832
2002-12-01,Virginia,5484530,3757075,3593715,163360
2002-12-01,Washington,4630181,3116864,2893327,223537
2002-12-01,Wisconsin,4190712,3033987,2869859,164128
2002-12-01,Wyoming,381063,271097,259410,11687
2003-01-01,Alabama,3414396,2121823,1997102,124721
2003-01-01,Alaska,456362,330628,305820,24808
2003-01-01,Arizona,4124592,2703900,2542108,161792
2003-01-01,Arkansas,2061880,1278953,1209257,69696
2003-01-01,California,26072135,17257209,16065489,1191720
2003-01-01,Colorado,3433355,2463721,2318615,145106
2003-01-01,Connecticut,2644003,1786460,1693003,93457
2003-01-01,Delaware,618270,412823,394645,18178
2003-01-01,Florida,13133514,8090994,7711130,379864
2003-01-01,Georgia,6415943,4383758,4151643,232115
2003-01-01,Hawaii,918710,601347,579331,22016
2003-01-01,Idaho,998526,689165,650994,38171
2003-01-01,Illinois,9497119,6290665,5872615,418050
2003-01-01,Indiana,4675288,3165387,3008223,157164
2003-01-01,Iowa,2250711,1621262,1553269,67993
2003-01-01,Kansas,2036212,1429715,1356442,73273
2003-01-01,Kentucky,3145239,1953079,1835364,117715
2003-01-01,Louisiana,3319932,2020780,1897054,123726
2003-01-01,Maine,1022204,682795,648641,34154
2003-01-01,Maryland,4136125,2869408,2734262,135146
2003-01-01,Massachusetts,5021081,3426342,3234426,191916
2003-01-01,Michigan,7649678,5022005,4693211,328794
2003-01-01,Minnesota,3844875,2883046,2754332,128714
2003-01-01,Mississippi,2117100,1296920,1214017,82903
2003-01-01,Missouri,4331112,2977841,2817329,160512
2003-01-01,Montana,704588,469189,447718,21471
2003-01-01,Nebraska,1303840,962142,925697,36445
2003-01-01,Nevada,1664718,1140824,1078469,62355
2003-01-01,Ohio,8735841,5859072,5505111,353961
2003-01-01,Oklahoma,2620758,1683263,1598051,85212
2003-01-01,Oregon,2741263,1842347,1701450,140897
2003-01-01,Pennsylvania,9588389,6168386,5812280,356106
2003-01-01,Tennessee,4471905,2910775,2763203,147572
2003-01-01,Texas,15933096,10852761,10130478,722283
2003-01-01,Utah,1673900,1187935,1118968,68967
2003-01-01,Vermont,486043,345314,330207,15107
2003-01-01,Virginia,5489117,3758558,3594457,164101
2003-01-01,Washington,4634614,3118244,2893139,225105
2003-01-01,Wisconsin,4193845,3039340,2871983,167357
2003-01-01,Wyoming,381254,271487,259482,12005
2003-02-01,Alabama,3414778,2123538,1998284,125254
2003-02-01,Alaska,456807,331210,306142,25068
2003-02-01,Arizona,4132450,2707087,2546216,160871
2003-02-01,Arkansas,2062580,1278812,1207914,70898
2003-02-01,California,26094053,17260877,16065354,1195523
2003-02-01,Colorado,3436189,2469409,2321211,148198
2003-02-01,Connecticut,2644968,1786818,1691836,94982
2003-02-01,Delaware,618854,412703,394190,18513
2003-02-01,Florida,13150127,8093533,7715910,377623
2003-02-01,Georgia,6423477,4392942,4159791,233151
2003-02-01,Hawaii,918969,601953,579595,22358
2003-02-01,Idaho,999754,690153,651733,38420
2003-02-01,Illinois,9498837,6291417,5873456,417961
2003-02-01,Indiana,4676608,3168763,3010266,158497
2003-02-01,Iowa,2250583,1617184,1547884,69300
2003-02-01,Kansas,2036703,1431658,1357353,74305
2003-02-01,Kentucky,3146771,1955720,1836063,119657
2003-02-01,Louisiana,3320353,2024386,1898235,126151
2003-02-01,Maine,1022832,683619,648651,34968
2003-02-01,Maryland,4139046,2873220,2735901,137319
2003-02-01,Massachusetts,5021549,3421546,3227814,193732
2003-02-01,Michigan,7651421,5026534,4686189,340345
2003-02-01,Minnesota,3846805,2886146,2755130,131016
2003-02-01,Mississippi,2117143,1298228,1215235,82993
2003-02-01,Missouri,4332750,2979689,2817042,162647
2003-02-01,Montana,705108,469389,447712,21677
2003-02-01,Nebraska,1304155,963983,926878,37105
2003-02-01,Nevada,1668826,1142496,1080294,62202
2003-02-01,Ohio,8737003,5870822,5509218,361604
2003-02-01,Oklahoma,2621249,1684854,1597145,87709
2003-02-01,Oregon,2743343,1843851,1699566,144285
2003-02-01,Pennsylvania,9589850,6159680,5802424,357256
2003-02-01,Tennessee,4474672,2911211,2759640,151571
2003-02-01,Texas,15951655,10873455,10141790,731665
2003-02-01,Utah,1676103,1189174,1120709,68465
2003-02-01,Vermont,486328,345555,330229,15326
2003-02-01,Virginia,5492366,3760778,3595995,164783
2003-02-01,Washington,4637971,3120445,2893714,226731
2003-02-01,Wisconsin,4195995,3044768,2874343,170425
2003-02-01,Wyoming,381432,271871,259674,12197
2003-03-01,Alabama,3415165,2125759,1999675,126084
2003-03-01,Alaska,457242,331713,306393,25320
2003-03-01,Arizona,4140103,2711777,2551211,160566
2003-03-01,Arkansas,2063221,1279094,1206946,72148
2003-03-01,California,26113712,17269010,16069800,1199210
2003-03-01,Colorado,3438934,2476117,2324818,151299
2003-03-01,Connecticut,2645875,1787321,1690969,96352
2003-03-01,Delaware,619442,413055,394290,18765
2003-03-01,Florida,13165982,8096655,7721190,375465
2003-03-01,Georgia,6430745,4402771,4168351,234420
2003-03-01,Hawaii,919140,602598,579724,22874
2003-03-01,Idaho,1000990,691062,652351,38711
2003-03-01,Illinois,9500180,6296371,5877884,418487
2003-03-01,Indiana,4677936,3173810,3012924,160886
2003-03-01,Iowa,2250457,1613222,1542602,70620
2003-03-01,Kansas,2037190,1434427,1358496,75931
2003-03-01,Kentucky,3148265,1959031,1837422,121609
2003-03-01,Louisiana,3320700,2027988,1898999,128989
2003-03-01,Maine,1023474,684207,648663,35544
2003-03-01,Maryland,4141769,2877933,2738709,139224
2003-03-01,Massachusetts,5021914,3418751,3223170,195581
2003-03-01,Michigan,7653059,5032775,4681665,351110
2003-03-01,Minnesota,3848728,2890205,2756587,133618
2003-03-01,Mississippi,2117085,1300092,1216916,83176
2003-03-01,Missouri,4334368,2982773,2817521,165252
2003-03-01,Montana,705616,469459,447617,21842
2003-03-01,Nebraska,1304463,965709,927963,37746
2003-03-01,Nevada,1672836,1144406,1082404,62002
2003-03-01,Ohio,8738069,5881930,5513335,368595
2003-03-01,Oklahoma,2621697,1686997,1596735,90262
2003-03-01,Oregon,2745383,1845493,1697569,147924
2003-03-01,Pennsylvania,9591186,6154613,5797686,356927
2003-03-01,Tennessee,4477375,2911978,2756243,155735
2003-03-01,Texas,15968829,10895560,10155181,740379
2003-03-01,Utah,1678267,1190721,1122826,67895
2003-03-01,Vermont,486559,345800,330347,15453
2003-03-01,Virginia,5495405,3763269,3598178,165091
2003-03-01,Washington,4641204,3123196,2894938,228258
2003-03-01,Wisconsin,4198093,3049303,2876330,172973
2003-03-01,Wyoming,381562,272209,259961,12248
2003-04-01,Alabama,3415998,2127689,2000568,127121
2003-04-01,Alaska,457783,332007,306473,25534
2003-04-01,Arizona,4148283,2717061,2556062,160999
2003-04-01,Arkansas,2064161,1279520,1206122,73398
2003-04-01,California,26137633,17276048,16072953,1203095
2003-04-01,Colorado,3442163,2482465,2328555,153910
2003-04-01,Connecticut,2647132,1787410,1689813,97597
2003-04-01,Delaware,620089,413703,394764,18939
2003-04-01,Florida,13183724,8099233,7725653,373580
2003-04-01,Georgia,6438979,4411122,4175537,235585
2003-04-01,Hawaii,919533,603039,579580,23459
2003-04-01,Idaho,1002322,691574,652536,39038
2003-04-01,Illinois,9502880,6303732,5882376,421356
2003-04-01,Indiana,4679781,3178702,3014768,163934
2003-04-01,Iowa,2250596,1609268,1537462,71806
2003-04-01,Kansas,2037898,1437328,1359347,77981
2003-04-01,Kentucky,3150164,1962327,1838964,123363
2003-04-01,Louisiana,3321512,2030239,1898379,131860
2003-04-01,Maine,1024226,684459,648585,35874
2003-04-01,Maryland,4145133,2881713,2741220,140493
2003-04-01,Massachusetts,5022946,3417530,3220113,197417
2003-04-01,Michigan,7655628,5038479,4678151,360328
2003-04-01,Minnesota,3851087,2893808,2757485,136323
2003-04-01,Mississippi,2117354,1302002,1218670,83332
2003-04-01,Missouri,4336500,2985771,2817464,168307
2003-04-01,Montana,706169,469443,447423,22020
2003-04-01,Nebraska,1304918,966889,928577,38312
2003-04-01,Nevada,1677090,1146247,1084395,61852
2003-04-01,Ohio,8740208,5888502,5514713,373789
2003-04-01,Oklahoma,2622439,1688823,1596225,92598
2003-04-01,Oregon,2747730,1846465,1695149,151316
2003-04-01,Pennsylvania,9593671,6151610,5795712,355898
2003-04-01,Tennessee,4480603,2911558,2751937,159621
2003-04-01,Texas,15988591,10914382,10166243,748139
2003-04-01,Utah,1680654,1192248,1124891,67357
2003-04-01,Vermont,486858,345952,330449,15503
2003-04-01,Virginia,5499170,3765173,3600147,165026
2003-04-01,Washington,4645066,3125925,2896270,229655
2003-04-01,Wisconsin,4200667,3051560,2876683,174877
2003-04-01,Wyoming,381725,272451,260258,12193
2003-05-01,Alabama,3417808,2128612,2000426,128186
2003-05-01,Alaska,458416,332068,306377,25691
2003-05-01,Arizona,4157421,2722263,2560450,161813
2003-05-01,Arkansas,2065680,1279954,1205338,74616
2003-05-01,California,26166389,17277573,16070128,1207445
2003-05-01,Colorado,3446297,2487392,2331724,155668
2003-05-01,Connecticut,2649006,1786680,1687977,98703
2003-05-01,Delaware,620936,414471,395441,19030
2003-05-01,Florida,13204215,8101013,7729028,371985
2003-05-01,Georgia,6449263,4416278,4180089,236189
2003-05-01,Hawaii,920043,603185,579162,24023
2003-05-01,Idaho,1003977,691579,652227,39352
2003-05-01,Illinois,9508070,6310771,5884178,426593
2003-05-01,Indiana,4683141,3181578,3014778,166800
2003-05-01,Iowa,2251443,1605585,1532841,72744
2003-05-01,Kansas,2039274,1439617,1359507,80110
2003-05-01,Kentucky,3153011,1965019,1840231,124788
2003-05-01,Louisiana,3323414,2030426,1896284,134142
2003-05-01,Maine,1025280,684413,648376,36037
2003-05-01,Maryland,4149472,2883328,2742266,141062
2003-05-01,Massachusetts,5025332,3417015,3217898,199117
2003-05-01,Michigan,7660435,5041951,4673980,367971
2003-05-01,Minnesota,3854699,2895878,2756921,138957
2003-05-01,Mississippi,2118291,1303461,1220150,83311
2003-05-01,Missouri,4339886,2987377,2815900,171477
2003-05-01,Montana,706947,469424,447206,22218
2003-05-01,Nebraska,1305813,967308,928510,38798
2003-05-01,Nevada,1681640,1147822,1086007,61815
2003-05-01,Ohio,8744855,5887473,5511232,376241
2003-05-01,Oklahoma,2623999,1689767,1595331,94436
2003-05-01,Oregon,2750824,1846543,1692712,153831
2003-05-01,Pennsylvania,9598714,6149152,5794052,355100
2003-05-01,Tennessee,4485189,2909176,2746286,162890
2003-05-01,Texas,16012098,10925861,10171387,754474
2003-05-01,Utah,1683758,1193559,1126613,66946
2003-05-01,Vermont,487311,345974,330456,15518
2003-05-01,Virginia,5504445,3766108,3601264,164844
2003-05-01,Washington,4650109,3128353,2897598,230755
2003-05-01,Wisconsin,4204541,3050805,2874680,176125
2003-05-01,Wyoming,382030,272567,260498,12069
2003-06-01,Alabama,3419291,2128804,1999701,129103
2003-06-01,Alaska,459028,332043,306239,25804
2003-06-01,Arizona,4166328,2727006,2564885,162121
2003-06-01,Arkansas,2066999,1280646,1204963,75683
2003-06-01,California,26194176,17275195,16063917,1211278
2003-06-01,Colorado,3450142,2491025,2334532,156493
2003-06-01,Connecticut,2650723,1785544,1685978,99566
2003-06-01,Delaware,621700,415324,396290,19034
2003-06-01,Florida,13224481,8104217,7734089,370128
2003-06-01,Georgia,6458596,4418916,4183266,235650
2003-06-01,Hawaii,920534,603222,578749,24473
2003-06-01,Idaho,1005541,691330,651775,39555
2003-06-01,Illinois,9512364,6316222,5883562,432660
2003-06-01,Indiana,4685927,3181931,3013693,168238
2003-06-01,Iowa,2252059,1602990,1529681,73309
2003-06-01,Kansas,2040395,1441198,1359313,81885
2003-06-01,Kentucky,3155471,1967061,1841327,125734
2003-06-01,Louisiana,3324821,2028933,1893949,134984
2003-06-01,Maine,1026241,684333,648247,36086
2003-06-01,Maryland,4153573,2883042,2742191,140851
2003-06-01,Massachusetts,5027336,3417145,3216757,200388
2003-06-01,Michigan,7664493,5043417,4669927,373490
2003-06-01,Minnesota,3857860,2896560,2755275,141285
2003-06-01,Mississippi,2118933,1304538,1221716,82822
2003-06-01,Missouri,4342876,2987369,2813329,174040
2003-06-01,Montana,707670,469560,447142,22418
2003-06-01,Nebraska,1306572,967242,928079,39163
2003-06-01,Nevada,1686175,1149241,1087432,61809
2003-06-01,Ohio,8748623,5879773,5504397,375376
2003-06-01,Oklahoma,2625260,1689877,1594367,95510
2003-06-01,Oregon,2753736,1846252,1691406,154846
2003-06-01,Pennsylvania,9603140,6147708,5793050,354658
2003-06-01,Tennessee,4489233,2905614,2740213,165401
2003-06-01,Texas,16034567,10929937,10172062,757875
2003-06-01,Utah,1686441,1194843,1128161,66682
2003-06-01,Vermont,487704,345951,330455,15496
2003-06-01,Virginia,5509213,3767138,3602525,164613
2003-06-01,Washington,4654799,3131155,2899925,231230
2003-06-01,Wisconsin,4208041,3048023,2871404,176619
2003-06-01,Wyoming,382297,272638,260714,11924
2003-07-01,Alabama,3421104,2128750,1999284,129466
2003-07-01,Alaska,459663,332097,306247,25850
2003-07-01,Arizona,4175564,2731033,2569956,161077
2003-07-01,Arkansas,2068537,1281653,1205346,76307
2003-07-01,California,26223362,17270209,16059225,1210984
2003-07-01,Colorado,3454238,2493863,2337595,156268
2003-07-01,Connecticut,2652706,1784434,1684501,99933
2003-07-01,Delaware,622538,416187,397233,18954
2003-07-01,Florida,13245749,8110290,7743475,366815
2003-07-01,Georgia,6468625,4420118,4186992,233126
2003-07-01,Hawaii,921097,603389,578677,24712
2003-07-01,Idaho,1007178,691170,651690,39480
2003-07-01,Illinois,9517498,6319227,5881948,437279
2003-07-01,Indiana,4689150,3184984,3012381,172603
2003-07-01,Iowa,2252879,1601794,1528425,73369
2003-07-01,Kansas,2041713,1442340,1359351,82989
2003-07-01,Kentucky,3158261,1968616,1842812,125804
2003-07-01,Louisiana,3326586,2026467,1892790,133677
2003-07-01,Maine,1027304,684502,648501,36001
2003-07-01,Maryland,4157985,2881933,2742022,139911
2003-07-01,Massachusetts,5029743,3417448,3216813,200635
2003-07-01,Michigan,7669272,5042857,4667405,375452
2003-07-01,Minnesota,3861413,2896186,2753315,142871
2003-07-01,Mississippi,2119791,1305402,1223833,81569
2003-07-01,Missouri,4346246,2986021,2810931,175090
2003-07-01,Montana,708447,469905,447344,22561
2003-07-01,Nebraska,1307432,967005,927760,39245
2003-07-01,Nevada,1690819,1150665,1089097,61568
2003-07-01,Ohio,8753223,5868132,5496831,371301
2003-07-01,Oklahoma,2626741,1689067,1593599,95468
2003-07-01,Oregon,2756849,1846103,1692219,153884
2003-07-01,Pennsylvania,9608391,6147794,5794429,353365
2003-07-01,Tennessee,4493757,2901590,2734779,166811
2003-07-01,Texas,16058127,10927994,10172127,755867
2003-07-01,Utah,1689284,1196359,1129956,66403
2003-07-01,Vermont,488147,346000,330591,15409
2003-07-01,Virginia,5514506,3769197,3605103,164094
2003-07-01,Washington,4659866,3134825,2904280,230545
2003-07-01,Wisconsin,4211892,3044763,2868700,176063
2003-07-01,Wyoming,382570,272733,260963,11770
2003-08-01,Alabama,3423238,2129017,1999855,129162
2003-08-01,Alaska,460685,332332,306517,25815
2003-08-01,Arizona,4186779,2734633,2575892,158741
2003-08-01,Arkansas,2070283,1282903,1206566,76337
2003-08-01,California,26250052,17265087,16060723,1204364
2003-08-01,Colorado,3457413,2496348,2341278,155070
2003-08-01,Connecticut,2654002,1783860,1684158,99702
2003-08-01,Delaware,623435,416949,398144,18805
2003-08-01,Florida,13274309,8119870,7758518,361352
2003-08-01,Georgia,6479064,4420604,4192012,228592
2003-08-01,Hawaii,922997,603776,579109,24667
2003-08-01,Idaho,1008996,691271,652165,39106
2003-08-01,Illinois,9521732,6319651,5881117,438534
2003-08-01,Indiana,4691592,3185326,3011148,174178
2003-08-01,Iowa,2253922,1601957,1529011,72946
2003-08-01,Kansas,2042694,1443351,1360039,83312
2003-08-01,Kentucky,3159839,1969986,1845195,124791
2003-08-01,Louisiana,3327995,2023769,1893321,130448
2003-08-01,Maine,1028102,684986,649213,35773
2003-08-01,Maryland,4162588,2881078,2742425,138653
2003-08-01,Massachusetts,5031325,3417555,3217956,199599
2003-08-01,Michigan,7673132,5040339,4667414,372925
2003-08-01,Minnesota,3864387,2895313,2751827,143486
2003-08-01,Mississippi,2121239,1306240,1226606,79634
2003-08-01,Missouri,4349981,2983820,2809610,174210
2003-08-01,Montana,709324,470428,447793,22635
2003-08-01,Nebraska,1308155,966945,927921,39024
2003-08-01,Nevada,1696711,1152200,1091261,60939
2003-08-01,Ohio,8756563,5854949,5489480,365469
2003-08-01,Oklahoma,2627866,1687374,1593130,94244
2003-08-01,Oregon,2759073,1846248,1694882,151366
2003-08-01,Pennsylvania,9612804,6149847,5799235,350612
2003-08-01,Tennessee,4497989,2897894,2731083,166811
2003-08-01,Texas,16081863,10922719,10174868,747851
2003-08-01,Utah,1692910,1198297,1132248,66049
2003-08-01,Vermont,488487,346211,330950,15261
2003-08-01,Virginia,5523829,3772572,3609338,163234
2003-08-01,Washington,4667040,3139210,2910556,228654
2003-08-01,Wisconsin,4215263,3042098,2867777,174321
2003-08-01,Wyoming,382889,272882,261257,11625
2003-09-01,Alabama,3425643,2129622,2001329,128293
2003-09-01,Alaska,461755,332691,306977,25714
2003-09-01,Arizona,4198248,2738684,2583001,155683
2003-09-01,Arkansas,2072182,1284302,1208502,75800
2003-09-01,California,26278279,17263667,16072530,1191137
2003-09-01,Colorado,3460845,2499159,2345933,153226
2003-09-01,Connecticut,2655410,1784048,1685164,98884
2003-09-01,Delaware,624382,417632,399074,18558
2003-09-01,Florida,13303522,8133676,7779744,353932
2003-09-01,Georgia,6490033,4421083,4198374,222709
2003-09-01,Hawaii,924992,604305,579989,24316
2003-09-01,Idaho,1010917,691656,653166,38490
2003-09-01,Illinois,9526623,6318480,5883328,435152
2003-09-01,Indiana,4694387,3183267,3009839,173428
2003-09-01,Iowa,2255124,1603110,1530971,72139
2003-09-01,Kansas,2043838,1444510,1361564,82946
2003-09-01,Kentucky,3161670,1970945,1848250,122695
2003-09-01,Louisiana,3329678,2021343,1895184,126159
2003-09-01,Maine,1028984,685706,650325,35381
2003-09-01,Maryland,4167436,2881086,2743719,137367
2003-09-01,Massachusetts,5033162,3417557,3220236,197321
2003-09-01,Michigan,7677527,5036588,4670668,365920
2003-09-01,Minnesota,3867659,2894312,2751315,142997
2003-09-01,Mississippi,2122873,1307127,1229625,77502
2003-09-01,Missouri,4354009,2981706,2809905,171801
2003-09-01,Montana,710264,471079,448428,22651
2003-09-01,Nebraska,1308971,967363,928751,38612
2003-09-01,Nevada,1702703,1153973,1094058,59915
2003-09-01,Ohio,8760450,5842700,5483261,359439
2003-09-01,Oklahoma,2629174,1685365,1593198,92167
2003-09-01,Oregon,2761466,1846243,1698110,148133
2003-09-01,Pennsylvania,9617686,6154445,5807656,346789
2003-09-01,Tennessee,4502551,2895997,2730811,165186
2003-09-01,Texas,16106743,10917190,10182968,734222
2003-09-01,Utah,1696697,1200793,1135187,65606
2003-09-01,Vermont,488848,346597,331542,15055
2003-09-01,Virginia,5533516,3777038,3615047,161991
2003-09-01,Washington,4674477,3143660,2917929,225731
2003-09-01,Wisconsin,4218887,3040587,2869153,171434
2003-09-01,Wyoming,383278,273101,261603,11498
2003-10-01,Alabama,3428231,2130528,2003261,127267
2003-10-01,Alaska,462857,333167,307559,25608
2003-10-01,Arizona,4209900,2744026,2591421,152605
2003-10-01,Arkansas,2074201,1285880,1210857,75023
2003-10-01,California,26307573,17269193,16094450,1174743
2003-10-01,Colorado,3464444,2502946,2351616,151330
2003-10-01,Connecticut,2656933,1784796,1687054,97742
2003-10-01,Delaware,625360,418372,400154,18218
2003-10-01,Florida,13333328,8151977,7805958,346019
2003-10-01,Georgia,6501406,4422206,4205499,216707
2003-10-01,Hawaii,926990,604988,581186,23802
2003-10-01,Idaho,1012861,692353,654562,37791
2003-10-01,Illinois,9532034,6317462,5889487,427975
2003-10-01,Indiana,4697419,3179816,3008157,171659
2003-10-01,Iowa,2256451,1604550,1533278,71272
2003-10-01,Kansas,2045110,1446147,1363822,82325
2003-10-01,Kentucky,3163657,1971376,1851332,120044
2003-10-01,Louisiana,3331606,2019694,1897863,121831
2003-10-01,Maine,1029897,686502,651594,34908
2003-10-01,Maryland,4172517,2882205,2745964,136241
2003-10-01,Massachusetts,5035257,3418074,3223709,194365
2003-10-01,Michigan,7682318,5033675,4676707,356968
2003-10-01,Minnesota,3871115,2894068,2751990,142078
2003-10-01,Mississippi,2124659,1308109,1232402,75707
2003-10-01,Missouri,4358264,2980658,2811647,169011
2003-10-01,Montana,711223,471769,449135,22634
2003-10-01,Nebraska,1309858,968311,930113,38198
2003-10-01,Nevada,1708723,1156108,1097432,58676
2003-10-01,Ohio,8764783,5834868,5479949,354919
2003-10-01,Oklahoma,2630617,1683879,1593970,89909
2003-10-01,Oregon,2763994,1846070,1700683,145387
2003-10-01,Pennsylvania,9623058,6161444,5818505,342939
2003-10-01,Tennessee,4507358,2897192,2734732,162460
2003-10-01,Texas,16132392,10914620,10196142,718478
2003-10-01,Utah,1700614,1203895,1138743,65152
2003-10-01,Vermont,489284,347093,332278,14815
2003-10-01,Virginia,5543519,3782228,3621422,160806
2003-10-01,Washington,4682139,3148255,2925796,222459
2003-10-01,Wisconsin,4222784,3040588,2872503,168085
2003-10-01,Wyoming,383660,273397,261989,11408
2003-11-01,Alabama,3430170,2131842,2005331,126511
2003-11-01,Alaska,463911,333763,308198,25565
2003-11-01,Arizona,4220869,2750731,2600436,150295
2003-11-01,Arkansas,2075835,1287593,1213244,74349
2003-11-01,California,26333470,17281265,16121723,1159542
2003-11-01,Colorado,3467548,2507509,2357816,149693
2003-11-01,Connecticut,2658035,1785439,1688882,96557
2003-11-01,Delaware,626250,419202,401340,17862
2003-11-01,Florida,13360573,8174013,7834864,339149
2003-11-01,Georgia,6511724,4423796,4212058,211738
2003-11-01,Hawaii,928979,605792,582527,23265
2003-11-01,Idaho,1014648,693226,656127,37099
2003-11-01,Illinois,9535761,6317719,5898467,419252
2003-11-01,Indiana,4699675,3176445,3006203,170242
2003-11-01,Iowa,2257338,1605690,1535107,70583
2003-11-01,Kansas,2045976,1448307,1366448,81859
2003-11-01,Kentucky,3165112,1971533,1853982,117551
2003-11-01,Louisiana,3332888,2019200,1900665,118535
2003-11-01,Maine,1030670,687101,652696,34405
2003-11-01,Maryland,4176911,2883747,2748357,135390
2003-11-01,Massachusetts,5036488,3419070,3227750,191320
2003-11-01,Michigan,7685770,5032945,4684308,348637
2003-11-01,Minnesota,3873956,2894698,2753577,141121
2003-11-01,Mississippi,2126027,1309185,1234681,74504
2003-11-01,Missouri,4361784,2980796,2813972,166824
2003-11-01,Montana,712076,472455,449865,22590
2003-11-01,Nebraska,1310533,969517,931612,37905
2003-11-01,Nevada,1714576,1158519,1101069,57450
2003-11-01,Ohio,8767557,5832832,5479600,353232
2003-11-01,Oklahoma,2631551,1683396,1595323,88073
2003-11-01,Oregon,2766049,1845891,1702166,143725
2003-11-01,Pennsylvania,9626595,6169696,5829763,339933
2003-11-01,Tennessee,4511411,2901005,2741593,159412
2003-11-01,Texas,16155874,10916509,10211768,704741
2003-11-01,Utah,1704232,1207415,1142603,64812
2003-11-01,Vermont,489616,347579,333022,14557
2003-11-01,Virginia,5552661,3787379,3627313,160066
2003-11-01,Washington,4689061,3153213,2933779,219434
2003-11-01,Wisconsin,4225924,3041626,2876787,164839
2003-11-01,Wyoming,383993,273715,262374,11341
2003-12-01,Alabama,3431807,2133454,2007337,126117
2003-12-01,Alaska,464858,334331,308764,25567
2003-12-01,Arizona,4231303,2757982,2608899,149083
2003-12-01,Arkansas,2077275,1289246,1215325,73921
2003-12-01,California,26356013,17296238,16148787,1147451
2003-12-01,Colorado,3470280,2512316,2364038,148278
2003-12-01,Connecticut,2658866,1785366,1689903,95463
2003-12-01,Delaware,627048,419970,402384,17586
2003-12-01,Florida,13386234,8198317,7864381,333936
2003-12-01,Georgia,6521486,4425357,4216858,208499
2003-12-01,Hawaii,930848,606630,583854,22776
2003-12-01,Idaho,1016340,694026,657598,36428
2003-12-01,Illinois,9538602,6320242,5908710,411532
2003-12-01,Indiana,4701502,3173945,3003831,170114
2003-12-01,Iowa,2258018,1606085,1535920,70165
2003-12-01,Kansas,2046639,1450811,1369067,81744
2003-12-01,Kentucky,3166269,1971526,1855980,115546
2003-12-01,Louisiana,3333925,2019717,1902785,116932
2003-12-01,Maine,1031313,687266,653415,33851
2003-12-01,Maryland,4180924,2884706,2749938,134768
2003-12-01,Massachusetts,5037233,3419585,3231161,188424
2003-12-01,Michigan,7688514,5034154,4691877,342277
2003-12-01,Minnesota,3876409,2895470,2755484,139986
2003-12-01,Mississippi,2127213,1310365,1236306,74059
2003-12-01,Missouri,4364893,2981753,2816016,165737
2003-12-01,Montana,712868,473096,450588,22508
2003-12-01,Nebraska,1311049,970633,932873,37760
2003-12-01,Nevada,1720218,1160955,1104598,56357
2003-12-01,Ohio,8769517,5834737,5480533,354204
2003-12-01,Oklahoma,2632214,1683573,1596931,86642
2003-12-01,Oregon,2767811,1845845,1702937,142908
2003-12-01,Pennsylvania,9629193,6177952,5840068,337884
2003-12-01,Tennessee,4515018,2905059,2748669,156390
2003-12-01,Texas,16177465,10921845,10227213,694632
2003-12-01,Utah,1707689,1210983,1146380,64603
2003-12-01,Vermont,489876,347928,333636,14292
2003-12-01,Virginia,5561272,3791774,3631928,159846
2003-12-01,Washington,4695514,3158238,2941507,216731
2003-12-01,Wisconsin,4228696,3042705,2880690,162015
2003-12-01,Wyoming,384284,273956,262705,11251
2004-01-01,Alabama,3433085,2135079,2009233,125846
2004-01-01,Alaska,465863,334741,309147,25594
2004-01-01,Arizona,4241467,2764569,2615971,148598
2004-01-01,Arkansas,2078485,1290641,1216905,73736
2004-01-01,California,26377278,17309407,16171157,1138250
2004-01-01,Colorado,3472675,2516896,2369974,146922
2004-01-01,Connecticut,2659392,1784241,1689747,94494
2004-01-01,Delaware,627838,420491,403050,17441
2004-01-01,Florida,13410688,8222986,7892825,330161
2004-01-01,Georgia,6530444,4426692,4219452,207240
2004-01-01,Hawaii,932670,607403,585087,22316
2004-01-01,Idaho,1017947,694609,658773,35836
2004-01-01,Illinois,9540419,6323763,5918111,405652
2004-01-01,Indiana,4702738,3169561,3000682,168879
2004-01-01,Iowa,2258410,1605504,1535411,70093
2004-01-01,Kansas,2047136,1453222,1371321,81901
2004-01-01,Kentucky,3167008,1971320,1857263,114057
2004-01-01,Louisiana,3334560,2020598,1903715,116883
2004-01-01,Maine,1031825,686975,653703,33272
2004-01-01,Maryland,4184452,2884243,2750195,134048
2004-01-01,Massachusetts,5037389,3418790,3233088,185702
2004-01-01,Michigan,7690309,5035899,4697353,338546
2004-01-01,Minnesota,3878373,2895742,2757083,138659
2004-01-01,Mississippi,2128150,1311475,1237222,74253
2004-01-01,Missouri,4367411,2982863,2817084,165779
2004-01-01,Montana,713535,473764,451372,22392
2004-01-01,Nebraska,1311438,971430,933710,37720
2004-01-01,Nevada,1725746,1163180,1107754,55426
2004-01-01,Ohio,8770391,5837546,5481118,356428
2004-01-01,Oklahoma,2632625,1683822,1598419,85403
2004-01-01,Oregon,2769240,1845768,1703314,142454
2004-01-01,Pennsylvania,9630651,6184757,5847893,336864
2004-01-01,Tennessee,4518034,2907164,2753587,153577
2004-01-01,Texas,16197933,10928063,10240704,687359
2004-01-01,Utah,1710973,1214258,1149805,64453
2004-01-01,Vermont,490092,348063,334025,14038
2004-01-01,Virginia,5569244,3794851,3634949,159902
2004-01-01,Washington,4701428,3163028,2948817,214211
2004-01-01,Wisconsin,4230892,3042711,2882994,159717
2004-01-01,Wyoming,384501,274065,262943,11122
2004-02-01,Alabama,3434233,2136691,2011207,125484
2004-02-01,Alaska,466768,335025,309418,25607
2004-02-01,Arizona,4251399,2770136,2621950,148186
2004-02-01,Arkansas,2079612,1291843,1218111,73732
2004-02-01,California,26397491,17319192,16188165,1131027
2004-02-01,Colorado,3475004,2521021,2375527,145494
2004-02-01,Connecticut,2659831,1782166,1688517,93649
2004-02-01,Delaware,628564,420727,403296,17431
2004-02-01,Florida,13434633,8247628,7920060,327568
2004-02-01,Georgia,6539377,4428141,4220186,207955
2004-02-01,Hawaii,934399,608045,586207,21838
2004-02-01,Idaho,1019480,695078,659740,35338
2004-02-01,Illinois,9542153,6326743,5925269,401474
2004-02-01,Indiana,4703907,3171522,2997382,174140
2004-02-01,Iowa,2258753,1604405,1534065,70340
2004-02-01,Kansas,2047513,1455058,1373033,82025
2004-02-01,Kentucky,3167748,1971186,1858197,112989
2004-02-01,Louisiana,3335103,2021542,1903786,117756
2004-02-01,Maine,1032322,686333,653662,32671
2004-02-01,Maryland,4187889,2882230,2749114,133116
2004-02-01,Massachusetts,5037486,3416688,3233494,183194
2004-02-01,Michigan,7691969,5037351,4699682,337669
2004-02-01,Minnesota,3880315,2895200,2758035,137165
2004-02-01,Mississippi,2129087,1312472,1237618,74854
2004-02-01,Missouri,4369873,2983993,2816937,167056
2004-02-01,Montana,714239,474629,452382,22247
2004-02-01,Nebraska,1311808,971902,934181,37721
2004-02-01,Nevada,1731208,1165251,1110585,54666
2004-02-01,Ohio,8771140,5839665,5481024,358641
2004-02-01,Oklahoma,2632965,1684158,1599873,84285
2004-02-01,Oregon,2770623,1845673,1703875,141798
2004-02-01,Pennsylvania,9631959,6189449,5852887,336562
2004-02-01,Tennessee,4521058,2907162,2756040,151122
2004-02-01,Texas,16218019,10934073,10252267,681806
2004-02-01,Utah,1714254,1217238,1152913,64325
2004-02-01,Vermont,490317,347989,334196,13793
2004-02-01,Virginia,5577107,3796863,3636925,159938
2004-02-01,Washington,4707256,3167586,2955903,211683
2004-02-01,Wisconsin,4233063,3041271,2883526,157745
2004-02-01,Wyoming,384777,274060,263110,10950
2004-03-01,Alabama,3435850,2138605,2013596,125009
2004-03-01,Alaska,467758,335316,309738,25578
2004-03-01,Arizona,4261812,2775047,2627781,147266
2004-03-01,Arkansas,2081054,1293256,1219410,73846
2004-03-01,California,26419460,17329131,16204247,1124884
2004-03-01,Colorado,3477768,2525009,2380909,144100
2004-03-01,Connecticut,2660629,1779987,1687010,92977
2004-03-01,Delaware,629366,420756,403235,17521
2004-03-01,Florida,13459929,8273038,7947207,325831
2004-03-01,Georgia,6549133,4431236,4220519,210717
2004-03-01,Hawaii,936221,608704,587346,21358
2004-03-01,Idaho,1021205,695801,660870,34931
2004-03-01,Illinois,9544949,6329748,5930867,398881
2004-03-01,Indiana,4705775,3167017,2994955,172062
2004-03-01,Iowa,2259439,1603910,1533044,70866
2004-03-01,Kansas,2048199,1456522,1374489,82033
2004-03-01,Kentucky,3168939,1971631,1859288,112343
2004-03-01,Louisiana,3336134,2022748,1904059,118689
2004-03-01,Maine,1032983,685653,653529,32124
2004-03-01,Maryland,4191851,2879702,2747423,132279
2004-03-01,Massachusetts,5038294,3414103,3233044,181059
2004-03-01,Michigan,7694720,5039531,4699967,339564
2004-03-01,Minnesota,3882829,2894398,2758479,135919
2004-03-01,Mississippi,2130299,1313652,1237802,75850
2004-03-01,Missouri,4373001,2985981,2816387,169594
2004-03-01,Montana,715014,475728,453632,22096
2004-03-01,Nebraska,1312336,972345,934610,37735
2004-03-01,Nevada,1736796,1167541,1113440,54101
2004-03-01,Ohio,8773158,5841740,5481099,360641
2004-03-01,Oklahoma,2633657,1684796,1601607,83189
2004-03-01,Oregon,2772385,1846069,1705242,140827
2004-03-01,Pennsylvania,9634546,6193295,5856438,336857
2004-03-01,Tennessee,4524708,2906276,2756818,149458
2004-03-01,Texas,16239300,10941915,10264447,677468
2004-03-01,Utah,1717784,1220277,1156051,64226
2004-03-01,Vermont,490608,347863,334289,13574
2004-03-01,Virginia,5585695,3798909,3638949,159960
2004-03-01,Washington,4713701,3172374,2963181,209193
2004-03-01,Wisconsin,4235849,3039707,2883699,156008
2004-03-01,Wyoming,385078,274053,263295,10758
2004-04-01,Alabama,3437710,2140692,2016465,124227
2004-04-01,Alaska,468813,335671,310191,25480
2004-04-01,Arizona,4272474,2779124,2633732,145392
2004-04-01,Arkansas,2082594,1295055,1221231,73824
2004-04-01,California,26443652,17340053,16223005,1117048
2004-04-01,Colorado,3480753,2529027,2386328,142699
2004-04-01,Connecticut,2661640,1778337,1686019,92318
2004-04-01,Delaware,630222,420683,403023,17660
2004-04-01,Florida,13486273,8297196,7973417,323779
2004-04-01,Georgia,6559211,4436733,4221874,214859
2004-04-01,Hawaii,938135,609424,588582,20842
2004-04-01,Idaho,1022949,697000,662386,34614
2004-04-01,Illinois,9548361,6332906,5936524,396382
2004-04-01,Indiana,4707896,3164103,2993722,170381
2004-04-01,Iowa,2260263,1604462,1532911,71551
2004-04-01,Kansas,2048978,1457910,1376040,81870
2004-04-01,Kentucky,3170338,1972417,1860709,111708
2004-04-01,Louisiana,3337310,2024070,1905177,118893
2004-04-01,Maine,1033682,685146,653463,31683
2004-04-01,Maryland,4196057,2877711,2746027,131684
2004-04-01,Massachusetts,5039418,3411106,3232101,179005
2004-04-01,Michigan,7697912,5042439,4699668,342771
2004-04-01,Minnesota,3885547,2893583,2758465,135118
2004-04-01,Mississippi,2131602,1315051,1237981,77070
2004-04-01,Missouri,4376314,2989077,2816352,172725
2004-04-01,Montana,715828,476879,454943,21936
2004-04-01,Nebraska,1312946,972956,935234,37722
2004-04-01,Nevada,1742523,1170127,1116534,53593
2004-04-01,Ohio,8775765,5843709,5481800,361909
2004-04-01,Oklahoma,2634528,1685600,1603693,81907
2004-04-01,Oregon,2774282,1846876,1707383,139493
2004-04-01,Pennsylvania,9637810,6197231,5860184,337047
2004-04-01,Tennessee,4528589,2904703,2755839,148864
2004-04-01,Texas,16261719,10951500,10279305,672195
2004-04-01,Utah,1721363,1223417,1159431,63986
2004-04-01,Vermont,490939,347778,334426,13352
2004-04-01,Virginia,5594632,3801263,3641669,159594
2004-04-01,Washington,4720436,3177125,2970663,206462
2004-04-01,Wisconsin,4238868,3038689,2884436,154253
2004-04-01,Wyoming,385368,274101,263530,10571
2004-05-01,Alabama,3439685,2142378,2019286,123092
2004-05-01,Alaska,469843,336120,310799,25321
2004-05-01,Arizona,4283321,2782662,2639904,142758
2004-05-01,Arkansas,2084280,1297196,1223700,73496
2004-05-01,California,26467780,17351446,16245756,1105690
2004-05-01,Colorado,3483817,2533306,2391942,141364
2004-05-01,Connecticut,2662777,1777246,1685699,91547
2004-05-01,Delaware,631130,420645,402806,17839
2004-05-01,Florida,13513490,8318017,7997178,320839
2004-05-01,Georgia,6569512,4444641,4225018,219623
2004-05-01,Hawaii,940006,610172,589865,20307
2004-05-01,Idaho,1024783,698687,664281,34406
2004-05-01,Illinois,9552159,6336758,5943302,393456
2004-05-01,Indiana,4710339,3162596,2993555,169041
2004-05-01,Iowa,2261286,1605634,1533356,72278
2004-05-01,Kansas,2049973,1459262,1377763,81499
2004-05-01,Kentucky,3171919,1972864,1862183,110681
2004-05-01,Louisiana,3338628,2025407,1907175,118232
2004-05-01,Maine,1034531,684872,653504,31368
2004-05-01,Maryland,4200421,2877036,2745676,131360
2004-05-01,Massachusetts,5040822,3407545,3230748,176797
2004-05-01,Michigan,7701567,5045752,4699968,345784
2004-05-01,Minnesota,3888600,2892939,2758324,134615
2004-05-01,Mississippi,2132985,1316291,1237915,78376
2004-05-01,Missouri,4380004,2992854,2817116,175738
2004-05-01,Montana,716704,477899,456110,21789
2004-05-01,Nebraska,1313691,973713,936041,37672
2004-05-01,Nevada,1748307,1172939,1119945,52994
2004-05-01,Ohio,8778817,5845975,5483256,362719
2004-05-01,Oklahoma,2635506,1686500,1606078,80422
2004-05-01,Oregon,2776406,1847565,1709650,137915
2004-05-01,Pennsylvania,9641784,6201909,5865330,336579
2004-05-01,Tennessee,4532727,2902053,2752673,149380
2004-05-01,Texas,16284426,10962640,10297656,664984
2004-05-01,Utah,1725073,1226615,1163120,63495
2004-05-01,Vermont,491303,347714,334625,13089
2004-05-01,Virginia,5603790,3804208,3645645,158563
2004-05-01,Washington,4727430,3181517,2978056,203461
2004-05-01,Wisconsin,4242228,3038020,2885519,152501
2004-05-01,Wyoming,385715,274229,263790,10439
2004-06-01,Alabama,3441786,2143069,2021471,121598
2004-06-01,Alaska,470883,336707,311581,25126
2004-06-01,Arizona,4294298,2786277,2646350,139927
2004-06-01,Arkansas,2086030,1299548,1226676,72872
2004-06-01,California,26492860,17363109,16272306,1090803
2004-06-01,Colorado,3487031,2537859,2397607,140252
2004-06-01,Connecticut,2663930,1776345,1685705,90640
2004-06-01,Delaware,632012,420730,402703,18027
2004-06-01,Florida,13540882,8336128,8019091,317037
2004-06-01,Georgia,6579965,4454231,4229741,224490
2004-06-01,Hawaii,941951,611002,591160,19842
2004-06-01,Idaho,1026647,700708,666437,34271
2004-06-01,Illinois,9556128,6341581,5950845,390736
2004-06-01,Indiana,4712898,3161918,2993593,168325
2004-06-01,Iowa,2262389,1606835,1533841,72994
2004-06-01,Kansas,2050940,1460394,1379416,80978
2004-06-01,Kentucky,3173568,1972555,1863418,109137
2004-06-01,Louisiana,3340023,2026903,1909929,116974
2004-06-01,Maine,1035353,684887,653682,31205
2004-06-01,Maryland,4204763,2878179,2746789,131390
2004-06-01,Massachusetts,5042398,3403327,3228938,174389
2004-06-01,Michigan,7705357,5049747,4701330,348417
2004-06-01,Minnesota,3891730,2892661,2758493,134168
2004-06-01,Mississippi,2134430,1316915,1237209,79706
2004-06-01,Missouri,4383735,2996620,2818440,178180
2004-06-01,Montana,717613,478665,457011,21654
2004-06-01,Nebraska,1314476,974426,936811,37615
2004-06-01,Nevada,1754092,1175947,1123666,52281
2004-06-01,Ohio,8782026,5849182,5484934,364248
2004-06-01,Oklahoma,2636585,1687695,1608727,78968
2004-06-01,Oregon,2778594,1847646,1711208,136438
2004-06-01,Pennsylvania,9645900,6207464,5871779,335685
2004-06-01,Tennessee,4536945,2898638,2747836,150802
2004-06-01,Texas,16307728,10975531,10318766,656765
2004-06-01,Utah,1728855,1229847,1167114,62733
2004-06-01,Vermont,491680,347631,334829,12802
2004-06-01,Virginia,5613034,3807970,3650944,157026
2004-06-01,Washington,4734536,3185496,2985114,200382
2004-06-01,Wisconsin,4245720,3037358,2886459,150899
2004-06-01,Wyoming,386088,274429,264047,10382
2004-07-01,Alabama,3443779,2142414,2022549,119865
2004-07-01,Alaska,471914,337419,312484,24935
2004-07-01,Arizona,4305236,2790248,2652981,137267
2004-07-01,Arkansas,2087718,1302202,1229988,72214
2004-07-01,California,26517866,17376345,16301677,1074668
2004-07-01,Colorado,3490155,2542645,2402909,139736
2004-07-01,Connecticut,2665072,1775671,1685982,89689
2004-07-01,Delaware,632901,420927,402739,18188
2004-07-01,Florida,13568246,8353823,8040978,312845
2004-07-01,Georgia,6590261,4464814,4235369,229445
2004-07-01,Hawaii,943836,611924,592411,19513
2004-07-01,Idaho,1028503,702889,668697,34192
2004-07-01,Illinois,9559957,6347448,5958454,388994
2004-07-01,Indiana,4715326,3161766,2993388,168378
2004-07-01,Iowa,2263438,1607946,1534316,73630
2004-07-01,Kansas,2051917,1461071,1380689,80382
2004-07-01,Kentucky,3175141,1971264,1864071,107193
2004-07-01,Louisiana,3341331,2028909,1913454,115455
2004-07-01,Maine,1036156,685158,653951,31207
2004-07-01,Maryland,4209075,2880951,2749214,131737
2004-07-01,Massachusetts,5043821,3398885,3226927,171958
2004-07-01,Michigan,7708983,5055411,4703673,351738
2004-07-01,Minnesota,3894760,2893170,2759581,133589
2004-07-01,Mississippi,2135811,1316784,1235652,81132
2004-07-01,Missouri,4387385,2999666,2819812,179854
2004-07-01,Montana,718478,479201,457706,21495
2004-07-01,Nebraska,1315209,974888,937285,37603
2004-07-01,Nevada,1759901,1179137,1127564,51573
2004-07-01,Ohio,8785028,5853902,5487103,366799
2004-07-01,Oklahoma,2637604,1689415,1611650,77765
2004-07-01,Oregon,2780722,1847125,1711794,135331
2004-07-01,Pennsylvania,9649782,6213955,5879097,334858
2004-07-01,Tennessee,4541057,2895791,2742822,152969
2004-07-01,Texas,16331058,10991436,10341395,650041
2004-07-01,Utah,1732590,1233083,1171302,61781
2004-07-01,Vermont,492034,347484,334961,12523
2004-07-01,Virginia,5622191,3812653,3657321,155332
2004-07-01,Washington,4741529,3189546,2991920,197626
2004-07-01,Wisconsin,4249079,3036243,2886811,149432
2004-07-01,Wyoming,386429,274680,264294,10386
2004-08-01,Alabama,3446834,2140490,2022542,117948
2004-08-01,Alaska,472628,338166,313397,24769
2004-08-01,Arizona,4319535,2794295,2659587,134708
2004-08-01,Arkansas,2089956,1305072,1233356,71716
2004-08-01,California,26540808,17389930,16330923,1059007
2004-08-01,Colorado,3495242,2547078,2407412,139666
2004-08-01,Connecticut,2666291,1775120,1686356,88764
2004-08-01,Delaware,633994,421158,402827,18331
2004-08-01,Florida,13598789,8372814,8064221,308593
2004-08-01,Georgia,6604308,4475645,4241376,234269
2004-08-01,Hawaii,944472,612844,593528,19316
2004-08-01,Idaho,1030964,705141,671045,34096
2004-08-01,Illinois,9564987,6354195,5966219,387976
2004-08-01,Indiana,4718862,3161814,2992678,169136
2004-08-01,Iowa,2264596,1608630,1534570,74060
2004-08-01,Kansas,2053427,1461198,1381424,79774
2004-08-01,Kentucky,3178077,1969188,1863931,105257
2004-08-01,Louisiana,3342934,2031535,1917672,113863
2004-08-01,Maine,1036856,685539,654211,31328
2004-08-01,Maryland,4213352,2884556,2752351,132205
2004-08-01,Massachusetts,5045874,3394330,3224738,169592
2004-08-01,Michigan,7712018,5061889,4706244,355645
2004-08-01,Minnesota,3897847,2893925,2761403,132522
2004-08-01,Mississippi,2137314,1316021,1233477,82544
2004-08-01,Missouri,4391827,3001647,2820934,180713
2004-08-01,Montana,719343,479547,458244,21303
2004-08-01,Nebraska,1316060,974901,937248,37653
2004-08-01,Nevada,1765131,1182474,1131457,51017
2004-08-01,Ohio,8788758,5858754,5489638,369116
2004-08-01,Oklahoma,2639439,1691534,1614626,76908
2004-08-01,Oregon,2784563,1845970,1711747,134223
2004-08-01,Pennsylvania,9655149,6220769,5887051,333718
2004-08-01,Tennessee,4547265,2893404,2737780,155624
2004-08-01,Texas,16356646,11010492,10364409,646083
2004-08-01,Utah,1736464,1236257,1175539,60718
2004-08-01,Vermont,492352,347236,334965,12271
2004-08-01,Virginia,5629892,3817970,3664274,153696
2004-08-01,Washington,4748214,3194261,2998871,195390
2004-08-01,Wisconsin,4252495,3034311,2886205,148106
2004-08-01,Wyoming,386726,274947,264529,10418
2004-09-01,Alabama,3449856,2137912,2021961,115951
2004-09-01,Alaska,473333,338908,314260,24648
2004-09-01,Arizona,4333748,2797989,2665712,132277
2004-09-01,Arkansas,2092188,1308106,1236602,71504
2004-09-01,California,26563611,17401640,16356394,1045246
2004-09-01,Colorado,3500274,2550329,2410731,139598
2004-09-01,Connecticut,2667497,1774206,1686219,87987
2004-09-01,Delaware,635071,421318,402828,18490
2004-09-01,Florida,13629175,8393668,8089209,304459
2004-09-01,Georgia,6618221,4485994,4246915,239079
2004-09-01,Hawaii,945118,613770,594526,19244
2004-09-01,Idaho,1033418,707505,673611,33894
2004-09-01,Illinois,9569964,6361016,5973680,387336
2004-09-01,Indiana,4722340,3162109,2991472,170637
2004-09-01,Iowa,2265799,1608698,1534430,74268
2004-09-01,Kansas,2054915,1460850,1381552,79298
2004-09-01,Kentucky,3180947,1967219,1863350,103869
2004-09-01,Louisiana,3344535,2034732,1922049,112683
2004-09-01,Maine,1037513,685894,654352,31542
2004-09-01,Maryland,4217571,2888178,2755412,132766
2004-09-01,Massachusetts,5047836,3389536,3222035,167501
2004-09-01,Michigan,7714892,5067304,4707661,359643
2004-09-01,Minnesota,3900940,2893676,2762929,130747
2004-09-01,Mississippi,2138807,1315041,1231164,83877
2004-09-01,Missouri,4396196,3002704,2821759,180945
2004-09-01,Montana,720237,479803,458684,21119
2004-09-01,Nebraska,1316936,974455,936692,37763
2004-09-01,Nevada,1770335,1185922,1135183,50739
2004-09-01,Ohio,8792357,5861798,5491127,370671
2004-09-01,Oklahoma,2641207,1693664,1617221,76443
2004-09-01,Oregon,2788374,1844455,1711773,132682
2004-09-01,Pennsylvania,9660361,6226813,5895143,331670
2004-09-01,Tennessee,4553381,2890258,2731743,158515
2004-09-01,Texas,16382090,11031545,10386154,645391
2004-09-01,Utah,1740320,1239371,1179706,59665
2004-09-01,Vermont,492644,346887,334809,12078
2004-09-01,Virginia,5637496,3823527,3671229,152298
2004-09-01,Washington,4754811,3199823,3006002,193821
2004-09-01,Wisconsin,4255875,3031344,2884270,147074
2004-09-01,Wyoming,387024,275180,264746,10434
2004-10-01,Alabama,3452951,2135435,2021520,113915
2004-10-01,Alaska,474064,339619,315045,24574
2004-10-01,Arizona,4348147,2801087,2670776,130311
2004-10-01,Arkansas,2094464,1311214,1239659,71555
2004-10-01,California,26587015,17410849,16376888,1033961
2004-10-01,Colorado,3505410,2552184,2412847,139337
2004-10-01,Connecticut,2668743,1773072,1685602,87470
2004-10-01,Delaware,636204,421353,402703,18650
2004-10-01,Florida,13660059,8416258,8115866,300392
2004-10-01,Georgia,6632340,4495936,4251657,244279
2004-10-01,Hawaii,945789,614700,595481,19219
2004-10-01,Idaho,1035876,709974,676484,33490
2004-10-01,Illinois,9575124,6366944,5980251,386693
2004-10-01,Indiana,4725924,3162880,2990119,172761
2004-10-01,Iowa,2266982,1608704,1534379,74325
2004-10-01,Kansas,2056435,1460286,1381290,78996
2004-10-01,Kentucky,3183913,1966154,1862742,103412
2004-10-01,Louisiana,3346145,2037986,1925636,112350
2004-10-01,Maine,1038218,686180,654358,31822
2004-10-01,Maryland,4221895,2891348,2757770,133578
2004-10-01,Massachusetts,5049924,3384634,3218714,165920
2004-10-01,Michigan,7718019,5070143,4707409,362734
2004-10-01,Minnesota,3904112,2891183,2762767,128416
2004-10-01,Mississippi,2140328,1314472,1229171,85301
2004-10-01,Missouri,4400691,3003305,2822567,180738
2004-10-01,Montana,721107,480123,459133,20990
2004-10-01,Nebraska,1317804,973912,935937,37975
2004-10-01,Nevada,1775557,1189438,1138683,50755
2004-10-01,Ohio,8796157,5861874,5490021,371853
2004-10-01,Oklahoma,2643012,1695658,1619246,76412
2004-10-01,Oregon,2792241,1842831,1712380,130451
2004-10-01,Pennsylvania,9665811,6231696,5902258,329438
2004-10-01,Tennessee,4559601,2885829,2724645,161184
2004-10-01,Texas,16407952,11052652,10405657,646995
2004-10-01,Utah,1744191,1242536,1183774,58762
2004-10-01,Vermont,493024,346518,334548,11970
2004-10-01,Virginia,5645219,3829026,3677759,151267
2004-10-01,Washington,4761572,3205718,3012926,192792
2004-10-01,Wisconsin,4259357,3027357,2881043,146314
2004-10-01,Wyoming,387319,275357,264960,10397
2004-11-01,Alabama,3455389,2133332,2021719,111613
2004-11-01,Alaska,474732,340258,315753,24505
2004-11-01,Arizona,4361732,2804115,2675079,129036
2004-11-01,Arkansas,2096365,1314212,1242580,71632
2004-11-01,California,26606532,17417930,16394216,1023714
2004-11-01,Colorado,3510005,2553001,2414109,138892
2004-11-01,Connecticut,2669573,1772446,1685246,87200
2004-11-01,Delaware,637179,421408,402655,18753
2004-11-01,Florida,13688136,8440010,8143940,296070
2004-11-01,Georgia,6645274,4505826,4256148,249678
2004-11-01,Hawaii,946406,615625,596478,19147
2004-11-01,Idaho,1038176,712525,679697,32828
2004-11-01,Illinois,9578688,6371477,5986076,385401
2004-11-01,Indiana,4728736,3164300,2989333,174967
2004-11-01,Iowa,2267796,1609289,1535112,74177
2004-11-01,Kansas,2057633,1459668,1380894,78774
2004-11-01,Kentucky,3186350,1966299,1862347,103952
2004-11-01,Louisiana,3347153,2040782,1928071,112711
2004-11-01,Maine,1038776,686474,654333,32141
2004-11-01,Maryland,4225446,2893990,2759355,134635
2004-11-01,Massachusetts,5051159,3380049,3215202,164847
2004-11-01,Michigan,7719740,5070334,4706109,364225
2004-11-01,Minnesota,3906683,2886465,2760586,125879
2004-11-01,Mississippi,2141445,1314607,1227778,86829
2004-11-01,Missouri,4404412,3003914,2823628,180286
2004-11-01,Montana,721908,480537,459632,20905
2004-11-01,Nebraska,1318498,973503,935239,38264
2004-11-01,Nevada,1780588,1193034,1142139,50895
2004-11-01,Ohio,8798349,5859524,5487261,372263
2004-11-01,Oklahoma,2644429,1697444,1620792,76652
2004-11-01,Oregon,2795684,1841275,1713800,127475
2004-11-01,Pennsylvania,9669418,6235083,5907502,327581
2004-11-01,Tennessee,4565066,2880946,2717840,163106
2004-11-01,Texas,16431310,11071593,10423472,648121
2004-11-01,Utah,1747839,1245923,1187918,58005
2004-11-01,Vermont,493261,346241,334309,11932
2004-11-01,Virginia,5652057,3834654,3684017,150637
2004-11-01,Washington,4767571,3211380,3019465,191915
2004-11-01,Wisconsin,4262165,3022811,2877339,145472
2004-11-01,Wyoming,387592,275494,265208,10286
2004-12-01,Alabama,3457864,2132075,2023018,109057
2004-12-01,Alaska,475388,340858,316435,24423
2004-12-01,Arizona,4375260,2808145,2679413,128732
2004-12-01,Arkansas,2098297,1317182,1245566,71616
2004-12-01,California,26625485,17426935,16412579,1014356
2004-12-01,Colorado,3514580,2553668,2415136,138532
2004-12-01,Connecticut,2670352,1773105,1685851,87254
2004-12-01,Delaware,638163,421836,403030,18806
2004-12-01,Florida,13716053,8465429,8173938,291491
2004-12-01,Georgia,6658325,4516765,4261626,255139
2004-12-01,Hawaii,947015,616613,597609,19004
2004-12-01,Idaho,1040488,715232,683201,32031
2004-12-01,Illinois,9582205,6375784,5991999,383785
2004-12-01,Indiana,4731573,3167353,2990614,176739
2004-12-01,Iowa,2268621,1611006,1537097,73909
2004-12-01,Kansas,2058823,1459201,1380607,78594
2004-12-01,Kentucky,3188808,1968075,1862538,105537
2004-12-01,Louisiana,3348219,2043263,1929847,113416
2004-12-01,Maine,1039312,687027,654455,32572
2004-12-01,Maryland,4229035,2896823,2760926,135897
2004-12-01,Massachusetts,5052390,3377131,3212696,164435
2004-12-01,Michigan,7721554,5069863,4705231,364632
2004-12-01,Minnesota,3909235,2881623,2757665,123958
2004-12-01,Mississippi,2142612,1315639,1227296,88343
2004-12-01,Missouri,4408140,3005007,2825149,179858
2004-12-01,Montana,722675,481009,460157,20852
2004-12-01,Nebraska,1319186,973347,934740,38607
2004-12-01,Nevada,1785562,1196891,1145822,51069
2004-12-01,Ohio,8800590,5858060,5486004,372056
2004-12-01,Oklahoma,2645828,1699186,1622239,76947
2004-12-01,Oregon,2799092,1840401,1716027,124374
2004-12-01,Pennsylvania,9673014,6238050,5911684,326366
2004-12-01,Tennessee,4570542,2877576,2713075,164501
2004-12-01,Texas,16454361,11089089,10441184,647905
2004-12-01,Utah,1751435,1249798,1192371,57427
2004-12-01,Vermont,493498,346179,334240,11939
2004-12-01,Virginia,5658923,3841612,3690869,150743
2004-12-01,Washington,4773559,3217289,3026064,191225
2004-12-01,Wisconsin,4264967,3018970,2874349,144621
2004-12-01,Wyoming,387828,275664,265528,10136
2005-01-01,Alabama,3460380,2131703,2025399,106304
2005-01-01,Alaska,476092,341438,317165,24273
2005-01-01,Arizona,4388833,2813887,2684510,129377
2005-01-01,Arkansas,2100215,1320144,1248822,71322
2005-01-01,California,26644965,17439739,16435427,1004312
2005-01-01,Colorado,3519168,2554891,2416722,138169
2005-01-01,Connecticut,2671146,1775159,1687677,87482
2005-01-01,Delaware,639183,422854,404007,18847
2005-01-01,Florida,13744074,8492386,8206242,286144
2005-01-01,Georgia,6671455,4529287,4269353,259934
2005-01-01,Hawaii,947670,617673,598918,18755
2005-01-01,Idaho,1042808,718063,686859,31204
2005-01-01,Illinois,9585780,6380668,5998455,382213
2005-01-01,Indiana,4734369,3172050,2994570,177480
2005-01-01,Iowa,2269436,1613752,1540278,73474
2005-01-01,Kansas,2060008,1458973,1380627,78346
2005-01-01,Kentucky,3191213,1971250,1863475,107775
2005-01-01,Louisiana,3349336,2045557,1931637,113920
2005-01-01,Maine,1039810,687951,654877,33074
2005-01-01,Maryland,4232709,2900672,2763621,137051
2005-01-01,Massachusetts,5053578,3376327,3211964,164363
2005-01-01,Michigan,7723279,5069412,4705996,363416
2005-01-01,Minnesota,3911758,2878253,2755477,122776
2005-01-01,Mississippi,2143800,1317464,1227658,89806
2005-01-01,Missouri,4411851,3006569,2827349,179220
2005-01-01,Montana,723461,481501,460719,20782
2005-01-01,Nebraska,1319812,973373,934503,38870
2005-01-01,Nevada,1790521,1201124,1149962,51162
2005-01-01,Ohio,8802792,5859119,5488022,371097
2005-01-01,Oklahoma,2647195,1700922,1623958,76964
2005-01-01,Oregon,2802431,1840535,1719030,121505
2005-01-01,Pennsylvania,9676572,6241271,5916028,325243
2005-01-01,Tennessee,4576008,2876208,2710731,165477
2005-01-01,Texas,16477714,11104720,10460250,644470
2005-01-01,Utah,1755023,1254218,1197310,56908
2005-01-01,Vermont,493748,346365,334412,11953
2005-01-01,Virginia,5665801,3850656,3699201,151455
2005-01-01,Washington,4779499,3223554,3033132,190422
2005-01-01,Wisconsin,4267697,3016579,2872890,143689
2005-01-01,Wyoming,388071,275949,265961,9988
2005-02-01,Alabama,3462717,2131888,2028403,103485
2005-02-01,Alaska,476716,341972,317924,24048
2005-02-01,Arizona,4402003,2821319,2690651,130668
2005-02-01,Arkansas,2101950,1323041,1252355,70686
2005-02-01,California,26662446,17455416,16463071,992345
2005-02-01,Colorado,3523573,2556829,2419263,137566
2005-02-01,Connecticut,2671679,1778212,1690532,87680
2005-02-01,Delaware,640133,424441,405516,18925
2005-02-01,Florida,13770467,8519788,8240124,279664
2005-02-01,Georgia,6684496,4543128,4279783,263345
2005-02-01,Hawaii,948189,618846,600440,18406
2005-02-01,Idaho,1045018,720965,690455,30510
2005-02-01,Illinois,9588823,6385992,6004806,381186
2005-02-01,Indiana,4736904,3177325,3000375,176950
2005-02-01,Iowa,2269999,1616939,1544054,72885
2005-02-01,Kansas,2061041,1458867,1380967,77900
2005-02-01,Kentucky,3193509,1975095,1864921,110174
2005-02-01,Louisiana,3350321,2047645,1933747,113898
2005-02-01,Maine,1040231,689243,655688,33555
2005-02-01,Maryland,4236127,2905808,2768164,137644
2005-02-01,Massachusetts,5054419,3377030,3212794,164236
2005-02-01,Michigan,7724621,5069092,4708726,360366
2005-02-01,Minnesota,3914076,2876919,2754981,121938
2005-02-01,Mississippi,2144960,1319560,1228513,91047
2005-02-01,Missouri,4415325,3008233,2830213,178020
2005-02-01,Montana,724169,481942,461273,20669
2005-02-01,Nebraska,1320408,973423,934480,38943
2005-02-01,Nevada,1795391,1205680,1154565,51115
2005-02-01,Ohio,8804440,5861578,5493034,368544
2005-02-01,Oklahoma,2648385,1702422,1625949,76473
2005-02-01,Oregon,2805596,1841539,1722403,119136
2005-02-01,Pennsylvania,9679271,6244682,5921082,323600
2005-02-01,Tennessee,4581243,2876117,2710274,165843
2005-02-01,Texas,16500347,11116844,10480729,636115
2005-02-01,Utah,1758684,1259004,1202700,56304
2005-02-01,Vermont,493996,346736,334776,11960
2005-02-01,Virginia,5672429,3861571,3709239,152332
2005-02-01,Washington,4785133,3229985,3040798,189187
2005-02-01,Wisconsin,4270211,3015702,2872864,142838
2005-02-01,Wyoming,388301,276375,266495,9880
2005-03-01,Alabama,3465050,2132542,2032012,100530
2005-03-01,Alaska,477365,342453,318673,23780
2005-03-01,Arizona,4415083,2830147,2698108,132039
2005-03-01,Arkansas,2103753,1325810,1255998,69812
2005-03-01,California,26678872,17473771,16495869,977902
2005-03-01,Colorado,3527977,2559265,2422811,136454
2005-03-01,Connecticut,2672291,1781743,1694123,87620
2005-03-01,Delaware,641082,426475,407433,19042
2005-03-01,Florida,13796773,8548127,8276228,271899
2005-03-01,Georgia,6697423,4557632,4292843,264789
2005-03-01,Hawaii,948653,620188,602193,17995
2005-03-01,Idaho,1047271,723846,693803,30043
2005-03-01,Illinois,9591812,6391368,6011404,379964
2005-03-01,Indiana,4739527,3182356,3007192,175164
2005-03-01,Iowa,2270656,1620079,1547950,72129
2005-03-01,Kansas,2062079,1458695,1381581,77114
2005-03-01,Kentucky,3195814,1979166,1867008,112158
2005-03-01,Louisiana,3351321,2049886,1936392,113494
2005-03-01,Maine,1040705,690827,656915,33912
2005-03-01,Maryland,4239551,2912173,2774885,137288
2005-03-01,Massachusetts,5055380,3378721,3215059,163662
2005-03-01,Michigan,7726034,5069101,4713415,355686
2005-03-01,Minnesota,3916435,2877593,2756754,120839
2005-03-01,Mississippi,2146056,1321680,1229790,91890
2005-03-01,Missouri,4418842,3009365,2833780,175585
2005-03-01,Montana,724891,482380,461878,20502
2005-03-01,Nebraska,1320998,973356,934634,38722
2005-03-01,Nevada,1800253,1210546,1159620,50926
2005-03-01,Ohio,8806322,5864576,5500803,363773
2005-03-01,Oklahoma,2649591,1703928,1628305,75623
2005-03-01,Oregon,2808757,1843099,1725739,117360
2005-03-01,Pennsylvania,9682205,6248159,5927206,320953
2005-03-01,Tennessee,4586532,2877240,2712037,165203
2005-03-01,Texas,16522317,11125846,10502785,623061
2005-03-01,Utah,1762308,1264021,1208513,55508
2005-03-01,Vermont,494236,347219,335273,11946
2005-03-01,Virginia,5679045,3873810,3720949,152861
2005-03-01,Washington,4790818,3236835,3049422,187413
2005-03-01,Wisconsin,4272766,3016078,2873999,142079
2005-03-01,Wyoming,388553,276936,267105,9831
2005-04-01,Alabama,3467687,2133797,2036225,97572
2005-04-01,Alaska,478096,342940,319427,23513
2005-04-01,Arizona,4428692,2840229,2707135,133094
2005-04-01,Arkansas,2105716,1328586,1259507,69079
2005-04-01,California,26698527,17496205,16533791,962414
2005-04-01,Colorado,3532733,2562139,2427282,134857
2005-04-01,Connecticut,2673108,1785633,1698358,87275
2005-04-01,Delaware,642098,428767,409590,19177
2005-04-01,Florida,13824542,8579298,8316002,263296
2005-04-01,Georgia,6710913,4572349,4307651,264698
2005-04-01,Hawaii,949295,621790,604188,17602
2005-04-01,Idaho,1049612,726623,696833,29790
2005-04-01,Illinois,9595765,6397182,6019020,378162
2005-04-01,Indiana,4742556,3187599,3014773,172826
2005-04-01,Iowa,2271492,1623189,1551978,71211
2005-04-01,Kansas,2063305,1458396,1382409,75987
2005-04-01,Kentucky,3198405,1983363,1869854,113509
2005-04-01,Louisiana,3352612,2052828,1939964,112864
2005-04-01,Maine,1041236,692602,658492,34110
2005-04-01,Maryland,4243365,2919397,2783419,135978
2005-04-01,Massachusetts,5056753,3381335,3218651,162684
2005-04-01,Michigan,7728136,5069995,4719678,350317
2005-04-01,Minnesota,3919150,2879816,2760555,119261
2005-04-01,Mississippi,2147354,1324117,1231424,92693
2005-04-01,Missouri,4422729,3009723,2838010,171713
2005-04-01,Montana,725667,482966,462673,20293
2005-04-01,Nebraska,1321677,973129,934935,38194
2005-04-01,Nevada,1805236,1215779,1165081,50698
2005-04-01,Ohio,8808940,5868991,5511573,357418
2005-04-01,Oklahoma,2651053,1705764,1630999,74765
2005-04-01,Oregon,2812208,1845150,1729019,116131
2005-04-01,Pennsylvania,9685990,6252160,5934802,317358
2005-04-01,Tennessee,4592237,2880139,2716883,163256
2005-04-01,Texas,16546090,11134783,10525682,609101
2005-04-01,Utah,1766020,1269262,1214708,54554
2005-04-01,Vermont,494509,347780,335872,11908
2005-04-01,Virginia,5686120,3887264,3734204,153060
2005-04-01,Washington,4796941,3244311,3058875,185436
2005-04-01,Wisconsin,4275662,3017984,2876475,141509
2005-04-01,Wyoming,388789,277618,267780,9838
2005-05-01,Alabama,3470456,2135881,2040891,94990
2005-05-01,Alaska,478798,343476,320167,23309
2005-05-01,Arizona,4442405,2850925,2717283,133642
2005-05-01,Arkansas,2107819,1331576,1262763,68813
2005-05-01,California,26718033,17522524,16574980,947544
2005-05-01,Colorado,3537599,2565371,2432503,132868
2005-05-01,Connecticut,2674080,1789854,1703125,86729
2005-05-01,Delaware,643156,431083,411764,19319
2005-05-01,Florida,13853110,8613694,8359329,254365
2005-05-01,Georgia,6724569,4586838,4322968,263870
2005-05-01,Hawaii,949852,623721,606410,17311
2005-05-01,Idaho,1052070,729260,699591,29669
2005-05-01,Illinois,9599964,6403350,6028017,375333
2005-05-01,Indiana,4745870,3193454,3022717,170737
2005-05-01,Iowa,2272565,1626381,1556181,70200
2005-05-01,Kansas,2064686,1458126,1383469,74657
2005-05-01,Kentucky,3201197,1987665,1873238,114427
2005-05-01,Louisiana,3353983,2055560,1943455,112105
2005-05-01,Maine,1041902,694480,660287,34193
2005-05-01,Maryland,4247232,2926886,2792868,134018
2005-05-01,Massachusetts,5058419,3384497,3222946,161551
2005-05-01,Michigan,7730645,5071335,4726752,344583
2005-05-01,Minnesota,3922141,2882721,2765257,117464
2005-05-01,Mississippi,2148711,1326831,1233270,93561
2005-05-01,Missouri,4426897,3009592,2842877,166715
2005-05-01,Montana,726519,483804,463742,20062
2005-05-01,Nebraska,1322532,972854,935419,37435
2005-05-01,Nevada,1810303,1221363,1170797,50566
2005-05-01,Ohio,8812021,5874671,5524226,350445
2005-05-01,Oklahoma,2652663,1707881,1633746,74135
2005-05-01,Oregon,2815829,1847512,1732227,115285
2005-05-01,Pennsylvania,9690477,6256609,5943384,313225
2005-05-01,Tennessee,4598137,2885126,2724760,160366
2005-05-01,Texas,16570063,11147039,10548719,598320
2005-05-01,Utah,1769922,1274652,1221155,53497
2005-05-01,Vermont,494820,348442,336553,11889
2005-05-01,Virginia,5693461,3901019,3748057,152962
2005-05-01,Washington,4803272,3252288,3068571,183717
2005-05-01,Wisconsin,4278932,3021665,2880445,141220
2005-05-01,Wyoming,389093,278399,268517,9882
2005-06-01,Alabama,3473470,2138558,2045463,93095
2005-06-01,Alaska,479556,344040,320787,23253
2005-06-01,Arizona,4456434,2861177,2727304,133873
2005-06-01,Arkansas,2110026,1334725,1265578,69147
2005-06-01,California,26739187,17548901,16613194,935707
2005-06-01,Colorado,3542670,2568581,2437884,130697
2005-06-01,Connecticut,2675160,1793985,1707802,86183
2005-06-01,Delaware,644233,433225,413740,19485
2005-06-01,Florida,13882354,8648158,8402146,246012
2005-06-01,Georgia,6738611,4600177,4337087,263090
2005-06-01,Hawaii,950463,625770,608578,17192
2005-06-01,Idaho,1054536,731642,702030,29612
2005-06-01,Illinois,9604737,6409402,6038327,371075
2005-06-01,Indiana,4749491,3199884,3030220,169664
2005-06-01,Iowa,2273770,1629285,1560026,69259
2005-06-01,Kansas,2066217,1458034,1384566,73468
2005-06-01,Kentucky,3204189,1991854,1876503,115351
2005-06-01,Louisiana,3355571,2056231,1944466,111765
2005-06-01,Maine,1042612,696234,661982,34252
2005-06-01,Maryland,4251294,2933604,2801630,131974
2005-06-01,Massachusetts,5060407,3387355,3226660,160695
2005-06-01,Michigan,7733585,5072040,4732938,339102
2005-06-01,Minnesota,3925387,2884875,2768925,115950
2005-06-01,Mississippi,2150204,1329527,1234991,94536
2005-06-01,Missouri,4431358,3009473,2847827,161646
2005-06-01,Montana,727426,484873,465024,19849
2005-06-01,Nebraska,1323452,972611,935960,36651
2005-06-01,Nevada,1815436,1227044,1176365,50679
2005-06-01,Ohio,8815566,5880174,5536130,344044
2005-06-01,Oklahoma,2654453,1710037,1636192,73845
2005-06-01,Oregon,2819622,1849614,1735012,114602
2005-06-01,Pennsylvania,9695414,6260739,5951255,309484
2005-06-01,Tennessee,4604267,2891389,2733867,157522
2005-06-01,Texas,16595241,11163389,10569961,593428
2005-06-01,Utah,1774015,1279876,1227458,52418
2005-06-01,Vermont,495183,349161,337233,11928
2005-06-01,Virginia,5701112,3913106,3760577,152529
2005-06-01,Washington,4809877,3260163,3077493,182670
2005-06-01,Wisconsin,4282435,3026367,2884933,141434
2005-06-01,Wyoming,389407,279173,269233,9940
2005-07-01,Alabama,3476528,2141446,2049425,92021
2005-07-01,Alaska,480302,344616,321214,23402
2005-07-01,Arizona,4470636,2870449,2736262,134187
2005-07-01,Arkansas,2112310,1337609,1267612,69997
2005-07-01,California,26761285,17571326,16642343,928983
2005-07-01,Colorado,3547868,2571894,2443117,128777
2005-07-01,Connecticut,2676356,1797541,1711644,85897
2005-07-01,Delaware,645335,435162,415453,19709
2005-07-01,Florida,13912144,8679055,8440004,239051
2005-07-01,Georgia,6752872,4611806,4348844,262962
2005-07-01,Hawaii,951120,627667,610383,17284
2005-07-01,Idaho,1057079,733547,704126,29421
2005-07-01,Illinois,9609780,6415103,6048748,366355
2005-07-01,Indiana,4753203,3206552,3036250,170302
2005-07-01,Iowa,2275021,1631666,1562922,68744
2005-07-01,Kansas,2067785,1458268,1385522,72746
2005-07-01,Kentucky,3207234,1995787,1878884,116903
2005-07-01,Louisiana,3357249,2053798,1941390,112408
2005-07-01,Maine,1043312,697669,663284,34385
2005-07-01,Maryland,4255488,2938910,2808520,130390
2005-07-01,Massachusetts,5062501,3389380,3228732,160648
2005-07-01,Michigan,7736738,5071751,4736805,334946
2005-07-01,Minnesota,3928695,2885243,2769965,115278
2005-07-01,Mississippi,2151754,1331761,1236213,95548
2005-07-01,Missouri,4435880,3009855,2852209,157646
2005-07-01,Montana,728315,486068,466344,19724
2005-07-01,Nebraska,1324378,972543,936425,36118
2005-07-01,Nevada,1820663,1232503,1181486,51017
2005-07-01,Ohio,8819325,5885049,5544880,340169
2005-07-01,Oklahoma,2656290,1712048,1638056,73992
2005-07-01,Oregon,2823483,1851120,1737093,114027
2005-07-01,Pennsylvania,9700613,6263784,5956351,307433
2005-07-01,Tennessee,4610566,2897898,2742168,155730
2005-07-01,Texas,16621056,11181941,10586526,595415
2005-07-01,Utah,1778097,1284707,1233299,51408
2005-07-01,Vermont,495527,349868,337831,12037
2005-07-01,Virginia,5708868,3922403,3770468,151935
2005-07-01,Washington,4816608,3267255,3084845,182410
2005-07-01,Wisconsin,4286049,3031393,2888786,142607
2005-07-01,Wyoming,389729,279863,269845,10018
2005-08-01,Alabama,3480482,2144070,2052511,91559
2005-08-01,Alaska,481163,345128,321428,23700
2005-08-01,Arizona,4484551,2878393,2743723,134670
2005-08-01,Arkansas,2114958,1339765,1268919,70846
2005-08-01,California,26779322,17586567,16660840,925727
2005-08-01,Colorado,3554004,2575669,2448234,127435
2005-08-01,Connecticut,2677768,1800444,1714626,85818
2005-08-01,Delaware,646369,436916,416994,19922
2005-08-01,Florida,13934021,8704254,8470906,233348
2005-08-01,Georgia,6766443,4621335,4358286,263049
2005-08-01,Hawaii,951794,629176,611695,17481
2005-08-01,Idaho,1059593,734841,705881,28960
2005-08-01,Illinois,9614723,6419959,6057981,361978
2005-08-01,Indiana,4756761,3212832,3040900,171932
2005-08-01,Iowa,2276379,1633524,1564894,68630
2005-08-01,Kansas,2068690,1458670,1386265,72405
2005-08-01,Kentucky,3210624,1999069,1880045,119024
2005-08-01,Louisiana,3361183,2048166,1934284,113882
2005-08-01,Maine,1043947,698645,664096,34549
2005-08-01,Maryland,4258621,2942753,2813495,129258
2005-08-01,Massachusetts,5064723,3390341,3229086,161255
2005-08-01,Michigan,7738967,5070878,4738218,332660
2005-08-01,Minnesota,3932287,2884095,2768586,115509
2005-08-01,Mississippi,2155428,1332744,1236730,96014
2005-08-01,Missouri,4440311,3010684,2855649,155035
2005-08-01,Montana,729287,487195,467581,19614
2005-08-01,Nebraska,1325114,972541,936709,35832
2005-08-01,Nevada,1826077,1237385,1186098,51287
2005-08-01,Ohio,8822454,5889390,5550220,339170
2005-08-01,Oklahoma,2659280,1713560,1639307,74253
2005-08-01,Oregon,2828040,1852083,1738689,113394
2005-08-01,Pennsylvania,9706213,6265158,5957806,307352
2005-08-01,Tennessee,4617670,2904849,2749511,155338
2005-08-01,Texas,16656333,11198913,10597585,601328
2005-08-01,Utah,1782993,1288990,1238581,50409
2005-08-01,Vermont,495840,350538,338360,12178
2005-08-01,Virginia,5715542,3928582,3777612,150970
2005-08-01,Washington,4825124,3272992,3090829,182163
2005-08-01,Wisconsin,4289172,3036040,2891742,144298
2005-08-01,Wyoming,390245,280397,270322,10075
2005-09-01,Alabama,3484482,2146009,2054667,91342
2005-09-01,Alaska,482067,345532,321504,24028
2005-09-01,Arizona,4498643,2885335,2750192,135143
2005-09-01,Arkansas,2122332,1341047,1269841,71206
2005-09-01,California,26798546,17593070,16670184,922886
2005-09-01,Colorado,3560313,2580186,2453632,126554
2005-09-01,Connecticut,2679281,1803280,1717539,85741
2005-09-01,Delaware,647424,438472,418445,20027
2005-09-01,Florida,13956379,8723602,8495124,228478
2005-09-01,Georgia,6780106,4628993,4366401,262592
2005-09-01,Hawaii,952539,630132,612523,17609
2005-09-01,Idaho,1062135,735658,707285,28373
2005-09-01,Illinois,9619947,6424089,6066490,357599
2005-09-01,Indiana,4760357,3218431,3045291,173140
2005-09-01,Iowa,2277783,1635007,1566429,68578
2005-09-01,Kansas,2069677,1458875,1386742,72133
2005-09-01,Kentucky,3214075,2001269,1880085,121184
2005-09-01,Louisiana,3162488,2173136,1924844,248292
2005-09-01,Maine,1044621,699076,664456,34620
2005-09-01,Maryland,4261842,2945531,2817311,128220
2005-09-01,Massachusetts,5067045,3390494,3228461,162033
2005-09-01,Michigan,7741284,5070043,4737551,332492
2005-09-01,Minnesota,3935944,2882897,2766312,116585
2005-09-01,Mississippi,2159130,1316504,1187304,129200
2005-09-01,Missouri,4444835,3011492,2857909,153583
2005-09-01,Montana,730293,488098,468695,19403
2005-09-01,Nebraska,1325871,972334,936752,35582
2005-09-01,Nevada,1831478,1241575,1190337,51238
2005-09-01,Ohio,8825781,5893220,5553817,339403
2005-09-01,Oklahoma,2667366,1714235,1640181,74054
2005-09-01,Oregon,2832682,1852864,1740376,112488
2005-09-01,Pennsylvania,9711995,6264639,5956334,308305
2005-09-01,Tennessee,4624873,2912507,2756425,156082
2005-09-01,Texas,16739709,11211963,10604917,607046
2005-09-01,Utah,1787954,1292779,1243398,49381
2005-09-01,Vermont,496157,351183,338880,12303
2005-09-01,Virginia,5722306,3932245,3782825,149420
2005-09-01,Washington,4833784,3277523,3096373,181150
2005-09-01,Wisconsin,4292397,3039521,2893934,145587
2005-09-01,Wyoming,390750,280752,270691,10061
2005-10-01,Alabama,3491829,2147374,2056388,90986
2005-10-01,Alaska,483268,345831,321576,24255
2005-10-01,Arizona,4518189,2892105,2757019,135086
2005-10-01,Arkansas,2122332,1341579,1270710,70869
2005-10-01,California,26862414,17592258,16675256,917002
2005-10-01,Colorado,3570629,2585429,2460026,125403
2005-10-01,Connecticut,2683889,1806325,1720905,85420
2005-10-01,Delaware,649203,439827,419873,19954
2005-10-01,Florida,13997572,8739398,8515544,223854
2005-10-01,Georgia,6801551,4635374,4374745,260629
2005-10-01,Hawaii,954631,630555,612996,17559
2005-10-01,Idaho,1065643,736264,708439,27825
2005-10-01,Illinois,9636489,6428364,6076025,352339
2005-10-01,Indiana,4768332,3223149,3050395,172754
2005-10-01,Iowa,2281089,1636188,1568012,68176
2005-10-01,Kansas,2072575,1458597,1386985,71612
2005-10-01,Kentucky,3219936,2002716,1879980,122736
2005-10-01,Louisiana,3162488,2163281,1915795,247486
2005-10-01,Maine,1046097,699035,664565,34470
2005-10-01,Maryland,4270149,2947984,2821340,126644
2005-10-01,Massachusetts,5074742,3390374,3227977,162397
2005-10-01,Michigan,7751012,5069227,4735206,334021
2005-10-01,Minnesota,3943026,2882961,2764955,118006
2005-10-01,Mississippi,2123380,1303895,1186924,116971
2005-10-01,Missouri,4453081,3012033,2859392,152641
2005-10-01,Montana,731782,488697,469654,19043
2005-10-01,Nebraska,1327891,971736,936622,35114
2005-10-01,Nevada,1839147,1245346,1194538,50808
2005-10-01,Ohio,8836887,5896020,5557780,338240
2005-10-01,Oklahoma,2667366,1714020,1640951,73069
2005-10-01,Oregon,2839870,1853654,1742628,111026
2005-10-01,Pennsylvania,9727342,6262659,5954723,307936
2005-10-01,Tennessee,4636094,2920508,2763210,157298
2005-10-01,Texas,16739709,11221201,10612285,608916
2005-10-01,Utah,1794442,1296320,1248068,48252
2005-10-01,Vermont,496958,351830,339450,12380
2005-10-01,Virginia,5735305,3934813,3787789,147024
2005-10-01,Washington,4846818,3281368,3102575,178793
2005-10-01,Wisconsin,4299451,3041767,2895781,145986
2005-10-01,Wyoming,391594,280982,271027,9955
2005-11-01,Alabama,3495703,2148494,2058020,90474
2005-11-01,Alaska,484146,346027,321695,24332
2005-11-01,Arizona,4532715,2899289,2765037,134252
2005-11-01,Arkansas,2124968,1341840,1271732,70108
2005-11-01,California,26886799,17588199,16680410,907789
2005-11-01,Colorado,3577167,2591508,2467857,123651
2005-11-01,Connecticut,2685408,1809526,1724701,84825
2005-11-01,Delaware,650249,440907,421211,19696
2005-11-01,Florida,14020653,8754532,8534968,219564
2005-11-01,Georgia,6815405,4641476,4384358,257118
2005-11-01,Hawaii,955583,630663,613292,17371
2005-11-01,Idaho,1068173,736969,709484,27485
2005-11-01,Illinois,9642026,6433630,6087174,346456
2005-11-01,Indiana,4771850,3226653,3056076,170577
2005-11-01,Iowa,2282350,1637386,1570143,67243
2005-11-01,Kansas,2073513,1457882,1387093,70789
2005-11-01,Kentucky,3223221,2003954,1880622,123332
2005-11-01,Louisiana,3163098,2153374,1909121,244253
2005-11-01,Maine,1046684,698711,664644,34067
2005-11-01,Maryland,4273424,2950992,2826553,124439
2005-11-01,Massachusetts,5077035,3390390,3228125,162265
2005-11-01,Michigan,7753142,5068822,4731389,337433
2005-11-01,Minnesota,3946572,2884450,2765204,119246
2005-11-01,Mississippi,2123831,1297935,1186645,111290
2005-11-01,Missouri,4457379,3012555,2860770,151785
2005-11-01,Montana,732721,489065,470489,18576
2005-11-01,Nebraska,1328595,970846,936489,34357
2005-11-01,Nevada,1844820,1249182,1198920,50262
2005-11-01,Ohio,8839733,5897939,5562941,334998
2005-11-01,Oklahoma,2670374,1713063,1641639,71424
2005-11-01,Oregon,2844462,1854667,1745572,109095
2005-11-01,Pennsylvania,9732648,6260944,5955415,305529
2005-11-01,Tennessee,4643173,2928930,2770270,158660
2005-11-01,Texas,16746390,11227907,10621632,606275
2005-11-01,Utah,1799404,1299869,1252829,47040
2005-11-01,Vermont,497275,352432,340020,12412
2005-11-01,Virginia,5742125,3937586,3793610,143976
2005-11-01,Washington,4855511,3285007,3109758,175249
2005-11-01,Wisconsin,4302495,3043147,2897652,145495
2005-11-01,Wyoming,392128,281156,271399,9757
2005-12-01,Alabama,3499904,2149633,2059843,89790
2005-12-01,Alaska,485094,346169,321902,24267
2005-12-01,Arizona,4547225,2907204,2774501,132703
2005-12-01,Arkansas,2127798,1342120,1272820,69300
2005-12-01,California,26910607,17583772,16687569,896203
2005-12-01,Colorado,3583738,2598074,2476752,121322
2005-12-01,Connecticut,2687028,1812780,1728795,83985
2005-12-01,Delaware,651324,441628,422333,19295
2005-12-01,Florida,14044122,8770521,8554725,215796
2005-12-01,Georgia,6829755,4647812,4395233,252579
2005-12-01,Hawaii,956608,630664,613526,17138
2005-12-01,Idaho,1070764,737865,710506,27359
2005-12-01,Illinois,9648009,6439468,6099998,339470
2005-12-01,Indiana,4775674,3228693,3061470,167223
2005-12-01,Iowa,2283791,1639110,1573366,65744
2005-12-01,Kansas,2074556,1456928,1387302,69626
2005-12-01,Kentucky,3226778,2005232,1882447,122785
2005-12-01,Louisiana,3164830,2035834,1905605,130229
2005-12-01,Maine,1047375,698259,664823,33436
2005-12-01,Maryland,4277029,2954859,2832771,122088
2005-12-01,Massachusetts,5079565,3390351,3228651,161700
2005-12-01,Michigan,7755832,5068366,4726467,341899
2005-12-01,Minnesota,3950331,2885850,2766158,119692
2005-12-01,Mississippi,2125280,1283148,1186761,96387
2005-12-01,Missouri,4462051,3013355,2862756,150599
2005-12-01,Montana,733738,489365,471289,18076
2005-12-01,Nebraska,1329407,969870,936544,33326
2005-12-01,Nevada,1850497,1253457,1203581,49876
2005-12-01,Ohio,8843248,5898850,5568986,329864
2005-12-01,Oklahoma,2673539,1711566,1642007,69559
2005-12-01,Oregon,2849175,1856074,1749282,106792
2005-12-01,Pennsylvania,9738584,6260644,5958684,301960
2005-12-01,Tennessee,4650602,2937905,2778144,159761
2005-12-01,Texas,16761096,11233098,10633045,600053
2005-12-01,Utah,1804466,1303593,1257816,45777
2005-12-01,Vermont,497626,352929,340528,12401
2005-12-01,Virginia,5749362,3940662,3800223,140439
2005-12-01,Washington,4864388,3288548,3117441,171107
2005-12-01,Wisconsin,4305860,3043904,2899804,144100
2005-12-01,Wyoming,392682,281322,271850,9472
2006-01-01,Alabama,3503666,2151174,2062219,88955
2006-01-01,Alaska,485968,346388,322315,24073
2006-01-01,Arizona,4561185,2916314,2785456,130858
2006-01-01,Arkansas,2130322,1342700,1273915,68785
2006-01-01,California,26930839,17582550,16698861,883689
2006-01-01,Colorado,3589857,2605057,2486296,118761
2006-01-01,Connecticut,2688340,1816063,1733100,82963
2006-01-01,Delaware,652379,442004,423215,18789
2006-01-01,Florida,14065590,8789465,8576664,212801
2006-01-01,Georgia,6843197,4654813,4406965,247848
2006-01-01,Hawaii,957451,630827,613850,16977
2006-01-01,Idaho,1073261,738902,711591,27311
2006-01-01,Illinois,9652716,6446086,6115270,330816
2006-01-01,Indiana,4778850,3230070,3066477,163593
2006-01-01,Iowa,2284916,1641849,1578060,63789
2006-01-01,Kansas,2075320,1455936,1387766,68170
2006-01-01,Kentucky,3229869,2006831,1885679,121152
2006-01-01,Louisiana,3166964,2003932,1905404,98528
2006-01-01,Maine,1047909,697917,665201,32716
2006-01-01,Maryland,4280040,2959519,2839370,120149
2006-01-01,Massachusetts,5081434,3390788,3229944,160844
2006-01-01,Michigan,7757479,5067923,4722032,345891
2006-01-01,Minnesota,3953580,2886377,2767467,118910
2006-01-01,Mississippi,2127247,1275110,1187661,87449
2006-01-01,Missouri,4466089,3014631,2865710,148921
2006-01-01,Montana,734619,489832,472225,17607
2006-01-01,Nebraska,1330057,969001,936904,32097
2006-01-01,Nevada,1855912,1258441,1208656,49785
2006-01-01,Ohio,8845558,5900385,5577335,323050
2006-01-01,Oklahoma,2676326,1710025,1642205,67820
2006-01-01,Oregon,2853540,1858333,1753954,104379
2006-01-01,Pennsylvania,9743262,6262494,5964453,298041
2006-01-01,Tennessee,4657345,2948616,2788197,160419
2006-01-01,Texas,16781676,11240453,10647444,593009
2006-01-01,Utah,1809287,1307644,1263185,44459
2006-01-01,Vermont,497880,353344,340982,12362
2006-01-01,Virginia,5755845,3944531,3807796,136735
2006-01-01,Washington,4872643,3292718,3125422,167296
2006-01-01,Wisconsin,4308593,3044830,2902831,141999
2006-01-01,Wyoming,393128,281549,272423,9126
2006-02-01,Alabama,3507068,2153411,2065225,88186
2006-02-01,Alaska,486740,346742,322936,23806
2006-02-01,Arizona,4574548,2926379,2796970,129409
2006-02-01,Arkansas,2132647,1343722,1274911,68811
2006-02-01,California,26947217,17587038,16714377,872661
2006-02-01,Colorado,3595664,2612418,2495895,116523
2006-02-01,Connecticut,2689362,1819226,1737275,81951
2006-02-01,Delaware,653305,442164,423908,18256
2006-02-01,Florida,14085252,8812184,8601209,210975
2006-02-01,Georgia,6856084,4662900,4418947,243953
2006-02-01,Hawaii,958135,631267,614296,16971
2006-02-01,Idaho,1075601,739890,712681,27209
2006-02-01,Illinois,9656519,6453903,6133097,320806
2006-02-01,Indiana,4781693,3231598,3070849,160749
2006-02-01,Iowa,2285822,1645442,1583664,61778
2006-02-01,Kansas,2075909,1455091,1388411,66680
2006-02-01,Kentucky,3232798,2008797,1889872,118925
2006-02-01,Louisiana,3169757,1998960,1907657,91303
2006-02-01,Maine,1048355,697805,665670,32135
2006-02-01,Maryland,4282638,2964849,2845544,119305
2006-02-01,Massachusetts,5082903,3392290,3232254,160036
2006-02-01,Michigan,7758526,5067483,4718738,348745
2006-02-01,Minnesota,3956568,2886107,2768846,117261
2006-02-01,Mississippi,2129927,1272806,1189293,83513
2006-02-01,Missouri,4469775,3016412,2869483,146929
2006-02-01,Montana,735491,490715,473484,17231
2006-02-01,Nebraska,1330588,968388,937521,30867
2006-02-01,Nevada,1861136,1264123,1214044,50079
2006-02-01,Ohio,8847270,5904768,5588283,316485
2006-02-01,Oklahoma,2678907,1708921,1642490,66431
2006-02-01,Oregon,2857633,1861625,1759373,102252
2006-02-01,Pennsylvania,9747075,6267038,5972062,294976
2006-02-01,Tennessee,4663797,2961842,2800802,161040
2006-02-01,Texas,16808414,11253367,10664814,588553
2006-02-01,Utah,1814025,1311981,1268854,43127
2006-02-01,Vermont,498164,353706,341368,12338
2006-02-01,Virginia,5761823,3949380,3815798,133582
2006-02-01,Washington,4880489,3297951,3133200,164751
2006-02-01,Wisconsin,4311099,3046724,2906854,139870
2006-02-01,Wyoming,393646,281877,273094,8783
2006-03-01,Alabama,3510348,2156335,2068505,87830
2006-03-01,Alaska,487558,347278,323717,23561
2006-03-01,Arizona,4587109,2937047,2808195,128852
2006-03-01,Arkansas,2134861,1345046,1275609,69437
2006-03-01,California,26956842,17596774,16730993,865781
2006-03-01,Colorado,3601065,2620070,2504897,115173
2006-03-01,Connecticut,2690127,1822224,1741020,81204
2006-03-01,Delaware,654229,442256,424429,17827
2006-03-01,Florida,14102496,8837309,8626543,210766
2006-03-01,Georgia,6868440,4672236,4430502,241734
2006-03-01,Hawaii,958572,631983,614874,17109
2006-03-01,Idaho,1077916,740751,713742,27009
2006-03-01,Illinois,9659302,6463382,6152425,310957
2006-03-01,Indiana,4784419,3233382,3073794,159588
2006-03-01,Iowa,2286724,1649127,1588911,60216
2006-03-01,Kansas,2076427,1454601,1389076,65525
2006-03-01,Kentucky,3235660,2011065,1894196,116869
2006-03-01,Louisiana,3174981,1995431,1910602,84829
2006-03-01,Maine,1048785,697986,666098,31888
2006-03-01,Maryland,4284856,2970542,2850446,120096
2006-03-01,Massachusetts,5084043,3394962,3235249,159713
2006-03-01,Michigan,7759212,5066385,4715647,350738
2006-03-01,Minnesota,3959476,2885094,2769722,115372
2006-03-01,Mississippi,2134966,1271087,1191197,79890
2006-03-01,Missouri,4473367,3019077,2873689,145388
2006-03-01,Montana,736318,492075,475078,16997
2006-03-01,Nebraska,1331045,968167,938255,29912
2006-03-01,Nevada,1866056,1270318,1219558,50760
2006-03-01,Ohio,8848684,5912662,5599950,312712
2006-03-01,Oklahoma,2681324,1708593,1642958,65635
2006-03-01,Oregon,2861501,1865808,1765028,100780
2006-03-01,Pennsylvania,9750419,6273630,5979608,294022
2006-03-01,Tennessee,4670063,2976996,2814715,162281
2006-03-01,Texas,16856023,11272128,10683983,588145
2006-03-01,Utah,1818717,1316509,1274637,41872
2006-03-01,Vermont,498398,354035,341639,12396
2006-03-01,Virginia,5767386,3954870,3823250,131620
2006-03-01,Washington,4888004,3304104,3140073,164031
2006-03-01,Wisconsin,4313453,3049844,2911405,138439
2006-03-01,Wyoming,394067,282331,273809,8522
2006-04-01,Alabama,3513803,2159713,2071802,87911
2006-04-01,Alaska,488418,347940,324533,23407
2006-04-01,Arizona,4599748,2947857,2818660,129197
2006-04-01,Arkansas,2137212,1346255,1275834,70421
2006-04-01,California,26966975,17609415,16745349,864066
2006-04-01,Colorado,3606595,2627673,2512768,114905
2006-04-01,Connecticut,2690984,1824847,1743960,80887
2006-04-01,Delaware,655160,442353,424748,17605
2006-04-01,Florida,14120197,8863169,8650938,212231
2006-04-01,Georgia,6881073,4682594,4441462,241132
2006-04-01,Hawaii,959152,632898,615623,17275
2006-04-01,Idaho,1080272,741494,714784,26710
2006-04-01,Illinois,9662467,6474739,6171881,302858
2006-04-01,Indiana,4787349,3234908,3074689,160219
2006-04-01,Iowa,2287744,1652328,1592837,59491
2006-04-01,Kansas,2076998,1457490,1392614,64876
2006-04-01,Kentucky,3238700,2013756,1898114,115642
2006-04-01,Louisiana,3180290,1992841,1912614,80227
2006-04-01,Maine,1049273,698519,666474,32045
2006-04-01,Maryland,4287265,2976119,2853647,122472
2006-04-01,Massachusetts,5085460,3398710,3238568,160142
2006-04-01,Michigan,7760312,5064429,4711722,352707
2006-04-01,Minnesota,3962617,2883712,2769949,113763
2006-04-01,Mississippi,2140074,1272591,1193090,79501
2006-04-01,Missouri,4477206,3022984,2877879,145105
2006-04-01,Montana,737179,493679,476780,16899
2006-04-01,Nebraska,1331622,968417,939016,29401
2006-04-01,Nevada,1871057,1276714,1225043,51671
2006-04-01,Ohio,8850579,5923616,5610899,312717
2006-04-01,Oklahoma,2683861,1709125,1643647,65478
2006-04-01,Oregon,2865540,1870498,1770303,100195
2006-04-01,Pennsylvania,9754252,6281330,5985668,295662
2006-04-01,Tennessee,4676556,2993120,2828835,164285
2006-04-01,Texas,16903616,11294298,10704340,589958
2006-04-01,Utah,1823477,1321063,1280361,40702
2006-04-01,Vermont,498663,354370,341788,12582
2006-04-01,Virginia,5773199,3960510,3829433,131077
2006-04-01,Washington,4895740,3311209,3146142,165067
2006-04-01,Wisconsin,4316003,3054068,2915742,138326
2006-04-01,Wyoming,394526,282905,274513,8392
2006-05-01,Alabama,3517270,2163359,2075386,87973
2006-05-01,Alaska,489223,348562,325248,23314
2006-05-01,Arizona,4612292,2958210,2828396,129814
2006-05-01,Arkansas,2139601,1346847,1275583,71264
2006-05-01,California,26975501,17622725,16757871,864854
2006-05-01,Colorado,3612117,2634815,2519556,115259
2006-05-01,Connecticut,2691896,1826938,1746106,80832
2006-05-01,Delaware,656124,442483,424936,17547
2006-05-01,Florida,14138018,8888754,8674278,214476
2006-05-01,Georgia,6893679,4693623,4452478,241145
2006-05-01,Hawaii,959626,633852,616564,17288
2006-05-01,Idaho,1082700,742127,715861,26266
2006-05-01,Illinois,9665568,6488248,6191538,296710
2006-05-01,Indiana,4790472,3235765,3073913,161852
2006-05-01,Iowa,2288903,1654729,1595166,59563
2006-05-01,Kansas,2077663,1460742,1396157,64585
2006-05-01,Kentucky,3241908,2017039,1901829,115210
2006-05-01,Louisiana,3185670,1991641,1913803,77838
2006-05-01,Maine,1049820,699299,666812,32487
2006-05-01,Maryland,4289562,2981172,2855605,125567
2006-05-01,Massachusetts,5086934,3403308,3242339,160969
2006-05-01,Michigan,7761618,5061963,4706902,355061
2006-05-01,Minnesota,3965924,2882539,2769759,112780
2006-05-01,Mississippi,2145215,1274797,1195081,79716
2006-05-01,Missouri,4481216,3028016,2882003,146013
2006-05-01,Montana,738094,495157,478285,16872
2006-05-01,Nebraska,1332250,969109,939813,29296
2006-05-01,Nevada,1875961,1282975,1230505,52470
2006-05-01,Ohio,8852737,5936851,5621439,315412
2006-05-01,Oklahoma,2686494,1710449,1644742,65707
2006-05-01,Oregon,2869684,1875141,1774854,100287
2006-05-01,Pennsylvania,9758456,6288804,5990267,298537
2006-05-01,Tennessee,4683186,3008468,2842377,166091
2006-05-01,Texas,16950545,11316310,10726117,590193
2006-05-01,Utah,1828395,1325529,1286032,39497
2006-05-01,Vermont,498974,354749,341898,12851
2006-05-01,Virginia,5779056,3965991,3834431,131560
2006-05-01,Washington,4903582,3318875,3152061,166814
2006-05-01,Wisconsin,4318785,3059089,2919686,139403
2006-05-01,Wyoming,395045,283567,275179,8388
2006-06-01,Alabama,3520846,2167159,2079399,87760
2006-06-01,Alaska,490098,349037,325825,23212
2006-06-01,Arizona,4625438,2967768,2837632,130136
2006-06-01,Arkansas,2142069,1346705,1274991,71714
2006-06-01,California,26988015,17635569,16770248,865321
2006-06-01,Colorado,3617894,2641282,2525693,115589
2006-06-01,Connecticut,2692943,1828775,1747945,80830
2006-06-01,Delaware,657087,442683,425140,17543
2006-06-01,Florida,14157040,8913367,8696519,216848
2006-06-01,Georgia,6906479,4705063,4464013,241050
2006-06-01,Hawaii,960179,634758,617722,17036
2006-06-01,Idaho,1085185,742774,717041,25733
2006-06-01,Illinois,9669194,6503286,6210984,292302
2006-06-01,Indiana,4793709,3235953,3072514,163439
2006-06-01,Iowa,2290118,1656339,1596192,60147
2006-06-01,Kansas,2078448,1464180,1399759,64421
2006-06-01,Kentucky,3245138,2020968,1905580,115388
2006-06-01,Louisiana,3190999,1992413,1915199,77214
2006-06-01,Maine,1050414,700153,667096,33057
2006-06-01,Maryland,4292028,2985290,2857042,128248
2006-06-01,Massachusetts,5088681,3408276,3246530,161746
2006-06-01,Michigan,7763097,5058880,4701332,357548
2006-06-01,Minnesota,3969353,2882243,2769472,112771
2006-06-01,Mississippi,2150308,1277358,1197221,80137
2006-06-01,Missouri,4485298,3033601,2886066,147535
2006-06-01,Montana,739054,496176,479335,16841
2006-06-01,Nebraska,1332910,970087,940667,29420
2006-06-01,Nevada,1881059,1288880,1235957,52923
2006-06-01,Ohio,8855024,5950887,5631674,319213
2006-06-01,Oklahoma,2689206,1711998,1645917,66081
2006-06-01,Oregon,2873984,1879552,1778796,100756
2006-06-01,Pennsylvania,9762883,6295098,5994139,300959
2006-06-01,Tennessee,4689861,3021272,2854682,166590
2006-06-01,Texas,16999573,11335374,10749064,586310
2006-06-01,Utah,1833309,1329902,1291669,38233
2006-06-01,Vermont,499285,355183,342044,13139
2006-06-01,Virginia,5785117,3971300,3838785,132515
2006-06-01,Washington,4911633,3326358,3158117,168241
2006-06-01,Wisconsin,4321688,3064326,2923138,141188
2006-06-01,Wyoming,395531,284276,275795,8481
2006-07-01,Alabama,3524489,2171367,2084065,87302
2006-07-01,Alaska,490950,349357,326290,23067
2006-07-01,Arizona,4638684,2977028,2847274,129754
2006-07-01,Arkansas,2144577,1346289,1274581,71708
2006-07-01,California,27001429,17650474,16786840,863634
2006-07-01,Colorado,3623832,2647155,2532065,115090
2006-07-01,Connecticut,2694086,1830942,1750241,80701
2006-07-01,Delaware,658065,442992,425528,17464
2006-07-01,Florida,14176539,8938216,8719152,219064
2006-07-01,Georgia,6919458,4717188,4476911,240277
2006-07-01,Hawaii,960755,635731,619244,16487
2006-07-01,Idaho,1087671,743753,718495,25258
2006-07-01,Illinois,9673133,6519819,6230966,288853
2006-07-01,Indiana,4797047,3236278,3072207,164071
2006-07-01,Iowa,2291405,1657590,1596824,60766
2006-07-01,Kansas,2079254,1467807,1403581,64226
2006-07-01,Kentucky,3248465,2025779,1910088,115691
2006-07-01,Louisiana,3196377,1994902,1917341,77561
2006-07-01,Maine,1051012,701038,667451,33587
2006-07-01,Maryland,4294599,2988845,2859174,129671
2006-07-01,Massachusetts,5090541,3413405,3251310,162095
2006-07-01,Michigan,7764767,5055515,4696148,359367
2006-07-01,Minnesota,3972847,2883675,2769850,113825
2006-07-01,Mississippi,2155425,1280178,1199699,80479
2006-07-01,Missouri,4489492,3039402,2890439,148963
2006-07-01,Montana,739999,496676,479942,16734
2006-07-01,Nebraska,1333638,971231,941724,29507
2006-07-01,Nevada,1886237,1294646,1241605,53041
2006-07-01,Ohio,8857512,5964470,5641744,322726
2006-07-01,Oklahoma,2692022,1713704,1647247,66457
2006-07-01,Oregon,2878329,1883930,1782598,101332
2006-07-01,Pennsylvania,9767552,6300948,5999284,301664
2006-07-01,Tennessee,4696684,3031107,2865935,165172
2006-07-01,Texas,17049031,11351838,10775124,576714
2006-07-01,Utah,1838305,1334478,1297521,36957
2006-07-01,Vermont,499602,355703,342294,13409
2006-07-01,Virginia,5791297,3976954,3843635,133319
2006-07-01,Washington,4919842,3333760,3165012,168748
2006-07-01,Wisconsin,4324694,3069428,2926323,143105
2006-07-01,Wyoming,396049,285048,276434,8614
2006-08-01,Alabama,3527515,2176026,2089301,86725
2006-08-01,Alaska,491379,349634,326706,22928
2006-08-01,Arizona,4649714,2986508,2857798,128710
2006-08-01,Arkansas,2146566,1346217,1274701,71516
2006-08-01,California,27025634,17671419,16810113,861306
2006-08-01,Colorado,3629927,2652385,2538867,113518
2006-08-01,Connecticut,2695372,1833746,1753195,80551
2006-08-01,Delaware,658964,443425,426171,17254
2006-08-01,Florida,14191932,8964208,8742603,221605
2006-08-01,Georgia,6933287,4730491,4491354,239137
2006-08-01,Hawaii,961394,636833,621045,15788
2006-08-01,Idaho,1089894,745184,720255,24929
2006-08-01,Illinois,9679632,6537794,6251061,286733
2006-08-01,Indiana,4800663,3237482,3073727,163755
2006-08-01,Iowa,2292788,1659099,1597910,61189
2006-08-01,Kansas,2080872,1471727,1407676,64051
2006-08-01,Kentucky,3250741,2031652,1915782,115870
2006-08-01,Louisiana,3204857,1998749,1920481,78268
2006-08-01,Maine,1051575,702011,668042,33969
2006-08-01,Maryland,4297454,2992402,2862631,129771
2006-08-01,Massachusetts,5094563,3418840,3256631,162209
2006-08-01,Michigan,7766182,5052872,4691989,360883
2006-08-01,Minnesota,3976524,2887166,2771111,116055
2006-08-01,Mississippi,2156898,1283338,1202508,80830
2006-08-01,Missouri,4493471,3045228,2895141,150087
2006-08-01,Montana,740941,496874,480340,16534
2006-08-01,Nebraska,1334445,972530,943039,29491
2006-08-01,Nevada,1890994,1300611,1247515,53096
2006-08-01,Ohio,8861768,5978031,5652208,325823
2006-08-01,Oklahoma,2694318,1715726,1648772,66954
2006-08-01,Oregon,2882700,1888427,1786546,101881
2006-08-01,Pennsylvania,9773593,6307766,6007146,300620
2006-08-01,Tennessee,4702407,3038347,2876327,162020
2006-08-01,Texas,17079249,11367207,10804130,563077
2006-08-01,Utah,1842871,1339519,1303704,35815
2006-08-01,Vermont,499853,356239,342595,13644
2006-08-01,Virginia,5797279,3983653,3849897,133756
2006-08-01,Washington,4927599,3341319,3172753,168566
2006-08-01,Wisconsin,4327819,3074307,2929287,145020
2006-08-01,Wyoming,396711,285874,277156,8718
2006-09-01,Alabama,3530831,2180689,2094591,86098
2006-09-01,Alaska,491865,349874,327071,22803
2006-09-01,Arizona,4661126,2995813,2868713,127100
2006-09-01,Arkansas,2148699,1346678,1275263,71415
2006-09-01,California,27052081,17699166,16838653,860513
2006-09-01,Colorado,3636313,2656964,2545785,111179
2006-09-01,Connecticut,2696847,1836913,1756417,80496
2006-09-01,Delaware,659891,443955,427015,16940
2006-09-01,Florida,14208495,8990679,8765814,224865
2006-09-01,Georgia,6947670,4744336,4506631,237705
2006-09-01,Hawaii,962139,637954,622790,15164
2006-09-01,Idaho,1092208,746840,722205,24635
2006-09-01,Illinois,9686923,6555585,6268521,287064
2006-09-01,Indiana,4804585,3238710,3075872,162838
2006-09-01,Iowa,2294361,1661018,1599582,61436
2006-09-01,Kansas,2082641,1475958,1411988,63970
2006-09-01,Kentucky,3253218,2038086,1922152,115934
2006-09-01,Louisiana,3213610,2003637,1924375,79262
2006-09-01,Maine,1052220,703009,668866,34143
2006-09-01,Maryland,4300680,2995782,2866926,128856
2006-09-01,Massachusetts,5098896,3424172,3261883,162289
2006-09-01,Michigan,7768125,5050900,4688983,361917
2006-09-01,Minnesota,3980510,2892049,2772961,119088
2006-09-01,Mississippi,2158536,1286478,1205340,81138
2006-09-01,Missouri,4497734,3050585,2899808,150777
2006-09-01,Montana,741949,497008,480753,16255
2006-09-01,Nebraska,1335339,973920,944455,29465
2006-09-01,Nevada,1895903,1306774,1253515,53259
2006-09-01,Ohio,8866608,5990760,5662364,328396
2006-09-01,Oklahoma,2696751,1718058,1650292,67766
2006-09-01,Oregon,2887241,1892988,1790709,102279
2006-09-01,Pennsylvania,9780250,6315598,6017276,298322
2006-09-01,Tennessee,4708406,3043505,2885641,157864
2006-09-01,Texas,17110941,11381736,10832912,548824
2006-09-01,Utah,1847529,1344922,1310071,34851
2006-09-01,Vermont,500114,356647,342812,13835
2006-09-01,Virginia,5803659,3991266,3857489,133777
2006-09-01,Washington,4935665,3348767,3180801,167966
2006-09-01,Wisconsin,4331183,3078965,2932001,146964
2006-09-01,Wyoming,397410,286704,277957,8747
2006-10-01,Alabama,3534233,2184587,2099223,85364
2006-10-01,Alaska,492363,350052,327406,22646
2006-10-01,Arizona,4672561,3004252,2879213,125039
2006-10-01,Arkansas,2150924,1347720,1276360,71360
2006-10-01,California,27078759,17731148,16870354,860794
2006-10-01,Colorado,3642735,2660820,2552545,108275
2006-10-01,Connecticut,2698356,1840211,1759811,80400
2006-10-01,Delaware,660866,444511,427949,16562
2006-10-01,Florida,14225236,9016846,8788180,228666
2006-10-01,Georgia,6962267,4757415,4521848,235567
2006-10-01,Hawaii,962862,638975,624209,14766
2006-10-01,Idaho,1094511,748469,724217,24252
2006-10-01,Illinois,9694364,6570891,6281776,289115
2006-10-01,Indiana,4808630,3239074,3078111,160963
2006-10-01,Iowa,2295947,1662986,1601611,61375
2006-10-01,Kansas,2084444,1478938,1415081,63857
2006-10-01,Kentucky,3255793,2043869,1928275,115594
2006-10-01,Louisiana,3222460,2009343,1928865,80478
2006-10-01,Maine,1052853,703851,669845,34006
2006-10-01,Maryland,4304017,2998354,2871256,127098
2006-10-01,Massachusetts,5103347,3428730,3266745,161985
2006-10-01,Michigan,7770240,5048765,4687689,361076
2006-10-01,Minnesota,3984539,2897203,2775300,121903
2006-10-01,Mississippi,2160264,1289198,1207813,81385
2006-10-01,Missouri,4502085,3054914,2904208,150706
2006-10-01,Montana,742968,497327,481487,15840
2006-10-01,Nebraska,1336273,975160,945823,29337
2006-10-01,Nevada,1900824,1312862,1259390,53472
2006-10-01,Ohio,8871588,6001365,5672001,329364
2006-10-01,Oklahoma,2699281,1720521,1651829,68692
2006-10-01,Oregon,2891842,1897606,1795512,102094
2006-10-01,Pennsylvania,9787133,6323451,6028619,294832
2006-10-01,Tennessee,4714580,3047672,2894538,153134
2006-10-01,Texas,17142922,11394861,10859232,535629
2006-10-01,Utah,1852277,1350404,1316400,34004
2006-10-01,Vermont,500437,356823,342892,13931
2006-10-01,Virginia,5810214,3999235,3866151,133084
2006-10-01,Washington,4943864,3355850,3189139,166711
2006-10-01,Wisconsin,4334726,3083012,2934814,148198
2006-10-01,Wyoming,398110,287463,278828,8635
2006-11-01,Alabama,3537230,2187215,2102582,84633
2006-11-01,Alaska,492811,350202,327755,22447
2006-11-01,Arizona,4683513,3011163,2888274,122889
2006-11-01,Arkansas,2152890,1349135,1277814,71321
2006-11-01,California,27103225,17763499,16900814,862685
2006-11-01,Colorado,3648895,2663422,2558561,104861
2006-11-01,Connecticut,2699575,1843373,1763165,80208
2006-11-01,Delaware,661769,444980,428750,16230
2006-11-01,Florida,14240024,9041667,8808471,233196
2006-11-01,Georgia,6976303,4768552,4535543,233009
2006-11-01,Hawaii,963638,639733,625059,14674
2006-11-01,Idaho,1096757,749884,726133,23751
2006-11-01,Illinois,9700854,6581859,6289937,291922
2006-11-01,Indiana,4812269,3238109,3079821,158288
2006-11-01,Iowa,2297319,1664385,1603265,61120
2006-11-01,Kansas,2086023,1484594,1420985,63609
2006-11-01,Kentucky,3258054,2047981,1933255,114726
2006-11-01,Louisiana,3230986,2015113,1933463,81650
2006-11-01,Maine,1053411,704327,670736,33591
2006-11-01,Maryland,4306848,2999434,2874673,124761
2006-11-01,Massachusetts,5107225,3432017,3270894,161123
2006-11-01,Michigan,7771568,5045048,4686860,358188
2006-11-01,Minnesota,3988221,2901587,2777537,124050
2006-11-01,Mississippi,2161794,1291444,1209651,81793
2006-11-01,Missouri,4506029,3057697,2907850,149847
2006-11-01,Montana,743938,498025,482717,15308
2006-11-01,Nebraska,1337076,975966,947007,28959
2006-11-01,Nevada,1905607,1318570,1264827,53743
2006-11-01,Ohio,8875607,6008981,5680298,328683
2006-11-01,Oklahoma,2701509,1722979,1653494,69485
2006-11-01,Oregon,2896151,1901918,1800823,101095
2006-11-01,Pennsylvania,9792714,6329667,6039226,290441
2006-11-01,Tennessee,4720259,3050954,2902791,148163
2006-11-01,Texas,17173555,11405690,10881093,524597
2006-11-01,Utah,1856935,1355691,1322348,33343
2006-11-01,Vermont,500707,356762,342822,13940
2006-11-01,Virginia,5816239,4006703,3874981,131722
2006-11-01,Washington,4951564,3362320,3197583,164737
2006-11-01,Wisconsin,4337810,3085923,2937397,148526
2006-11-01,Wyoming,398800,288093,279707,8386
2006-12-01,Alabama,3539975,2188157,2104100,84057
2006-12-01,Alaska,493209,350246,328038,22208
2006-12-01,Arizona,4694090,3015741,2894953,120788
2006-12-01,Arkansas,2154700,1350471,1279168,71303
2006-12-01,California,27125539,17791249,16924622,866627
2006-12-01,Colorado,3654689,2664298,2563203,101095
2006-12-01,Connecticut,2700572,1845968,1766016,79952
2006-12-01,Delaware,662605,445217,429217,16000
2006-12-01,Florida,14253857,9063204,8824665,238539
2006-12-01,Georgia,6989645,4776763,4546384,230379
2006-12-01,Hawaii,964323,640049,625186,14863
2006-12-01,Idaho,1098875,750946,727798,23148
2006-12-01,Illinois,9706507,6587537,6292132,295405
2006-12-01,Indiana,4815412,3234565,3079521,155044
2006-12-01,Iowa,2298473,1664469,1603613,60856
2006-12-01,Kansas,2087411,1485269,1421997,63272
2006-12-01,Kentucky,3260036,2049777,1936376,113401
2006-12-01,Louisiana,3239209,2019911,1937175,82736
2006-12-01,Maine,1053865,704222,671172,33050
2006-12-01,Maryland,4309390,2998285,2876346,121939
2006-12-01,Massachusetts,5110695,3433704,3273958,159746
2006-12-01,Michigan,7772247,5038631,4684597,354034
2006-12-01,Minnesota,3991537,2904402,2778889,125513
2006-12-01,Mississippi,2163100,1292752,1210528,82224
2006-12-01,Missouri,4509532,3058416,2909972,148444
2006-12-01,Montana,744795,499089,484328,14761
2006-12-01,Nebraska,1337751,976178,947798,28380
2006-12-01,Nevada,1910243,1323560,1269442,54118
2006-12-01,Ohio,8878875,6013359,5686100,327259
2006-12-01,Oklahoma,2703508,1725014,1654984,70030
2006-12-01,Oregon,2900173,1905040,1805631,99409
2006-12-01,Pennsylvania,9797592,6332288,6046688,285600
2006-12-01,Tennessee,4725564,3052604,2909137,143467
2006-12-01,Texas,17202612,11412317,10896648,515669
2006-12-01,Utah,1861354,1360400,1327488,32912
2006-12-01,Vermont,500907,356469,342563,13906
2006-12-01,Virginia,5821739,4012705,3882705,130000
2006-12-01,Washington,4958849,3367727,3205651,162076
2006-12-01,Wisconsin,4340530,3087289,2939043,148246
2006-12-01,Wyoming,399410,288545,280486,8059
2007-01-01,Alabama,3542815,2187339,2103550,83789
2007-01-01,Alaska,493664,350083,328102,21981
2007-01-01,Arizona,4704694,3017695,2899008,118687
2007-01-01,Arkansas,2156533,1351331,1279989,71342
2007-01-01,California,27148345,17811829,16938382,873447
2007-01-01,Colorado,3660570,2663897,2566479,97418
2007-01-01,Connecticut,2701606,1848030,1768257,79773
2007-01-01,Delaware,663461,445183,429285,15898
2007-01-01,Florida,14267753,9079865,8835015,244850
2007-01-01,Georgia,7003265,4781979,4553801,228178
2007-01-01,Hawaii,965074,639907,624680,15227
2007-01-01,Idaho,1101043,751704,729172,22532
2007-01-01,Illinois,9712343,6589487,6289431,300056
2007-01-01,Indiana,4818643,3227858,3076193,151665
2007-01-01,Iowa,2299627,1663289,1602493,60796
2007-01-01,Kansas,2088878,1485282,1422275,63007
2007-01-01,Kentucky,3262037,2049214,1937338,111876
2007-01-01,Louisiana,3247530,2022840,1939101,83739
2007-01-01,Maine,1054293,703506,670974,32532
2007-01-01,Maryland,4312014,2994895,2875951,118944
2007-01-01,Massachusetts,5114213,3434072,3275858,158214
2007-01-01,Michigan,7773003,5029796,4679591,350205
2007-01-01,Minnesota,3994866,2905237,2778670,126567
2007-01-01,Mississippi,2164477,1292826,1210328,82498
2007-01-01,Missouri,4513113,3057457,2910257,147200
2007-01-01,Montana,745694,500327,485966,14361
2007-01-01,Nebraska,1338456,976001,948140,27861
2007-01-01,Nevada,1914899,1327708,1273015,54693
2007-01-01,Ohio,8882233,6015798,5688698,327100
2007-01-01,Oklahoma,2705529,1726172,1655845,70327
2007-01-01,Oregon,2904260,1906671,1809169,97502
2007-01-01,Pennsylvania,9802460,6331494,6050069,281425
2007-01-01,Tennessee,4730893,3051958,2912489,139469
2007-01-01,Texas,17232072,11413662,10905100,508562
2007-01-01,Utah,1865807,1364352,1331564,32788
2007-01-01,Vermont,501089,355976,342115,13861
2007-01-01,Virginia,5827381,4016723,3888251,128472
2007-01-01,Washington,4966166,3371978,3213005,158973
2007-01-01,Wisconsin,4343261,3087107,2939387,147720
2007-01-01,Wyoming,400067,288825,281087,7738
2007-02-01,Alabama,3545167,2185202,2101371,83831
2007-02-01,Alaska,494007,349811,327999,21812
2007-02-01,Arizona,4714781,3017647,2901286,116361
2007-02-01,Arkansas,2158081,1351478,1279970,71508
2007-02-01,California,27168086,17826788,16943822,882966
2007-02-01,Colorado,3666058,2663475,2569153,94322
2007-02-01,Connecticut,2702303,1849724,1769948,79776
2007-02-01,Delaware,664226,444987,429060,15927
2007-02-01,Florida,14279851,9091891,8839714,252177
2007-02-01,Georgia,7016065,4785242,4558332,226910
2007-02-01,Hawaii,965632,639382,623747,15635
2007-02-01,Idaho,1103046,752358,730389,21969
2007-02-01,Illinois,9717097,6591137,6285513,305624
2007-02-01,Indiana,4821332,3218753,3070366,148387
2007-02-01,Iowa,2300517,1661602,1600672,60930
2007-02-01,Kansas,2090053,1484899,1422087,62812
2007-02-01,Kentucky,3263696,2046911,1936545,110366
2007-02-01,Louisiana,3255510,2023956,1939168,84788
2007-02-01,Maine,1054627,702423,670267,32156
2007-02-01,Maryland,4314108,2990228,2874136,116092
2007-02-01,Massachusetts,5117238,3433865,3277054,156811
2007-02-01,Michigan,7772855,5019800,4672378,347422
2007-02-01,Minnesota,3997795,2904324,2776911,127413
2007-02-01,Mississippi,2165618,1291912,1209476,82436
2007-02-01,Missouri,4516134,3055861,2909172,146689
2007-02-01,Montana,746466,501476,487228,14248
2007-02-01,Nebraska,1338983,975808,948238,27570
2007-02-01,Nevada,1919343,1331183,1275701,55482
2007-02-01,Ohio,8884607,6017630,5689064,328566
2007-02-01,Oklahoma,2707226,1726322,1655815,70507
2007-02-01,Oregon,2907965,1906967,1811075,95892
2007-02-01,Pennsylvania,9806222,6328908,6050384,278524
2007-02-01,Tennessee,4735729,3049020,2912944,136076
2007-02-01,Texas,17259736,11411958,10908743,503215
2007-02-01,Utah,1870120,1367666,1334719,32947
2007-02-01,Vermont,501269,355401,341580,13821
2007-02-01,Virginia,5832389,4019179,3891877,127302
2007-02-01,Washington,4972954,3375862,3219836,156026
2007-02-01,Wisconsin,4345498,3086120,2938906,147214
2007-02-01,Wyoming,400707,289039,281520,7519
2007-03-01,Alabama,3547626,2182257,2098155,84102
2007-03-01,Alaska,494382,349471,327774,21697
2007-03-01,Arizona,4724746,3015955,2902281,113674
2007-03-01,Arkansas,2159672,1350887,1279107,71780
2007-03-01,California,27186717,17837732,16944145,893587
2007-03-01,Colorado,3671548,2664085,2572031,92054
2007-03-01,Connecticut,2703036,1850803,1770914,79889
2007-03-01,Delaware,665035,444654,428670,15984
2007-03-01,Florida,14291739,9099437,8839277,260160
2007-03-01,Georgia,7028941,4787416,4560839,226577
2007-03-01,Hawaii,966129,638441,622449,15992
2007-03-01,Idaho,1105085,752994,731466,21528
2007-03-01,Illinois,9721893,6594491,6283126,311365
2007-03-01,Indiana,4824188,3208405,3063073,145332
2007-03-01,Iowa,2301493,1659975,1598932,61043
2007-03-01,Kansas,2091299,1484163,1421613,62550
2007-03-01,Kentucky,3265475,2043296,1934313,108983
2007-03-01,Louisiana,3263490,2023695,1937949,85746
2007-03-01,Maine,1054996,701102,669145,31957
2007-03-01,Maryland,4316235,2985200,2871826,113374
2007-03-01,Massachusetts,5120326,3433170,3277638,155532
2007-03-01,Michigan,7772871,5009740,4664185,345555
2007-03-01,Minnesota,4000855,2902138,2774014,128124
2007-03-01,Mississippi,2166767,1290406,1208538,81868
2007-03-01,Missouri,4519323,3054108,2907025,147083
2007-03-01,Montana,747297,502396,487908,14488
2007-03-01,Nebraska,1339583,975800,948254,27546
2007-03-01,Nevada,1923771,1334075,1277645,56430
2007-03-01,Ohio,8887255,6018863,5688428,330435
2007-03-01,Oklahoma,2708997,1725376,1654906,70470
2007-03-01,Oregon,2911736,1906174,1811295,94879
2007-03-01,Pennsylvania,9810236,6325867,6049127,276740
2007-03-01,Tennessee,4740652,3044434,2911363,133071
2007-03-01,Texas,17286779,11408395,10909724,498671
2007-03-01,Utah,1874494,1370319,1337078,33241
2007-03-01,Vermont,501453,354803,341022,13781
2007-03-01,Virginia,5837444,4020557,3894124,126433
2007-03-01,Washington,4979787,3379685,3226114,153571
2007-03-01,Wisconsin,4347897,3084887,2938058,146829
2007-03-01,Wyoming,401306,289270,281824,7446
2007-04-01,Alabama,3550367,2179466,2094744,84722
2007-04-01,Alaska,494816,349168,327497,21671
2007-04-01,Arizona,4735194,3013261,2902557,110704
2007-04-01,Arkansas,2161464,1349996,1277800,72196
2007-04-01,California,27208433,17848998,16944007,904991
2007-04-01,Colorado,3677433,2666633,2575603,91030
2007-04-01,Connecticut,2703993,1851481,1771391,80090
2007-04-01,Delaware,665843,444310,428349,15961
2007-04-01,Florida,14305044,9103305,8834580,268725
2007-04-01,Georgia,7042417,4789823,4562579,227244
2007-04-01,Hawaii,966815,637218,620930,16288
2007-04-01,Idaho,1107207,753743,732433,21310
2007-04-01,Illinois,9727632,6601114,6284088,317026
2007-04-01,Indiana,4827419,3198676,3055662,143014
2007-04-01,Iowa,2302638,1658797,1597745,61052
2007-04-01,Kansas,2092707,1483334,1421088,62246
2007-04-01,Kentucky,3267511,2039096,1931178,107918
2007-04-01,Louisiana,3271780,2022494,1936224,86270
2007-04-01,Maine,1055438,699674,667728,31946
2007-04-01,Maryland,4318781,2981141,2870098,111043
2007-04-01,Massachusetts,5123854,3432208,3277798,154410
2007-04-01,Michigan,7773549,5000964,4656111,344853
2007-04-01,Minnesota,4004225,2899693,2770677,129016
2007-04-01,Mississippi,2168121,1288973,1208054,80919
2007-04-01,Missouri,4522851,3052781,2904486,148295
2007-04-01,Montana,748152,503141,488072,15069
2007-04-01,Nebraska,1340253,976138,948372,27766
2007-04-01,Nevada,1928351,1336648,1279106,57542
2007-04-01,Ohio,8890662,6019476,5686963,332513
2007-04-01,Oklahoma,2711001,1723712,1653537,70175
2007-04-01,Oregon,2915785,1905062,1810393,94669
2007-04-01,Pennsylvania,9815062,6324317,6048045,276272
2007-04-01,Tennessee,4745983,3039561,2908711,130850
2007-04-01,Texas,17315600,11405711,10910668,495043
2007-04-01,Utah,1878974,1372517,1338904,33613
2007-04-01,Vermont,501644,354210,340469,13741
2007-04-01,Virginia,5843053,4021773,3895919,125854
2007-04-01,Washington,4987100,3383635,3231633,152002
2007-04-01,Wisconsin,4350635,3084013,2937255,146758
2007-04-01,Wyoming,401915,289584,282060,7524
2007-05-01,Alabama,3553057,2177514,2091810,85704
2007-05-01,Alaska,495225,349067,327322,21745
2007-05-01,Arizona,4745562,3010820,2902959,107861
2007-05-01,Arkansas,2163259,1349262,1276423,72839
2007-05-01,California,27228543,17864179,16945471,918708
2007-05-01,Colorado,3683212,2671638,2580013,91625
2007-05-01,Connecticut,2704965,1852382,1771872,80510
2007-05-01,Delaware,666703,444108,428254,15854
2007-05-01,Florida,14318164,9104735,8826525,278210
2007-05-01,Georgia,7055680,4793806,4564652,229154
2007-05-01,Hawaii,967396,635993,619428,16565
2007-05-01,Idaho,1109395,754736,733266,21470
2007-05-01,Illinois,9733064,6612003,6288680,323323
2007-05-01,Indiana,4830704,3191090,3049045,142045
2007-05-01,Iowa,2303875,1658248,1597178,61070
2007-05-01,Kansas,2094137,1482871,1420764,62107
2007-05-01,Kentucky,3269599,2035221,1927722,107499
2007-05-01,Louisiana,3279938,2020880,1934816,86064
2007-05-01,Maine,1055909,698469,666311,32158
2007-05-01,Maryland,4321081,2979361,2869725,109636
2007-05-01,Massachusetts,5127404,3431323,3277616,153707
2007-05-01,Michigan,7774209,4994572,4648398,346174
2007-05-01,Minnesota,4007656,2897960,2767511,130449
2007-05-01,Mississippi,2169389,1288212,1208301,79911
2007-05-01,Missouri,4526429,3052676,2902173,150503
2007-05-01,Montana,749055,503837,487924,15913
2007-05-01,Nebraska,1340978,976883,948707,28176
2007-05-01,Nevada,1932909,1339270,1280394,58876
2007-05-01,Ohio,8893985,6019240,5683902,335338
2007-05-01,Oklahoma,2713002,1721952,1652156,69796
2007-05-01,Oregon,2919845,1904550,1809031,95519
2007-05-01,Pennsylvania,9819965,6326189,6048133,278056
2007-05-01,Tennessee,4751300,3036040,2905735,130305
2007-05-01,Texas,17343816,11406369,10913440,492929
2007-05-01,Utah,1883565,1374601,1340503,34098
2007-05-01,Vermont,501915,353648,339909,13739
2007-05-01,Virginia,5848525,4023984,3898080,125904
2007-05-01,Washington,4994344,3388302,3236416,151886
2007-05-01,Wisconsin,4353467,3084018,2936652,147366
2007-05-01,Wyoming,402568,290015,282297,7718
2007-06-01,Alabama,3555840,2176642,2089809,86833
2007-06-01,Alaska,495672,349218,327344,21874
2007-06-01,Arizona,4756223,3009749,2904001,105748
2007-06-01,Arkansas,2165134,1348840,1275317,73523
2007-06-01,California,27250665,17884308,16949426,934882
2007-06-01,Colorado,3689241,2678950,2585195,93755
2007-06-01,Connecticut,2706011,1853582,1772394,81188
2007-06-01,Delaware,667547,444095,428382,15713
2007-06-01,Florida,14332124,9105560,8817098,288462
2007-06-01,Georgia,7069217,4799738,4567895,231843
2007-06-01,Hawaii,968049,634988,618131,16857
2007-06-01,Idaho,1111626,755825,733862,21963
2007-06-01,Illinois,9738987,6626590,6295927,330663
2007-06-01,Indiana,4834163,3186811,3044087,142724
2007-06-01,Iowa,2305187,1658520,1597354,61166
2007-06-01,Kansas,2095692,1482976,1420851,62125
2007-06-01,Kentucky,3271781,2032318,1924641,107677
2007-06-01,Louisiana,3288245,2019628,1934783,84845
2007-06-01,Maine,1056469,697735,665225,32510
2007-06-01,Maryland,4323615,2980361,2871146,109215
2007-06-01,Massachusetts,5131157,3430837,3277367,153470
2007-06-01,Michigan,7775181,4990740,4641105,349635
2007-06-01,Minnesota,4011308,2897126,2764914,132212
2007-06-01,Mississippi,2170706,1288461,1209455,79006
2007-06-01,Missouri,4530219,3053868,2900452,153416
2007-06-01,Montana,749995,504589,487728,16861
2007-06-01,Nebraska,1341787,978010,949273,28737
2007-06-01,Nevada,1937559,1342122,1281753,60369
2007-06-01,Ohio,8897675,6018239,5679913,338326
2007-06-01,Oklahoma,2715153,1720786,1651389,69397
2007-06-01,Oregon,2924062,1905140,1807945,97195
2007-06-01,Pennsylvania,9825270,6331860,6050019,281841
2007-06-01,Tennessee,4756801,3035028,2903157,131871
2007-06-01,Texas,17373223,11411196,10919419,491777
2007-06-01,Utah,1888192,1376750,1342100,34650
2007-06-01,Vermont,502139,353120,339337,13783
2007-06-01,Virginia,5854226,4028150,3901236,126914
2007-06-01,Washington,5001907,3394186,3241007,153179
2007-06-01,Wisconsin,4356491,3084946,2936311,148635
2007-06-01,Wyoming,403237,290549,282594,7955
2007-07-01,Alabama,3558681,2176801,2088783,88018
2007-07-01,Alaska,496104,349601,327600,22001
2007-07-01,Arizona,4766960,3010496,2905303,105193
2007-07-01,Arkansas,2167028,1348878,1274796,74082
2007-07-01,California,27272732,17909056,16955401,953655
2007-07-01,Colorado,3695257,2687730,2590676,97054
2007-07-01,Connecticut,2707103,1855062,1772917,82145
2007-07-01,Delaware,668413,444306,428680,15626
2007-07-01,Florida,14346248,9107665,8808067,299598
2007-07-01,Georgia,7082742,4807351,4572460,234891
2007-07-01,Hawaii,968654,634347,617083,17264
2007-07-01,Idaho,1113839,756838,734072,22766
2007-07-01,Illinois,9744901,6643166,6304082,339084
2007-07-01,Indiana,4837626,3186509,3041603,144906
2007-07-01,Iowa,2306506,1659537,1598096,61441
2007-07-01,Kansas,2097234,1483761,1421335,62426
2007-07-01,Kentucky,3274004,2030626,1922179,108447
2007-07-01,Louisiana,3296552,2020024,1937021,83003
2007-07-01,Maine,1056994,697547,664650,32897
2007-07-01,Maryland,4326118,2983555,2874060,109495
2007-07-01,Massachusetts,5134949,3430818,3277176,153642
2007-07-01,Michigan,7776164,4988759,4634339,354420
2007-07-01,Minnesota,4014920,2896892,2762772,134120
2007-07-01,Mississippi,2172054,1289829,1211517,78312
2007-07-01,Missouri,4533977,3056144,2899507,156637
2007-07-01,Montana,750920,505402,487649,17753
2007-07-01,Nebraska,1342569,979315,949989,29326
2007-07-01,Nevada,1942229,1345169,1283216,61953
2007-07-01,Ohio,8901395,6016911,5676080,340831
2007-07-01,Oklahoma,2717277,1720470,1651470,69000
2007-07-01,Oregon,2928298,1907026,1807857,99169
2007-07-01,Pennsylvania,9830577,6340420,6053546,286874
2007-07-01,Tennessee,4762302,3036405,2900885,135520
2007-07-01,Texas,17402744,11421250,10928845,492405
2007-07-01,Utah,1892813,1378927,1343693,35234
2007-07-01,Vermont,502403,352634,338784,13850
2007-07-01,Virginia,5859929,4034464,3905389,129075
2007-07-01,Washington,5009419,3401159,3245815,155344
2007-07-01,Wisconsin,4359501,3086615,2936378,150237
2007-07-01,Wyoming,403916,291070,282958,8112
2007-08-01,Alabama,3561917,2177930,2088560,89370
2007-08-01,Alaska,496548,350146,328057,22089
2007-08-01,Arizona,4776490,3013553,2906699,106854
2007-08-01,Arkansas,2168911,1349562,1275104,74458
2007-08-01,California,27303913,17937431,16962173,975258
2007-08-01,Colorado,3701828,2697211,2596232,100979
2007-08-01,Connecticut,2709153,1857126,1773734,83392
2007-08-01,Delaware,669353,444788,429083,15705
2007-08-01,Florida,14359617,9113142,8801072,312070
2007-08-01,Georgia,7093411,4816462,4578064,238398
2007-08-01,Hawaii,969244,634307,616467,17840
2007-08-01,Idaho,1115743,757610,733890,23720
2007-08-01,Illinois,9751568,6659740,6311421,348319
2007-08-01,Indiana,4841311,3189936,3042056,147880
2007-08-01,Iowa,2307852,1661174,1599243,61931
2007-08-01,Kansas,2098568,1485166,1422076,63090
2007-08-01,Kentucky,3277367,2030101,1920430,109671
2007-08-01,Louisiana,3301976,2022752,1941466,81286
2007-08-01,Maine,1057594,697898,664625,33273
2007-08-01,Maryland,4329119,2987929,2877897,110032
2007-08-01,Massachusetts,5139706,3431305,3277143,154162
2007-08-01,Michigan,7776510,4987655,4628409,359246
2007-08-01,Minnesota,4018335,2896949,2760940,136009
2007-08-01,Mississippi,2173543,1292419,1214328,78091
2007-08-01,Missouri,4538164,3059270,2899435,159835
2007-08-01,Montana,751782,506257,487785,18472
2007-08-01,Nebraska,1343491,980593,950869,29724
2007-08-01,Nevada,1945510,1348473,1284830,63643
2007-08-01,Ohio,8904792,6015646,5672744,342902
2007-08-01,Oklahoma,2719731,1721008,1652431,68577
2007-08-01,Oregon,2932301,1910361,1809306,101055
2007-08-01,Pennsylvania,9836784,6351089,6058375,292714
2007-08-01,Tennessee,4768036,3039495,2898731,140764
2007-08-01,Texas,17433249,11437858,10942199,495659
2007-08-01,Utah,1896507,1381216,1345301,35915
2007-08-01,Vermont,502642,352250,338324,13926
2007-08-01,Virginia,5866159,4042707,3910208,132499
2007-08-01,Washington,5016731,3409111,3251381,157730
2007-08-01,Wisconsin,4362443,3088677,2936986,151691
2007-08-01,Wyoming,404543,291531,283401,8130
2007-09-01,Alabama,3565336,2179782,2088878,90904
2007-09-01,Alaska,496997,350731,328614,22117
2007-09-01,Arizona,4786223,3018977,2908422,110555
2007-09-01,Arkansas,2170921,1350759,1276385,74374
2007-09-01,California,27336405,17966927,16969958,996969
2007-09-01,Colorado,3708531,2706470,2601718,104752
2007-09-01,Connecticut,2711285,1859938,1775209,84729
2007-09-01,Delaware,670273,445525,429558,15967
2007-09-01,Florida,14373626,9122980,8797471,325509
2007-09-01,Georgia,7104351,4826570,4584166,242404
2007-09-01,Hawaii,969891,634954,616466,18488
2007-09-01,Idaho,1117698,757879,733406,24473
2007-09-01,Illinois,9758656,6674906,6317812,357094
2007-09-01,Indiana,4845110,3196416,3045872,150544
2007-09-01,Iowa,2309268,1663352,1600949,62403
2007-09-01,Kansas,2100032,1486755,1422954,63801
2007-09-01,Kentucky,3280860,2030322,1919801,110521
2007-09-01,Louisiana,3307526,2027354,1947292,80062
2007-09-01,Maine,1058224,698665,665148,33517
2007-09-01,Maryland,4332260,2992773,2882585,110188
2007-09-01,Massachusetts,5144605,3432460,3277791,154669
2007-09-01,Michigan,7777126,4986270,4623665,362605
2007-09-01,Minnesota,4021916,2897029,2759599,137430
2007-09-01,Mississippi,2175146,1295815,1217572,78243
2007-09-01,Missouri,4542485,3062504,2900171,162333
2007-09-01,Montana,752706,507153,488205,18948
2007-09-01,Nebraska,1344485,981750,951958,29792
2007-09-01,Nevada,1948879,1352002,1286632,65370
2007-09-01,Ohio,8908449,6015396,5671388,344008
2007-09-01,Oklahoma,2722273,1722237,1654437,67800
2007-09-01,Oregon,2936407,1914597,1812240,102357
2007-09-01,Pennsylvania,9843273,6362760,6064488,298272
2007-09-01,Tennessee,4773950,3043398,2896840,146558
2007-09-01,Texas,17464661,11459823,10960290,499533
2007-09-01,Utah,1900303,1383625,1346964,36661
2007-09-01,Vermont,502894,352038,338053,13985
2007-09-01,Virginia,5872564,4052349,3915752,136597
2007-09-01,Washington,5024250,3417771,3258296,159475
2007-09-01,Wisconsin,4365543,3090646,2938383,152263
2007-09-01,Wyoming,405178,291994,283956,8038
2007-10-01,Alabama,3568596,2181628,2088944,92684
2007-10-01,Alaska,497450,351277,329175,22102
2007-10-01,Arizona,4795667,3026157,2910471,115686
2007-10-01,Arkansas,2172797,1352032,1278323,73709
2007-10-01,California,27367418,17993950,16976329,1017621
2007-10-01,Colorado,3715036,2714544,2606543,108001
2007-10-01,Connecticut,2713317,1862997,1776872,86125
2007-10-01,Delaware,671234,446439,430080,16359
2007-10-01,Florida,14386906,9135500,8795668,339832
2007-10-01,Georgia,7115031,4836836,4589565,247271
2007-10-01,Hawaii,970511,636095,617035,19060
2007-10-01,Idaho,1119585,757432,732664,24768
2007-10-01,Illinois,9765252,6687735,6322851,364884
2007-10-01,Indiana,4848744,3204215,3051752,152463
2007-10-01,Iowa,2310605,1665743,1603116,62627
2007-10-01,Kansas,2101341,1487983,1423641,64342
2007-10-01,Kentucky,3284212,2030463,1919867,110596
2007-10-01,Louisiana,3312952,2032731,1952978,79753
2007-10-01,Maine,1058844,699588,666019,33569
2007-10-01,Maryland,4335243,2997232,2887521,109711
2007-10-01,Massachusetts,5149281,3434433,3279271,155162
2007-10-01,Michigan,7777378,4983547,4619463,364084
2007-10-01,Minnesota,4025298,2897040,2758855,138185
2007-10-01,Mississippi,2176634,1299111,1220565,78546
2007-10-01,Missouri,4546601,3064788,2900818,163970
2007-10-01,Montana,753561,508080,488870,19210
2007-10-01,Nebraska,1345387,982695,953057,29638
2007-10-01,Nevada,1952165,1355515,1288393,67122
2007-10-01,Ohio,8911693,6016279,5671830,344449
2007-10-01,Oklahoma,2724649,1723543,1657137,66406
2007-10-01,Oregon,2940386,1918769,1815958,102811
2007-10-01,Pennsylvania,9849346,6373535,6070703,302832
2007-10-01,Tennessee,4779666,3046663,2894542,152121
2007-10-01,Texas,17495067,11484031,10981282,502749
2007-10-01,Utah,1904011,1385953,1348475,37478
2007-10-01,Vermont,503126,351966,337926,14040
2007-10-01,Virginia,5878751,4062269,3921492,140777
2007-10-01,Washington,5031493,3426353,3266024,160329
2007-10-01,Wisconsin,4368458,3091929,2940541,151388
2007-10-01,Wyoming,405800,292498,284587,7911
2007-11-01,Alabama,3571609,2182775,2088237,94538
2007-11-01,Alaska,497891,351710,329677,22033
2007-11-01,Arizona,4804966,3033968,2912955,121013
2007-11-01,Arkansas,2174594,1352941,1280515,72426
2007-11-01,California,27397478,18015561,16980264,1035297
2007-11-01,Colorado,3721443,2721095,2610602,110493
2007-11-01,Connecticut,2715153,1865712,1778299,87413
2007-11-01,Delaware,672135,447478,430714,16764
2007-11-01,Florida,14399166,9148193,8793740,354453
2007-11-01,Georgia,7125436,4846765,4594075,252690
2007-11-01,Hawaii,971191,637526,618088,19438
2007-11-01,Idaho,1121480,756280,731723,24557
2007-11-01,Illinois,9771394,6697912,6327482,370430
2007-11-01,Indiana,4852139,3211460,3058115,153345
2007-11-01,Iowa,2311802,1667996,1605547,62449
2007-11-01,Kansas,2102572,1488571,1424075,64496
2007-11-01,Kentucky,3287457,2029895,1919969,109926
2007-11-01,Louisiana,3318199,2038038,1957597,80441
2007-11-01,Maine,1059364,700420,667037,33383
2007-11-01,Maryland,4337998,3000787,2892173,108614
2007-11-01,Massachusetts,5153707,3437265,3281811,155454
2007-11-01,Michigan,7777233,4978443,4615704,362739
2007-11-01,Minnesota,4028498,2896893,2758896,137997
2007-11-01,Mississippi,2178005,1301574,1222882,78692
2007-11-01,Missouri,4550492,3065589,2900868,164721
2007-11-01,Montana,754430,508950,489629,19321
2007-11-01,Nebraska,1346253,983488,954064,29424
2007-11-01,Nevada,1955382,1358745,1289934,68811
2007-11-01,Ohio,8914436,6016931,5673416,343515
2007-11-01,Oklahoma,2726950,1724548,1660213,64335
2007-11-01,Oregon,2944204,1922205,1819994,102211
2007-11-01,Pennsylvania,9854658,6382502,6076768,305734
2007-11-01,Tennessee,4785177,3048534,2891923,156611
2007-11-01,Texas,17525088,11508120,11004022,504098
2007-11-01,Utah,1907684,1387937,1349690,38247
2007-11-01,Vermont,503341,351983,337899,14084
2007-11-01,Virginia,5884697,4071799,3927530,144269
2007-11-01,Washington,5038548,3434198,3274082,160116
2007-11-01,Wisconsin,4371156,3092492,2943825,148667
2007-11-01,Wyoming,406411,293057,285260,7797
2007-12-01,Alabama,3574475,2183086,2086564,96522
2007-12-01,Alaska,498284,352134,330190,21944
2007-12-01,Arizona,4813893,3041613,2915755,125858
2007-12-01,Arkansas,2176232,1353447,1282727,70720
2007-12-01,California,27425922,18032573,16982149,1050424
2007-12-01,Colorado,3727619,2726104,2613895,112209
2007-12-01,Connecticut,2716819,1867928,1779384,88544
2007-12-01,Delaware,672993,448554,431428,17126
2007-12-01,Florida,14410520,9159259,8789788,369471
2007-12-01,Georgia,7135470,4856726,4598040,258686
2007-12-01,Hawaii,971788,639094,619435,19659
2007-12-01,Idaho,1123263,754691,730659,24032
2007-12-01,Illinois,9776966,6705536,6332204,373332
2007-12-01,Indiana,4855240,3217636,3064296,153340
2007-12-01,Iowa,2312834,1670033,1608126,61907
2007-12-01,Kansas,2103675,1488603,1424446,64157
2007-12-01,Kentucky,3290467,2028679,1919790,108889
2007-12-01,Louisiana,3323283,2042821,1961120,81701
2007-12-01,Maine,1059861,701031,668042,32989
2007-12-01,Maryland,4340521,3003897,2896480,107417
2007-12-01,Massachusetts,5157761,3440566,3284993,155573
2007-12-01,Michigan,7776660,4970964,4611446,359518
2007-12-01,Minnesota,4031466,2896769,2759616,137153
2007-12-01,Mississippi,2179312,1303016,1224337,78679
2007-12-01,Missouri,4554148,3065251,2900324,164927
2007-12-01,Montana,755224,509732,490367,19365
2007-12-01,Nebraska,1347008,984217,955010,29207
2007-12-01,Nevada,1958465,1361625,1291127,70498
2007-12-01,Ohio,8916628,6016753,5675653,341100
2007-12-01,Oklahoma,2729061,1725382,1663681,61701
2007-12-01,Oregon,2947849,1924688,1824021,100667
2007-12-01,Pennsylvania,9859441,6390393,6083501,306892
2007-12-01,Tennessee,4790396,3049619,2889792,159827
2007-12-01,Texas,17553909,11531148,11027674,503474
2007-12-01,Utah,1911237,1389416,1350526,38890
2007-12-01,Vermont,503532,352068,337945,14123
2007-12-01,Virginia,5890286,4081055,3934313,146742
2007-12-01,Washington,5045286,3441083,3281863,159220
2007-12-01,Wisconsin,4373577,3092618,2948303,144315
2007-12-01,Wyoming,406998,293644,285941,7703
2008-01-01,Alabama,3577198,2182712,2083744,98968
2008-01-01,Alaska,498693,352640,330728,21912
2008-01-01,Arizona,4822624,3048650,2918156,130494
2008-01-01,Arkansas,2177814,1353678,1284620,69058
2008-01-01,California,27453421,18047064,16979728,1067336
2008-01-01,Colorado,3733587,2729192,2615692,113500
2008-01-01,Connecticut,2718370,1869605,1779846,89759
2008-01-01,Delaware,673835,449481,432002,17479
2008-01-01,Florida,14421176,9166494,8780743,385751
2008-01-01,Georgia,7145219,4866898,4601237,265661
2008-01-01,Hawaii,972401,640525,620658,19867
2008-01-01,Idaho,1125010,753003,729462,23541
2008-01-01,Illinois,9782110,6709673,6334043,375630
2008-01-01,Indiana,4858075,3222317,3068926,153391
2008-01-01,Iowa,2313758,1671514,1610160,61354
2008-01-01,Kansas,2104656,1488330,1424783,63547
2008-01-01,Kentucky,3293294,2027269,1919001,108268
2008-01-01,Louisiana,3328228,2046613,1963488,83125
2008-01-01,Maine,1060238,701344,668746,32598
2008-01-01,Maryland,4342905,3006981,2899910,107071
2008-01-01,Massachusetts,5161571,3443336,3287272,156064
2008-01-01,Michigan,7775722,4962050,4604930,357120
2008-01-01,Minnesota,4034155,2896805,2760194,136611
2008-01-01,Mississippi,2180462,1303465,1224659,78806
2008-01-01,Missouri,4557530,3064242,2899013,165229
2008-01-01,Montana,755967,510364,490873,19491
2008-01-01,Nebraska,1347708,984852,955811,29041
2008-01-01,Nevada,1961491,1364101,1291670,72431
2008-01-01,Ohio,8918397,6014754,5675960,338794
2008-01-01,Oklahoma,2731019,1726265,1667262,59003
2008-01-01,Oregon,2951299,1925863,1827073,98790
2008-01-01,Pennsylvania,9863659,6397499,6090155,307344
2008-01-01,Tennessee,4795355,3050278,2887750,162528
2008-01-01,Texas,17582139,11551722,11049469,502253
2008-01-01,Utah,1914712,1390196,1350736,39460
2008-01-01,Vermont,503680,352192,337980,14212
2008-01-01,Virginia,5895643,4089713,3941102,148611
2008-01-01,Washington,5051757,3446781,3288083,158698
2008-01-01,Wisconsin,4375769,3092444,2952857,139587
2008-01-01,Wyoming,407544,294176,286531,7645
2008-02-01,Alabama,3579499,2182002,2079970,102032
2008-02-01,Alaska,499046,353200,331231,21969
2008-02-01,Arizona,4830910,3055250,2919912,135338
2008-02-01,Arkansas,2179102,1353823,1286093,67730
2008-02-01,California,27479147,18061461,16972015,1089446
2008-02-01,Colorado,3739334,2730710,2615827,114883
2008-02-01,Connecticut,2719672,1871046,1779792,91254
2008-02-01,Delaware,674570,450124,432276,17848
2008-02-01,Florida,14430272,9169252,8765562,403690
2008-02-01,Georgia,7154305,4877596,4604149,273447
2008-02-01,Hawaii,972875,641682,621470,20212
2008-02-01,Idaho,1126616,751556,728191,23365
2008-02-01,Illinois,9786404,6708900,6329578,379322
2008-02-01,Indiana,4860492,3225717,3071079,154638
2008-02-01,Iowa,2314422,1672496,1611271,61225
2008-02-01,Kansas,2105468,1488077,1425145,62932
2008-02-01,Kentucky,3295867,2026297,1917658,108639
2008-02-01,Louisiana,3332810,2049281,1964932,84349
2008-02-01,Maine,1060512,701507,669081,32426
2008-02-01,Maryland,4344772,3010368,2902178,108190
2008-02-01,Massachusetts,5164974,3445463,3288107,157356
2008-02-01,Michigan,7773898,4952602,4595514,357088
2008-02-01,Minnesota,4036544,2897217,2760058,137159
2008-02-01,Mississippi,2181475,1302924,1223753,79171
2008-02-01,Missouri,4560490,3063107,2897024,166083
2008-02-01,Montana,756618,510816,491021,19795
2008-02-01,Nebraska,1348302,985443,956411,29032
2008-02-01,Nevada,1964358,1366231,1291488,74743
2008-02-01,Ohio,8919307,6011252,5672357,338895
2008-02-01,Oklahoma,2732742,1727384,1670591,56793
2008-02-01,Oregon,2954500,1926271,1828799,97472
2008-02-01,Pennsylvania,9866910,6403801,6095607,308194
2008-02-01,Tennessee,4799873,3050932,2884998,165934
2008-02-01,Texas,17609205,11569544,11068110,501434
2008-02-01,Utah,1918073,1390331,1350305,40026
2008-02-01,Vermont,503793,352351,337975,14376
2008-02-01,Virginia,5900482,4097974,3947359,150615
2008-02-01,Washington,5057807,3451561,3292130,159431
2008-02-01,Wisconsin,4377602,3092050,2956324,135726
2008-02-01,Wyoming,408100,294628,286996,7632
2008-03-01,Alabama,3582052,2181312,2075441,105871
2008-03-01,Alaska,499412,353867,331722,22145
2008-03-01,Arizona,4839400,3062260,2920981,141279
2008-03-01,Arkansas,2180553,1354111,1287098,67013
2008-03-01,California,27505162,18079489,16958869,1120620
2008-03-01,Colorado,3745254,2731524,2614588,116936
2008-03-01,Connecticut,2721142,1872549,1779225,93324
2008-03-01,Delaware,675366,450558,432198,18360
2008-03-01,Florida,14439993,9169367,8745057,424310
2008-03-01,Georgia,7163749,4889427,4607194,282233
2008-03-01,Hawaii,973332,642622,621796,20826
2008-03-01,Idaho,1128349,750634,726940,23694
2008-03-01,Illinois,9791250,6703482,6317160,386322
2008-03-01,Indiana,4863316,3229511,3071330,158181
2008-03-01,Iowa,2315303,1673699,1611773,61926
2008-03-01,Kansas,2106418,1488306,1425587,62719
2008-03-01,Kentucky,3298681,2026753,1916245,110508
2008-03-01,Louisiana,3337626,2051196,1966079,85117
2008-03-01,Maine,1060902,701834,669166,32668
2008-03-01,Maryland,4346938,3014563,2903324,111239
2008-03-01,Massachusetts,5168747,3448080,3288084,159996
2008-03-01,Michigan,7772766,4943787,4583166,360621
2008-03-01,Minnesota,4039257,2898610,2759179,139431
2008-03-01,Mississippi,2182554,1301731,1221681,80050
2008-03-01,Missouri,4563774,3062698,2894477,168221
2008-03-01,Montana,757375,511130,490799,20331
2008-03-01,Nebraska,1348963,986086,956801,29285
2008-03-01,Nevada,1967341,1368224,1290616,77608
2008-03-01,Ohio,8920917,6008457,5664400,344057
2008-03-01,Oklahoma,2734661,1729075,1673464,55611
2008-03-01,Oregon,2957914,1927307,1829599,97708
2008-03-01,Pennsylvania,9870932,6410873,6099944,310929
2008-03-01,Tennessee,4804746,3052029,2881036,170993
2008-03-01,Texas,17636630,11587968,11084171,503797
2008-03-01,Utah,1921544,1390054,1349332,40722
2008-03-01,Vermont,503985,352567,337934,14633
2008-03-01,Virginia,5905631,4106722,3952938,153784
2008-03-01,Washington,5064189,3456754,3294563,162191
2008-03-01,Wisconsin,4379735,3091763,2957863,133900
2008-03-01,Wyoming,408662,295041,287354,7687
2008-04-01,Alabama,3584693,2180544,2070085,110459
2008-04-01,Alaska,499825,354642,332225,22417
2008-04-01,Arizona,4848008,3070618,2921370,149248
2008-04-01,Arkansas,2182082,1354740,1287626,67114
2008-04-01,California,27532092,18102490,16940096,1162394
2008-04-01,Colorado,3751342,2732182,2612373,119809
2008-04-01,Connecticut,2722664,1874146,1778038,96108
2008-04-01,Delaware,676171,450833,431703,19130
2008-04-01,Florida,14449961,9168749,8720582,448167
2008-04-01,Georgia,7173457,4902145,4609997,292148
2008-04-01,Hawaii,973900,643304,621515,21789
2008-04-01,Idaho,1130104,756944,725740,31204
2008-04-01,Illinois,9796390,6694126,6297079,397047
2008-04-01,Indiana,4866256,3234611,3070463,164148
2008-04-01,Iowa,2316272,1675641,1612124,63517
2008-04-01,Kansas,2107403,1489101,1425930,63171
2008-04-01,Kentucky,3301623,2028938,1914843,114095
2008-04-01,Louisiana,3342530,2053498,1967590,85908
2008-04-01,Maine,1061310,702403,669018,33385
2008-04-01,Maryland,4349192,3019372,2903305,116067
2008-04-01,Massachusetts,5172601,3451857,3287651,164206
2008-04-01,Michigan,7771825,4936116,4568466,367650
2008-04-01,Minnesota,4042105,2901263,2757878,143385
2008-04-01,Mississippi,2183705,1300119,1218522,81597
2008-04-01,Missouri,4567221,3063138,2891182,171956
2008-04-01,Montana,758116,511411,490311,21100
2008-04-01,Nebraska,1349702,986716,956899,29817
2008-04-01,Nevada,1970300,1370126,1289063,81063
2008-04-01,Ohio,8922741,6007620,5652710,354910
2008-04-01,Oklahoma,2736623,1731478,1675777,55701
2008-04-01,Oregon,2961357,1930010,1829951,100059
2008-04-01,Pennsylvania,9875143,6419243,6103469,315774
2008-04-01,Tennessee,4809741,3053781,2875899,177882
2008-04-01,Texas,17664569,11609646,11098012,511634
2008-04-01,Utah,1925126,1389475,1347866,41609
2008-04-01,Vermont,504134,352841,337854,14987
2008-04-01,Virginia,5910973,4116032,3957470,158562
2008-04-01,Washington,5070675,3463341,3296358,166983
2008-04-01,Wisconsin,4381983,3091788,2957241,134547
2008-04-01,Wyoming,409212,295452,287625,7827
2008-05-01,Alabama,3587446,2179601,2063894,115707
2008-05-01,Alaska,500225,355376,332635,22741
2008-05-01,Arizona,4856783,3080677,2921270,159407
2008-05-01,Arkansas,2183726,1355970,1287961,68009
2008-05-01,California,27559044,18131133,16917726,1213407
2008-05-01,Colorado,3757482,2733114,2609574,123540
2008-05-01,Connecticut,2724259,1875861,1776383,99478
2008-05-01,Delaware,677046,450971,430805,20166
2008-05-01,Florida,14460689,9169161,8694289,474872
2008-05-01,Georgia,7183238,4915122,4611993,303129
2008-05-01,Hawaii,974398,643618,620551,23067
2008-05-01,Idaho,1131924,760351,724589,35762
2008-05-01,Illinois,9801672,6681135,6270759,410376
2008-05-01,Indiana,4869426,3241131,3069326,171805
2008-05-01,Iowa,2317378,1678567,1612887,65680
2008-05-01,Kansas,2108535,1490277,1425962,64315
2008-05-01,Kentucky,3304688,2032389,1913311,119078
2008-05-01,Louisiana,3347495,2057291,1969706,87585
2008-05-01,Maine,1061827,703056,668592,34464
2008-05-01,Maryland,4351442,3024091,2902061,122030
2008-05-01,Massachusetts,5176718,3457054,3287296,169758
2008-05-01,Michigan,7771115,4929420,4552402,377018
2008-05-01,Minnesota,4045132,2905299,2756987,148312
2008-05-01,Mississippi,2184868,1298265,1214621,83644
2008-05-01,Missouri,4570847,3063984,2886999,176985
2008-05-01,Montana,758910,511776,489740,22036
2008-05-01,Nebraska,1350512,987230,956699,30531
2008-05-01,Nevada,1973333,1371914,1286907,85007
2008-05-01,Ohio,8924889,6009324,5639316,370008
2008-05-01,Oklahoma,2738669,1734689,1677856,56833
2008-05-01,Oregon,2965016,1935049,1830610,104439
2008-05-01,Pennsylvania,9879825,6428978,6106957,322021
2008-05-01,Tennessee,4814888,3056689,2870663,186026
2008-05-01,Texas,17692809,11635536,11109993,525543
2008-05-01,Utah,1928810,1388638,1345995,42643
2008-05-01,Vermont,504303,353179,337781,15398
2008-05-01,Virginia,5916469,4125461,3960901,164560
2008-05-01,Washington,5077412,3470993,3297939,173054
2008-05-01,Wisconsin,4384483,3092342,2955027,137315
2008-05-01,Wyoming,409806,295913,287868,8045
2008-06-01,Alabama,3590424,2178622,2057140,121482
2008-06-01,Alaska,500654,355922,332865,23057
2008-06-01,Arizona,4865847,3092028,2921092,170936
2008-06-01,Arkansas,2185440,1357843,1288251,69592
2008-06-01,California,27587706,18164654,16894388,1270266
2008-06-01,Colorado,3763867,2734443,2606433,128010
2008-06-01,Connecticut,2726025,1877881,1774721,103160
2008-06-01,Delaware,677885,451055,429649,21406
2008-06-01,Florida,14472206,9171233,8667892,503341
2008-06-01,Georgia,7193494,4928114,4612997,315117
2008-06-01,Hawaii,974980,643567,619036,24531
2008-06-01,Idaho,1133789,762381,723505,38876
2008-06-01,Illinois,9807583,6665433,6241078,424355
2008-06-01,Indiana,4872865,3248295,3068270,180025
2008-06-01,Iowa,2318576,1682183,1614205,67978
2008-06-01,Kansas,2109796,1491760,1425746,66014
2008-06-01,Kentucky,3307933,2036392,1911585,124807
2008-06-01,Louisiana,3352675,2062672,1971996,90676
2008-06-01,Maine,1062361,703584,667838,35746
2008-06-01,Maryland,4354007,3028390,2899785,128605
2008-06-01,Massachusetts,5181107,3463575,3287364,176211
2008-06-01,Michigan,7770857,4923379,4535828,387551
2008-06-01,Minnesota,4048438,2910820,2757296,153524
2008-06-01,Mississippi,2186207,1296313,1210483,85830
2008-06-01,Missouri,4574724,3064984,2882201,182783
2008-06-01,Montana,759760,512294,489229,23065
2008-06-01,Nebraska,1351414,987667,956407,31260
2008-06-01,Nevada,1976466,1373585,1284291,89294
2008-06-01,Ohio,8927562,6012507,5625793,386714
2008-06-01,Oklahoma,2740965,1738601,1679997,58604
2008-06-01,Oregon,2968804,1942229,1831696,110533
2008-06-01,Pennsylvania,9885062,6439771,6110512,329259
2008-06-01,Tennessee,4820351,3060667,2866212,194455
2008-06-01,Texas,17722244,11666163,11121171,544992
2008-06-01,Utah,1932599,1387616,1343861,43755
2008-06-01,Vermont,504558,353581,337764,15817
2008-06-01,Virginia,5922288,4134305,3963346,170959
2008-06-01,Washington,5084384,3478758,3299349,179409
2008-06-01,Wisconsin,4387249,3093969,2952277,141692
2008-06-01,Wyoming,410427,296475,288145,8330
2008-07-01,Alabama,3593293,2177334,2049897,127437
2008-07-01,Alaska,501082,356199,332941,23258
2008-07-01,Arizona,4874841,3103708,2920905,182803
2008-07-01,Arkansas,2187167,1359733,1288132,71601
2008-07-01,California,27615732,18198631,16869967,1328664
2008-07-01,Colorado,3770226,2735689,2603060,132629
2008-07-01,Connecticut,2727747,1879919,1773119,106800
2008-07-01,Delaware,678769,451063,428337,22726
2008-07-01,Florida,14483564,9172784,8640817,531967
2008-07-01,Georgia,7203540,4940633,4612633,328000
2008-07-01,Hawaii,975546,643139,617129,26010
2008-07-01,Idaho,1135675,763509,722338,41171
2008-07-01,Illinois,9813237,6647982,6211153,436829
2008-07-01,Indiana,4876173,3254256,3066171,188085
2008-07-01,Iowa,2319771,1685651,1615698,69953
2008-07-01,Kansas,2110980,1493312,1425477,67835
2008-07-01,Kentucky,3311128,2040031,1909387,130644
2008-07-01,Louisiana,3357744,2068708,1973844,94864
2008-07-01,Maine,1062884,703689,666608,37081
2008-07-01,Maryland,4356418,3031959,2896505,135454
2008-07-01,Massachusetts,5185422,3470637,3287628,183009
2008-07-01,Michigan,7770438,4916694,4517863,398831
2008-07-01,Minnesota,4051642,2916961,2758679,158282
2008-07-01,Mississippi,2187453,1293981,1206270,87711
2008-07-01,Missouri,4578539,3065820,2876896,188924
2008-07-01,Montana,760598,512944,488842,24102
2008-07-01,Nebraska,1352261,988067,956138,31929
2008-07-01,Nevada,1979594,1375054,1281173,93881
2008-07-01,Ohio,8930028,6014218,5612464,401754
2008-07-01,Oklahoma,2743144,1742674,1682136,60538
2008-07-01,Oregon,2972578,1950173,1832417,117756
2008-07-01,Pennsylvania,9890101,6450249,6112981,337268
2008-07-01,Tennessee,4825694,3064883,2862683,202200
2008-07-01,Texas,17751353,11698046,11131376,566670
2008-07-01,Utah,1936350,1386267,1341399,44868
2008-07-01,Vermont,504770,353970,337768,16202
2008-07-01,Virginia,5927975,4141385,3964430,176955
2008-07-01,Washington,5091309,3485255,3300237,185018
2008-07-01,Wisconsin,4389936,3096523,2949524,146999
2008-07-01,Wyoming,411048,297099,288449,8650
2008-08-01,Alabama,3596204,2175532,2041980,133552
2008-08-01,Alaska,502170,356256,332935,23321
2008-08-01,Arizona,4882204,3114501,2920241,194260
2008-08-01,Arkansas,2188840,1360944,1287008,73936
2008-08-01,California,27647757,18229614,16841893,1387721
2008-08-01,Colorado,3776709,2736631,2599477,137154
2008-08-01,Connecticut,2729782,1881524,1771270,110254
2008-08-01,Delaware,679481,450915,426883,24032
2008-08-01,Florida,14494359,9170735,8610848,559887
2008-08-01,Georgia,7212743,4952285,4610521,341764
2008-08-01,Hawaii,976125,642316,614884,27432
2008-08-01,Idaho,1137065,763961,720883,43078
2008-08-01,Illinois,9820037,6630290,6183599,446691
2008-08-01,Indiana,4879459,3257956,3061005,196951
2008-08-01,Iowa,2321258,1688328,1616614,71714
2008-08-01,Kansas,2112793,1494865,1425260,69605
2008-08-01,Kentucky,3312948,2042938,1906189,136749
2008-08-01,Louisiana,3360884,2074146,1974665,99481
2008-08-01,Maine,1063209,703231,664756,38475
2008-08-01,Maryland,4360469,3034819,2892074,142745
2008-08-01,Massachusetts,5190727,3477120,3287107,190013
2008-08-01,Michigan,7771436,4908296,4496904,411392
2008-08-01,Minnesota,4054892,2922523,2760026,162497
2008-08-01,Mississippi,2188782,1291079,1201959,89120
2008-08-01,Missouri,4581836,3066259,2870988,195271
2008-08-01,Montana,761268,513563,488397,25166
2008-08-01,Nebraska,1353373,988463,955768,32695
2008-08-01,Nevada,1981608,1376217,1277347,98870
2008-08-01,Ohio,8933289,6011816,5598120,413696
2008-08-01,Oklahoma,2746239,1746499,1683945,62554
2008-08-01,Oregon,2976099,1957311,1831635,125676
2008-08-01,Pennsylvania,9895782,6458730,6112327,346403
2008-08-01,Tennessee,4829913,3068290,2859187,209103
2008-08-01,Texas,17783166,11727305,11139202,588103
2008-08-01,Utah,1939685,1384255,1338357,45898
2008-08-01,Vermont,505023,354246,337699,16547
2008-08-01,Virginia,5934957,4145890,3963418,182472
2008-08-01,Washington,5099238,3489319,3299643,189676
2008-08-01,Wisconsin,4392873,3099708,2946571,153137
2008-08-01,Wyoming,411744,297673,288702,8971
2008-09-01,Alabama,3598993,2173629,2033141,140488
2008-09-01,Alaska,503222,356278,332909,23369
2008-09-01,Arizona,4889372,3123387,2917994,205393
2008-09-01,Arkansas,2190470,1361416,1284515,76901
2008-09-01,California,27679019,18257580,16805122,1452458
2008-09-01,Colorado,3783064,2737389,2595132,142257
2008-09-01,Connecticut,2731705,1882648,1768820,113828
2008-09-01,Delaware,680178,450618,425254,25364
2008-09-01,Florida,14504739,9162508,8574307,588201
2008-09-01,Georgia,7221664,4800201,4442850,357351
2008-09-01,Hawaii,976705,641210,612280,28930
2008-09-01,Idaho,1138405,764150,718961,45189
2008-09-01,Illinois,9826546,6614614,6158416,456198
2008-09-01,Indiana,4882575,3259403,3050821,208582
2008-09-01,Iowa,2322671,1689996,1616033,73963
2008-09-01,Kansas,2114526,1496707,1424974,71733
2008-09-01,Kentucky,3314652,2045566,1901351,144215
2008-09-01,Louisiana,3363894,2078215,1974007,104208
2008-09-01,Maine,1063497,702387,662212,40175
2008-09-01,Maryland,4364380,3037478,2886085,151393
2008-09-01,Massachusetts,5195775,3481923,3284012,197911
2008-09-01,Michigan,7772172,4898438,4471729,426709
2008-09-01,Minnesota,4058030,2926961,2759427,167534
2008-09-01,Mississippi,2190044,1287989,1197500,90489
2008-09-01,Missouri,4584996,3066669,2864204,202465
2008-09-01,Montana,761925,513902,487527,26375
2008-09-01,Nebraska,1354435,988765,955119,33646
2008-09-01,Nevada,1983560,1377125,1272537,104588
2008-09-01,Ohio,8936246,6004979,5579973,425006
2008-09-01,Oklahoma,2749269,1749749,1684673,65076
2008-09-01,Oregon,2979483,1962925,1828177,134748
2008-09-01,Pennsylvania,9901160,6465072,6106294,358778
2008-09-01,Tennessee,4834013,3070328,2854164,216164
2008-09-01,Texas,17814485,11751993,11141801,610192
2008-09-01,Utah,1942966,1381301,1334384,46917
2008-09-01,Vermont,505257,354355,337442,16913
2008-09-01,Virginia,5941756,4147911,3959244,188667
2008-09-01,Washington,5106981,3490731,3296178,194553
2008-09-01,Wisconsin,4395671,3103711,2942506,161205
2008-09-01,Wyoming,412444,298023,288770,9253
2008-10-01,Alabama,3601896,2172322,2023364,148958
2008-10-01,Alaska,504284,356381,332820,23561
2008-10-01,Arizona,4896695,3129730,2912892,216838
2008-10-01,Arkansas,2192094,1361363,1280596,80767
2008-10-01,California,27710666,18283764,16755408,1528356
2008-10-01,Colorado,3789510,2738037,2589291,148746
2008-10-01,Connecticut,2733733,1883668,1765753,117915
2008-10-01,Delaware,680882,450134,423297,26837
2008-10-01,Florida,14515421,9143874,8528323,615551
2008-10-01,Georgia,7230835,4763216,4387423,375793
2008-10-01,Hawaii,977292,639971,609289,30682
2008-10-01,Idaho,1139803,764450,716492,47958
2008-10-01,Illinois,9833265,6602533,6133051,469482
2008-10-01,Indiana,4885822,3259393,3034749,224644
2008-10-01,Iowa,2324167,1690958,1613479,77479
2008-10-01,Kansas,2116326,1498893,1424409,74484
2008-10-01,Kentucky,3316457,2048791,1894862,153929
2008-10-01,Louisiana,3366976,2080286,1971443,108843
2008-10-01,Maine,1063777,701476,659005,42471
2008-10-01,Maryland,4368415,3040575,2878435,162140
2008-10-01,Massachusetts,5200987,3484355,3276874,207481
2008-10-01,Michigan,7773056,4887718,4442055,445663
2008-10-01,Minnesota,4061267,2930202,2755312,174890
2008-10-01,Mississippi,2191391,1285225,1192839,92386
2008-10-01,Missouri,4588232,3067640,2856334,211306
2008-10-01,Montana,762562,513700,485834,27866
2008-10-01,Nebraska,1355531,988947,954101,34846
2008-10-01,Nevada,1985545,1377911,1266591,111320
2008-10-01,Ohio,8939361,5995207,5556150,439057
2008-10-01,Oklahoma,2752323,1752645,1683793,68852
2008-10-01,Oregon,2982987,1966958,1821021,145937
2008-10-01,Pennsylvania,9906713,6469954,6093486,376468
2008-10-01,Tennessee,4838191,3070955,2846010,224945
2008-10-01,Texas,17846170,11771507,11136874,634633
2008-10-01,Utah,1946306,1377244,1329258,47986
2008-10-01,Vermont,505508,355352,337955,17397
2008-10-01,Virginia,5948680,4148057,3951093,196964
2008-10-01,Washington,5114846,3490210,3288871,201339
2008-10-01,Wisconsin,4398555,3108572,2935774,172798
2008-10-01,Wyoming,413128,298085,288534,9551
2008-11-01,Alabama,3604408,2171630,2012593,159037
2008-11-01,Alaska,505353,356617,332618,23999
2008-11-01,Arizona,4903496,3133420,2904315,229105
2008-11-01,Arkansas,2193563,1361045,1275604,85441
2008-11-01,California,27740241,18307599,16691191,1616408
2008-11-01,Colorado,3795646,2738762,2581484,157278
2008-11-01,Connecticut,2735434,1884613,1761893,122720
2008-11-01,Delaware,681538,449376,420891,28485
2008-11-01,Florida,14524347,9117676,8472472,645204
2008-11-01,Georgia,7239404,4761050,4364135,396915
2008-11-01,Hawaii,977913,638587,605845,32742
2008-11-01,Idaho,1141084,764784,713504,51280
2008-11-01,Illinois,9839056,6594077,6104242,489835
2008-11-01,Indiana,4888584,3258489,3013159,245330
2008-11-01,Iowa,2325378,1691223,1608748,82475
2008-11-01,Kansas,2117869,1501360,1423372,77988
2008-11-01,Kentucky,3317952,2052892,1886996,165896
2008-11-01,Louisiana,3369760,2080055,1966607,113448
2008-11-01,Maine,1063982,700719,655292,45427
2008-11-01,Maryland,4372021,3044184,2869411,174773
2008-11-01,Massachusetts,5205636,3484329,3265439,218890
2008-11-01,Michigan,7773150,4876390,4409115,467275
2008-11-01,Minnesota,4064091,2932497,2747372,185125
2008-11-01,Mississippi,2192508,1282861,1187659,95202
2008-11-01,Missouri,4591041,3069076,2847323,221753
2008-11-01,Montana,763186,512832,483179,29653
2008-11-01,Nebraska,1356466,988981,952612,36369
2008-11-01,Nevada,1987408,1378359,1259504,118855
2008-11-01,Ohio,8941524,5983594,5525376,458218
2008-11-01,Oklahoma,2755121,1755374,1680966,74408
2008-11-01,Oregon,2986162,1969619,1809879,159740
2008-11-01,Pennsylvania,9911055,6472379,6072949,399430
2008-11-01,Tennessee,4841978,3069508,2832943,236565
2008-11-01,Texas,17876599,11784834,11123092,661742
2008-11-01,Utah,1949504,1371962,1322915,49047
2008-11-01,Vermont,505734,356228,338176,18052
2008-11-01,Virginia,5955076,4146700,3938595,208105
2008-11-01,Washington,5122196,3488288,3277136,211152
2008-11-01,Wisconsin,4401027,3113762,2924909,188853
2008-11-01,Wyoming,413791,298010,287926,10084
2008-12-01,Alabama,3606592,2171169,2001037,170132
2008-12-01,Alaska,506307,357004,332312,24692
2008-12-01,Arizona,4909739,3135110,2892889,242221
2008-12-01,Arkansas,2194791,1360662,1270115,90547
2008-12-01,California,27766504,18327303,16614367,1712936
2008-12-01,Colorado,3801345,2739993,2572099,167894
2008-12-01,Connecticut,2736850,1885195,1757045,128150
2008-12-01,Delaware,682121,448368,418100,30268
2008-12-01,Florida,14531697,9086029,8409554,676475
2008-12-01,Georgia,7247260,4768790,4349635,419155
2008-12-01,Hawaii,978390,637096,602094,35002
2008-12-01,Idaho,1142231,764905,710176,54729
2008-12-01,Illinois,9843756,6589361,6071369,517992
2008-12-01,Indiana,4890861,3257127,2987719,269408
2008-12-01,Iowa,2326326,1690582,1602026,88556
2008-12-01,Kansas,2119222,1504198,1421825,82373
2008-12-01,Kentucky,3319100,2057610,1878114,179496
2008-12-01,Louisiana,3372245,2078009,1959715,118294
2008-12-01,Maine,1064068,700292,651465,48827
2008-12-01,Maryland,4375176,3047840,2859476,188364
2008-12-01,Massachusetts,5209753,3482788,3251176,231612
2008-12-01,Michigan,7772501,4864371,4375398,488973
2008-12-01,Minnesota,4066483,2934202,2736774,197428
2008-12-01,Mississippi,2193422,1280995,1181857,99138
2008-12-01,Missouri,4593380,3070614,2837411,233203
2008-12-01,Montana,763677,511355,479767,31588
2008-12-01,Nebraska,1357295,988919,950668,38251
2008-12-01,Nevada,1989039,1378215,1251597,126618
2008-12-01,Ohio,8942768,5970422,5487378,483044
2008-12-01,Oklahoma,2757591,1758229,1676316,81913
2008-12-01,Oregon,2988988,1971578,1795993,175585
2008-12-01,Pennsylvania,9914426,6471599,6045617,425982
2008-12-01,Tennessee,4845237,3065036,2814331,250705
2008-12-01,Texas,17904835,11791925,11101977,689948
2008-12-01,Utah,1952476,1388245,1315656,72589
2008-12-01,Vermont,505873,357013,338155,18858
2008-12-01,Virginia,5960915,4144520,3922612,221908
2008-12-01,Washington,5129048,3485137,3261532,223605
2008-12-01,Wisconsin,4402985,3118667,2909875,208792
2008-12-01,Wyoming,414409,298049,287005,11044
2009-01-01,Alabama,3608960,2170615,1989308,181307
2009-01-01,Alaska,507364,357527,331939,25588
2009-01-01,Arizona,4916200,3135245,2879700,255545
2009-01-01,Arkansas,2196134,1360180,1264593,95587
2009-01-01,California,27794667,18341252,16530013,1811239
2009-01-01,Colorado,3807212,2741783,2561844,179939
2009-01-01,Connecticut,2738401,1885168,1751324,133844
2009-01-01,Delaware,682762,447205,415103,32102
2009-01-01,Florida,14539769,9052178,8343928,708250
2009-01-01,Georgia,7255557,4778508,4337640,440868
2009-01-01,Hawaii,978992,635569,598286,37283
2009-01-01,Idaho,1143426,764671,706733,57938
2009-01-01,Illinois,9849030,6588346,6037014,551332
2009-01-01,Indiana,4893292,3256297,2961664,294633
2009-01-01,Iowa,2327391,1689096,1594063,95033
2009-01-01,Kansas,2120640,1507169,1419811,87358
2009-01-01,Kentucky,3320357,2062601,1868875,193726
2009-01-01,Louisiana,3374902,2075125,1951613,123512
2009-01-01,Maine,1064171,700203,647898,52305
2009-01-01,Maryland,4378599,3051111,2849401,201710
2009-01-01,Massachusetts,5214072,3480717,3236069,244648
2009-01-01,Michigan,7772160,4875359,4342294,533065
2009-01-01,Minnesota,4068989,2935506,2725000,210506
2009-01-01,Mississippi,2194462,1279561,1175741,103820
2009-01-01,Missouri,4595874,3072024,2827112,244912
2009-01-01,Montana,764203,509478,476051,33427
2009-01-01,Nebraska,1358167,988763,948435,40328
2009-01-01,Nevada,1990788,1377435,1243320,134115
2009-01-01,Ohio,8944394,5956344,5444780,511564
2009-01-01,Oklahoma,2760215,1761587,1670671,90916
2009-01-01,Oregon,2991928,1973386,1781451,191935
2009-01-01,Pennsylvania,9918169,6467790,6014392,453398
2009-01-01,Tennessee,4848693,3057747,2791562,266185
2009-01-01,Texas,17934287,11794357,11077513,716844
2009-01-01,Utah,1955576,1392634,1307934,84700
2009-01-01,Vermont,506066,357735,337995,19740
2009-01-01,Virginia,5967043,4142432,3905221,237211
2009-01-01,Washington,5136093,3480693,3243615,237078
2009-01-01,Wisconsin,4405116,3122945,2892187,230758
2009-01-01,Wyoming,415020,298360,285891,12469
2009-02-01,Alabama,3611025,2169888,1978083,191805
2009-02-01,Alaska,508336,358159,331565,26594
2009-02-01,Arizona,4922302,3134718,2866239,268479
2009-02-01,Arkansas,2197249,1359814,1259658,100156
2009-02-01,California,27820364,18350557,16445664,1904893
2009-02-01,Colorado,3812882,2743809,2551450,192359
2009-02-01,Connecticut,2739720,1885022,1745553,139469
2009-02-01,Delaware,683309,445924,412069,33855
2009-02-01,Florida,14546500,9020030,8280792,739238
2009-02-01,Georgia,7263209,4787926,4326851,461075
2009-02-01,Hawaii,979422,634151,594807,39344
2009-02-01,Idaho,1144528,764044,703500,60544
2009-02-01,Illinois,9853542,6591950,6005570,586380
2009-02-01,Indiana,4895465,3255885,2937994,317891
2009-02-01,Iowa,2328279,1687015,1585947,101068
2009-02-01,Kansas,2121939,1510355,1417552,92803
2009-02-01,Kentucky,3321451,2067583,1860303,207280
2009-02-01,Louisiana,3377231,2072767,1943568,129199
2009-02-01,Maine,1064193,700270,644828,55442
2009-02-01,Maryland,4381626,3053799,2840168,213631
2009-02-01,Massachusetts,5218090,3478984,3221939,257045
2009-02-01,Michigan,7771192,4885037,4310659,574378
2009-02-01,Minnesota,4071329,2936857,2714157,222700
2009-02-01,Mississippi,2195299,1278354,1169822,108532
2009-02-01,Missouri,4598092,3073323,2817179,256144
2009-02-01,Montana,764676,507574,472644,34930
2009-02-01,Nebraska,1358954,988607,946270,42337
2009-02-01,Nevada,1992370,1376206,1235176,141030
2009-02-01,Ohio,8945406,5942920,5402230,540690
2009-02-01,Oklahoma,2762668,1765678,1665415,100263
2009-02-01,Oregon,2994706,1975379,1768747,206632
2009-02-01,Pennsylvania,9921186,6462229,5983557,478672
2009-02-01,Tennessee,4851827,3049266,2767661,281605
2009-02-01,Texas,17962241,11795821,11055073,740748
2009-02-01,Utah,1958558,1391346,1300274,91072
2009-02-01,Vermont,506207,358464,337853,20611
2009-02-01,Virginia,5972693,4141054,3888770,252284
2009-02-01,Washington,5142825,3474872,3225423,249449
2009-02-01,Wisconsin,4407013,3126622,2874456,252166
2009-02-01,Wyoming,415658,298950,284717,14233
2009-03-01,Alabama,3613034,2168962,1968035,200927
2009-03-01,Alaska,509304,358815,331287,27528
2009-03-01,Arizona,4928269,3134761,2854602,280159
2009-03-01,Arkansas,2198385,1359655,1255912,103743
2009-03-01,California,27845224,18357115,16370975,1986140
2009-03-01,Colorado,3818492,2745639,2541992,203647
2009-03-01,Connecticut,2741025,1885758,1741164,144594
2009-03-01,Delaware,683851,444546,409245,35301
2009-03-01,Florida,14553015,8993087,8226093,766994
2009-03-01,Georgia,7270704,4796410,4318122,478288
2009-03-01,Hawaii,979839,633015,592076,40939
2009-03-01,Idaho,1145653,763045,700851,62194
2009-03-01,Illinois,9857938,6599816,5981260,618556
2009-03-01,Indiana,4897589,3254065,2918351,335714
2009-03-01,Iowa,2329173,1684717,1578852,105865
2009-03-01,Kansas,2123219,1513752,1415542,98210
2009-03-01,Kentucky,3322520,2071976,1853366,218610
2009-03-01,Louisiana,3379507,2072027,1936935,135092
2009-03-01,Maine,1064236,700301,642493,57808
2009-03-01,Maryland,4384547,3055887,2832928,222959
2009-03-01,Massachusetts,5222100,3478298,3210588,267710
2009-03-01,Michigan,7770196,4893566,4282346,611220
2009-03-01,Minnesota,4073662,2938667,2706532,232135
2009-03-01,Mississippi,2196101,1277088,1164570,112518
2009-03-01,Missouri,4600232,3074303,2808736,265567
2009-03-01,Montana,765161,505944,470036,35908
2009-03-01,Nebraska,1359717,988641,944615,44026
2009-03-01,Nevada,1993918,1374816,1227786,147030
2009-03-01,Ohio,8946406,5931002,5364822,566180
2009-03-01,Oklahoma,2765042,1770364,1661702,108662
2009-03-01,Oregon,2997399,1977117,1759644,217473
2009-03-01,Pennsylvania,9924198,6455797,5956881,498916
2009-03-01,Tennessee,4854945,3041270,2746230,295040
2009-03-01,Texas,17989636,11799261,11040416,758845
2009-03-01,Utah,1961510,1387931,1293342,94589
2009-03-01,Vermont,506354,359307,337951,21356
2009-03-01,Virginia,5978215,4140763,3875758,265005
2009-03-01,Washington,5149512,3467544,3209014,258530
2009-03-01,Wisconsin,4408918,3129930,2859606,270324
2009-03-01,Wyoming,416274,299720,283647,16073
2009-04-01,Alabama,3615107,2167672,1959272,208400
2009-04-01,Alaska,510314,359404,331163,28241
2009-04-01,Arizona,4934381,3135697,2845709,289988
2009-04-01,Arkansas,2199548,1359293,1253369,105924
2009-04-01,California,27871138,18360253,16310052,2050201
2009-04-01,Colorado,3824191,2746627,2534133,212494
2009-04-01,Connecticut,2742384,1887457,1738492,148965
2009-04-01,Delaware,684422,443075,406789,36286
2009-04-01,Florida,14559741,8974062,8182726,791336
2009-04-01,Georgia,7278430,4803528,4311940,491588
2009-04-01,Hawaii,980298,632282,590308,41974
2009-04-01,Idaho,1146825,761716,698919,62797
2009-04-01,Illinois,9862551,6609226,5964724,644502
2009-04-01,Indiana,4899811,3249511,2903308,346203
2009-04-01,Iowa,2330117,1682539,1573692,108847
2009-04-01,Kansas,2124509,1517037,1414106,102931
2009-04-01,Kentucky,3323639,2074923,1848460,226463
2009-04-01,Louisiana,3381899,2072391,1932168,140223
2009-04-01,Maine,1064283,700192,640979,59213
2009-04-01,Maryland,4387555,3057218,2828165,229053
2009-04-01,Massachusetts,5226156,3478483,3202508,275975
2009-04-01,Michigan,7769346,4900321,4257967,642354
2009-04-01,Minnesota,4076031,2940298,2702508,237790
2009-04-01,Mississippi,2196932,1275427,1160113,115314
2009-04-01,Missouri,4602491,3074803,2802257,272546
2009-04-01,Montana,765637,504683,468374,36309
2009-04-01,Nebraska,1360520,989011,943699,45312
2009-04-01,Nevada,1995501,1373429,1221385,152044
2009-04-01,Ohio,8947541,5920506,5335602,584904
2009-04-01,Oklahoma,2767495,1774985,1659766,115219
2009-04-01,Oregon,3000182,1977826,1754553,223273
2009-04-01,Pennsylvania,9927312,6448142,5935194,512948
2009-04-01,Tennessee,4858086,3034647,2729517,305130
2009-04-01,Texas,18017597,11805364,11035746,769618
2009-04-01,Utah,1964512,1384192,1287412,96780
2009-04-01,Vermont,506480,359755,337870,21885
2009-04-01,Virginia,5983942,4141347,3867062,274285
2009-04-01,Washington,5156239,3467492,3195574,271918
2009-04-01,Wisconsin,4410843,3132217,2848985,283232
2009-04-01,Wyoming,416861,300461,282792,17669
2009-05-01,Alabama,3617361,2165514,1950906,214608
2009-05-01,Alaska,511330,359892,331161,28731
2009-05-01,Arizona,4940746,3136601,2838286,298315
2009-05-01,Arkansas,2200846,1358162,1251338,106824
2009-05-01,California,27897359,18356368,16257221,2099147
2009-05-01,Colorado,3830099,2745488,2527186,218302
2009-05-01,Connecticut,2743885,1889319,1736551,152768
2009-05-01,Delaware,684993,441440,404596,36844
2009-05-01,Florida,14567324,8990744,8148166,842578
2009-05-01,Georgia,7286426,4807998,4306652,501346
2009-05-01,Hawaii,980763,631952,589386,42566
2009-05-01,Idaho,1148040,765242,697495,67747
2009-05-01,Illinois,9867563,6616824,5952614,664210
2009-05-01,Indiana,4902376,3241440,2891493,349947
2009-05-01,Iowa,2331259,1680503,1570351,110152
2009-05-01,Kansas,2125995,1519576,1412960,106616
2009-05-01,Kentucky,3325013,2075708,1844941,230767
2009-05-01,Louisiana,3384370,2072526,1928778,143748
2009-05-01,Maine,1064444,699741,639964,59777
2009-05-01,Maryland,4390739,3057191,2824833,232358
2009-05-01,Massachusetts,5230561,3478354,3196305,282049
2009-05-01,Michigan,7768973,4904363,4236418,667945
2009-05-01,Minnesota,4078760,2940428,2700525,239903
2009-05-01,Mississippi,2197842,1272969,1155919,117050
2009-05-01,Missouri,4605119,3074117,2796764,277353
2009-05-01,Montana,766208,503645,467389,36256
2009-05-01,Nebraska,1361436,989500,943261,46239
2009-05-01,Nevada,1997181,1371955,1215496,156459
2009-05-01,Ohio,8949202,5910747,5313941,596806
2009-05-01,Oklahoma,2770103,1778265,1658576,119689
2009-05-01,Oregon,3003209,1976717,1752493,224224
2009-05-01,Pennsylvania,9931122,6437627,5916119,521508
2009-05-01,Tennessee,4861579,3029350,2717680,311670
2009-05-01,Texas,18046180,11933809,11037541,896268
2009-05-01,Utah,1967728,1380535,1282005,98530
2009-05-01,Vermont,506662,361124,338923,22201
2009-05-01,Virginia,5989932,4141603,3861057,280546
2009-05-01,Washington,5163366,3466388,3185132,281256
2009-05-01,Wisconsin,4413190,3131940,2841498,290442
2009-05-01,Wyoming,417505,300897,282070,18827
2009-06-01,Alabama,3619629,2162128,1942142,219986
2009-06-01,Alaska,512325,360268,331193,29075
2009-06-01,Arizona,4947208,3136757,2831102,305655
2009-06-01,Arkansas,2202154,1356219,1249384,106835
2009-06-01,California,27924313,18344271,16206712,2137559
2009-06-01,Colorado,3836067,2741685,2520583,221102
2009-06-01,Connecticut,2745421,1890959,1734700,156259
2009-06-01,Delaware,685612,439569,402469,37100
2009-06-01,Florida,14575145,8991320,8119224,872096
2009-06-01,Georgia,7294421,4809047,4300595,508452
2009-06-01,Hawaii,981229,631868,588993,42875
2009-06-01,Idaho,1149304,765973,696379,69594
2009-06-01,Illinois,9872670,6620584,5941437,679147
2009-06-01,Indiana,4904977,3229982,2881080,348902
2009-06-01,Iowa,2332447,1678718,1568344,110374
2009-06-01,Kansas,2127510,1520649,1411631,109018
2009-06-01,Kentucky,3326417,2074132,1841907,232225
2009-06-01,Louisiana,3386911,2071821,1926334,145487
2009-06-01,Maine,1064612,698904,639123,59781
2009-06-01,Maryland,4393922,3055637,2821735,233902
2009-06-01,Massachusetts,5235023,3477099,3190727,286372
2009-06-01,Michigan,7768604,4905950,4216979,688971
2009-06-01,Minnesota,4081532,2938602,2699072,239530
2009-06-01,Mississippi,2198782,1269700,1151486,118214
2009-06-01,Missouri,4607694,3071762,2791064,280698
2009-06-01,Montana,766762,502704,466739,35965
2009-06-01,Nebraska,1362376,989738,942897,46841
2009-06-01,Nevada,1998890,1370321,1209700,160621
2009-06-01,Ohio,8950933,5902027,5297717,604310
2009-06-01,Oklahoma,2772778,1779326,1657117,122209
2009-06-01,Oregon,3006279,1973627,1752128,221499
2009-06-01,Pennsylvania,9935005,6423159,5897683,525476
2009-06-01,Tennessee,4865073,3025629,2710361,315268
2009-06-01,Texas,18075211,11998393,11041350,957043
2009-06-01,Utah,1970908,1376948,1276697,100251
2009-06-01,Vermont,506890,360821,338444,22377
2009-06-01,Virginia,5995931,4140712,3855929,284783
2009-06-01,Washington,5170538,3464827,3176939,287888
2009-06-01,Wisconsin,4415500,3128053,2835423,292630
2009-06-01,Wyoming,418196,300868,281384,19484
2009-07-01,Alabama,3622181,2157556,1932774,224782
2009-07-01,Alaska,513402,360424,331095,29329
2009-07-01,Arizona,4953939,3135266,2823229,312037
2009-07-01,Arkansas,2203656,1353772,1247347,106425
2009-07-01,California,27952375,18323390,16154640,2168750
2009-07-01,Colorado,3842322,2735370,2513522,221848
2009-07-01,Connecticut,2747122,1891930,1732321,159609
2009-07-01,Delaware,686254,437522,400274,37248
2009-07-01,Florida,14583822,8985929,8092905,893024
2009-07-01,Georgia,7302994,4806283,4292715,513568
2009-07-01,Hawaii,981756,631704,588669,43035
2009-07-01,Idaho,1150638,765397,695387,70010
2009-07-01,Illinois,9878410,6618475,5927060,691415
2009-07-01,Indiana,4907917,3216060,2870731,345329
2009-07-01,Iowa,2333773,1676953,1566823,110130
2009-07-01,Kansas,2129150,1519761,1409610,110151
2009-07-01,Kentucky,3328074,2070370,1838771,231599
2009-07-01,Louisiana,3389686,2069984,1924210,145774
2009-07-01,Maine,1064870,697805,638257,59548
2009-07-01,Maryland,4397413,3052760,2818008,234752
2009-07-01,Massachusetts,5239849,3474026,3184659,289367
2009-07-01,Michigan,7768829,4881546,4199503,682043
2009-07-01,Minnesota,4084586,2935063,2697239,237824
2009-07-01,Mississippi,2199851,1266095,1146754,119341
2009-07-01,Missouri,4610651,3067274,2784144,283130
2009-07-01,Montana,767393,501734,466047,35687
2009-07-01,Nebraska,1363415,989444,942248,47196
2009-07-01,Nevada,2000720,1368177,1203710,164467
2009-07-01,Ohio,8953337,5894470,5283917,610553
2009-07-01,Oklahoma,2775621,1777772,1654657,123115
2009-07-01,Oregon,3009552,1969041,1752029,217012
2009-07-01,Pennsylvania,9939596,6403921,5878278,525643
2009-07-01,Tennessee,4868936,3023463,2706513,316950
2009-07-01,Texas,18105139,12027290,11042872,984418
2009-07-01,Utah,1974253,1373141,1271180,101961
2009-07-01,Vermont,507115,360377,337862,22515
2009-07-01,Virginia,6002403,4138354,3850155,288199
2009-07-01,Washington,5178070,3463333,3169356,293977
2009-07-01,Wisconsin,4418188,3120387,2828900,291487
2009-07-01,Wyoming,418865,300467,280658,19809
2009-08-01,Alabama,3624837,2152222,1923196,229026
2009-08-01,Alaska,513656,360299,330803,29496
2009-08-01,Arizona,4961060,3131513,2814158,317355
2009-08-01,Arkansas,2205479,1351081,1245167,105914
2009-08-01,California,27986270,18295071,16100602,2194469
2009-08-01,Colorado,3847562,2727247,2505320,221927
2009-08-01,Connecticut,2749085,1891764,1728836,162928
2009-08-01,Delaware,686972,435435,398014,37421
2009-08-01,Florida,14599431,8978345,8067438,910907
2009-08-01,Georgia,7312496,4799902,4282945,516957
2009-08-01,Hawaii,982384,631317,588153,43164
2009-08-01,Idaho,1151866,764334,694403,69931
2009-08-01,Illinois,9884709,6610820,5907507,703313
2009-08-01,Indiana,4911180,3201118,2860122,340996
2009-08-01,Iowa,2335284,1674750,1565031,109719
2009-08-01,Kansas,2130871,1516989,1406736,110253
2009-08-01,Kentucky,3330802,2064926,1835411,229515
2009-08-01,Louisiana,3392730,2067196,1921831,145365
2009-08-01,Maine,1065143,696562,637239,59323
2009-08-01,Maryland,4401975,3048938,2813403,235535
2009-08-01,Massachusetts,5244207,3469286,3177920,291366
2009-08-01,Michigan,7770891,4856487,4184303,672184
2009-08-01,Minnesota,4087541,2930548,2694937,235611
2009-08-01,Mississippi,2201059,1262789,1141924,120865
2009-08-01,Missouri,4613947,3060731,2775832,284899
2009-08-01,Montana,767959,500707,465128,35579
2009-08-01,Nebraska,1364635,988595,941206,47389
2009-08-01,Nevada,2002267,1365329,1197462,167867
2009-08-01,Ohio,8956374,5888132,5270650,617482
2009-08-01,Oklahoma,2778180,1773942,1650963,122979
2009-08-01,Oregon,3012625,1963985,1751276,212709
2009-08-01,Pennsylvania,9945029,6380840,5857656,523184
2009-08-01,Tennessee,4873515,3022770,2705032,317738
2009-08-01,Texas,18134768,12035941,11040880,995061
2009-08-01,Utah,1977352,1368895,1265371,103524
2009-08-01,Vermont,507430,359802,337117,22685
2009-08-01,Virginia,6009725,4134913,3843174,291739
2009-08-01,Washington,5185004,3462571,3161327,301244
2009-08-01,Wisconsin,4420667,3110072,2820936,289136
2009-08-01,Wyoming,419192,299950,279871,20079
2009-09-01,Alabama,3627477,2146808,1914421,232387
2009-09-01,Alaska,513872,360018,330431,29587
2009-09-01,Arizona,4968072,3126346,2804614,321732
2009-09-01,Arkansas,2207281,1348368,1242864,105504
2009-09-01,California,28019194,18266064,16049842,2216222
2009-09-01,Colorado,3852743,2718739,2496342,222397
2009-09-01,Connecticut,2751032,1890575,1724297,166278
2009-09-01,Delaware,687690,433494,395820,37674
2009-09-01,Florida,14615000,8971805,8044442,927363
2009-09-01,Georgia,7321947,4791624,4272839,518785
2009-09-01,Hawaii,982979,630905,587593,43312
2009-09-01,Idaho,1153087,763191,693446,69745
2009-09-01,Illinois,9890904,6601019,5885181,715838
2009-09-01,Indiana,4914475,3187111,2849830,337281
2009-09-01,Iowa,2336799,1671946,1562768,109178
2009-09-01,Kansas,2132592,1513022,1403365,109657
2009-09-01,Kentucky,3333496,2059145,1832168,226977
2009-09-01,Louisiana,3395772,2064076,1919181,144895
2009-09-01,Maine,1065440,695385,636129,59256
2009-09-01,Maryland,4406548,3044831,2808298,236533
2009-09-01,Massachusetts,5248524,3464412,3171810,292602
2009-09-01,Michigan,7772966,4832672,4171972,660700
2009-09-01,Minnesota,4090504,2926112,2692908,233204
2009-09-01,Mississippi,2202315,1260410,1137403,123007
2009-09-01,Missouri,4617243,3053430,2767093,286337
2009-09-01,Montana,768524,499791,464097,35694
2009-09-01,Nebraska,1365808,987507,939966,47541
2009-09-01,Nevada,2003771,1362186,1191275,170911
2009-09-01,Ohio,8959495,5883486,5257988,625498
2009-09-01,Oklahoma,2780669,1769326,1646669,122657
2009-09-01,Oregon,3015664,1959776,1750074,209702
2009-09-01,Pennsylvania,9950472,6357890,5837681,520209
2009-09-01,Tennessee,4878100,3023659,2705490,318169
2009-09-01,Texas,18163851,12036191,11038831,997360
2009-09-01,Utah,1980374,1364462,1259612,104850
2009-09-01,Vermont,507724,359182,336279,22903
2009-09-01,Virginia,6017014,4131421,3835560,295861
2009-09-01,Washington,5191902,3463071,3152726,310345
2009-09-01,Wisconsin,4423136,3099185,2812227,286958
2009-09-01,Wyoming,419500,299610,279101,20509
2009-10-01,Alabama,3630337,2142208,1907643,234565
2009-10-01,Alaska,514133,359711,330034,29677
2009-10-01,Arizona,4975352,3120895,2795851,325044
2009-10-01,Arkansas,2209199,1345775,1240400,105375
2009-10-01,California,28053709,18243355,16007637,2235718
2009-10-01,Colorado,3858144,2711692,2487400,224292
2009-10-01,Connecticut,2753149,1888815,1719152,169663
2009-10-01,Delaware,688459,431859,393847,38012
2009-10-01,Florida,14631311,8968645,8026138,942507
2009-10-01,Georgia,7331829,4783230,4264115,519115
2009-10-01,Hawaii,983622,630679,587205,43474
2009-10-01,Idaho,1154366,762147,692584,69563
2009-10-01,Illinois,9897655,6593339,5864865,728474
2009-10-01,Indiana,4918039,3175581,2840309,335272
2009-10-01,Iowa,2338466,1668747,1560093,108654
2009-10-01,Kansas,2134462,1508787,1399911,108876
2009-10-01,Kentucky,3336401,2054515,1829565,224950
2009-10-01,Louisiana,3398961,2061211,1916572,144639
2009-10-01,Maine,1065788,694561,635139,59422
2009-10-01,Maryland,4411347,3041386,2803176,238210
2009-10-01,Massachusetts,5253091,3460868,3167575,293293
2009-10-01,Michigan,7775455,4811810,4162184,649626
2009-10-01,Minnesota,4093670,2922698,2691628,231070
2009-10-01,Mississippi,2203668,1259466,1133784,125682
2009-10-01,Missouri,4620808,3046720,2759008,287712
2009-10-01,Montana,769146,499149,463140,36009
2009-10-01,Nebraska,1367090,986531,938727,47804
2009-10-01,Nevada,2005462,1359279,1185525,173754
2009-10-01,Ohio,8963041,5880324,5245920,634404
2009-10-01,Oklahoma,2783333,1765197,1642579,122618
2009-10-01,Oregon,3018895,1957509,1749082,208427
2009-10-01,Pennsylvania,9956445,6339102,5820126,518976
2009-10-01,Tennessee,4882981,3025771,2707285,318486
2009-10-01,Texas,18194118,12036269,11040270,995999
2009-10-01,Utah,1983529,1360205,1254310,105895
2009-10-01,Vermont,508094,358651,335482,23169
2009-10-01,Virginia,6024651,4128934,3828154,300780
2009-10-01,Washington,5199075,3456236,3143906,312330
2009-10-01,Wisconsin,4425882,3089933,2804121,285812
2009-10-01,Wyoming,419851,299628,278438,21190
2009-11-01,Alabama,3632553,2139947,1904011,235936
2009-11-01,Alaska,514325,359647,329798,29849
2009-11-01,Arizona,4981854,3116842,2789383,327459
2009-11-01,Arkansas,2210757,1343857,1238191,105666
2009-11-01,California,28084234,18237262,15981193,2256069
2009-11-01,Colorado,3862938,2708033,2479744,228289
2009-11-01,Connecticut,2754731,1887858,1714686,173172
2009-11-01,Delaware,689092,430762,392346,38416
2009-11-01,Florida,14645036,8973003,8016095,956908
2009-11-01,Georgia,7340523,4777540,4258854,518686
2009-11-01,Hawaii,984262,631046,587373,43673
2009-11-01,Idaho,1155469,761632,692099,69533
2009-11-01,Illinois,9902704,6592973,5852392,740581
2009-11-01,Indiana,4920671,3168554,2833101,335453
2009-11-01,Iowa,2339640,1666336,1558033,108303
2009-11-01,Kansas,2135884,1505314,1396912,108402
2009-11-01,Kentucky,3338735,2052571,1828591,223980
2009-11-01,Louisiana,3401585,2059990,1915071,144919
2009-11-01,Maine,1065945,694427,634580,59847
2009-11-01,Maryland,4415406,3040505,2799603,240902
2009-11-01,Massachusetts,5256717,3460102,3166227,293875
2009-11-01,Michigan,7776472,4796531,4155159,641372
2009-11-01,Minnesota,4096104,2921699,2692020,229679
2009-11-01,Mississippi,2204638,1260322,1131805,128517
2009-11-01,Missouri,4623522,3042320,2752712,289608
2009-11-01,Montana,769618,498984,462518,36466
2009-11-01,Nebraska,1368134,986060,937863,48197
2009-11-01,Nevada,2006744,1357494,1180770,176724
2009-11-01,Ohio,8964826,5880807,5236980,643827
2009-11-01,Oklahoma,2785467,1762634,1639789,122845
2009-11-01,Oregon,3021588,1958343,1749369,208974
2009-11-01,Pennsylvania,9960433,6328965,5807933,521032
2009-11-01,Tennessee,4886991,3030297,2711254,319043
2009-11-01,Texas,18221759,12045372,11050184,995188
2009-11-01,Utah,1986362,1356818,1250061,106757
2009-11-01,Vermont,508329,358407,334938,23469
2009-11-01,Virginia,6031267,4129176,3822838,306338
2009-11-01,Washington,5205382,3451994,3136631,315363
2009-11-01,Wisconsin,4427819,3084461,2798737,285724
2009-11-01,Wyoming,420108,300001,278031,21970
2009-12-01,Alabama,3634419,2140674,1903811,236863
2009-12-01,Alaska,514467,359932,329829,30103
2009-12-01,Arizona,4987853,3115241,2785895,329346
2009-12-01,Arkansas,2212101,1343147,1236853,106294
2009-12-01,California,28111925,18254035,15975922,2278113
2009-12-01,Colorado,3867378,2708249,2474419,233830
2009-12-01,Connecticut,2756043,1889075,1712315,176760
2009-12-01,Delaware,689720,430322,391519,38803
2009-12-01,Florida,14657213,8987807,8017476,970331
2009-12-01,Georgia,7348529,4776286,4258241,518045
2009-12-01,Hawaii,984741,632327,588446,43881
2009-12-01,Idaho,1156479,761927,692251,69676
2009-12-01,Illinois,9906794,6601820,5851687,750133
2009-12-01,Indiana,4922905,3167003,2829818,337185
2009-12-01,Iowa,2340638,1666046,1557898,108148
2009-12-01,Kansas,2137157,1503151,1394859,108292
2009-12-01,Kentucky,3340801,2053885,1829926,223959
2009-12-01,Louisiana,3403890,2061538,1915554,145984
2009-12-01,Maine,1066053,695077,634656,60421
2009-12-01,Maryland,4419022,3043485,2799405,244080
2009-12-01,Massachusetts,5259886,3462787,3168295,294492
2009-12-01,Michigan,7776809,4788182,4151879,636303
2009-12-01,Minnesota,4098214,2923951,2694944,229007
2009-12-01,Mississippi,2205398,1262711,1131753,130958
2009-12-01,Missouri,4625852,3041155,2749112,292043
2009-12-01,Montana,770036,499358,462376,36982
2009-12-01,Nebraska,1369023,986333,937752,48581
2009-12-01,Nevada,2007872,1357344,1177391,179953
2009-12-01,Ohio,8965878,5886389,5234320,652069
2009-12-01,Oklahoma,2787381,1762250,1639144,123106
2009-12-01,Oregon,3023994,1962640,1751681,210959
2009-12-01,Pennsylvania,9963526,6329739,5803095,526644
2009-12-01,Tennessee,4890561,3038713,2718884,319829
2009-12-01,Texas,18247563,12070223,11072620,997603
2009-12-01,Utah,1989021,1354784,1247251,107533
2009-12-01,Vermont,508622,358555,334803,23752
2009-12-01,Virginia,6037319,4132983,3821237,311746
2009-12-01,Washington,5211219,3451532,3132862,318670
2009-12-01,Wisconsin,4429332,3083749,2797682,286067
2009-12-01,Wyoming,420366,300619,277989,22630
2010-01-01,Alabama,3636380,2143297,1906185,237112
2010-01-01,Alaska,514628,360431,330113,30318
2010-01-01,Arizona,4994110,3115797,2785351,330446
2010-01-01,Arkansas,2213503,1343957,1237151,106806
2010-01-01,California,28141513,18288466,15991766,2296700
2010-01-01,Colorado,3871967,2711291,2471793,239498
2010-01-01,Connecticut,2757497,1892594,1712632,179962
2010-01-01,Delaware,690331,430527,391523,39004
2010-01-01,Florida,14670087,9011633,8031055,980578
2010-01-01,Georgia,7356794,4778162,4261834,516328
2010-01-01,Hawaii,985330,634566,590573,43993
2010-01-01,Idaho,1157503,762726,693074,69652
2010-01-01,Illinois,9911282,6616172,5862132,754040
2010-01-01,Indiana,4925217,3169128,2830634,338494
2010-01-01,Iowa,2341680,1668161,1560395,107766
2010-01-01,Kansas,2138455,1502302,1394052,108250
2010-01-01,Kentucky,3342861,2057265,1833428,223837
2010-01-01,Louisiana,3406282,2065893,1918232,147661
2010-01-01,Maine,1066138,696250,635414,60836
2010-01-01,Maryland,4422798,3049772,2803421,246351
2010-01-01,Massachusetts,5263246,3468119,3173610,294509
2010-01-01,Michigan,7777357,4785142,4153410,631732
2010-01-01,Minnesota,4100422,2928681,2700412,228269
2010-01-01,Mississippi,2206254,1265805,1133350,132455
2010-01-01,Missouri,4628246,3042296,2748478,293818
2010-01-01,Montana,770491,500111,462743,37368
2010-01-01,Nebraska,1370014,987372,938545,48827
2010-01-01,Nevada,2009168,1358406,1175465,182941
2010-01-01,Ohio,8967104,5895027,5238928,656099
2010-01-01,Oklahoma,2789349,1763483,1640540,122943
2010-01-01,Oregon,3026512,1969690,1756262,213428
2010-01-01,Pennsylvania,9966890,6338833,5805453,533380
2010-01-01,Tennessee,4894242,3050578,2730789,319789
2010-01-01,Texas,18274485,12108919,11106882,1002037
2010-01-01,Utah,1991747,1354098,1245935,108163
2010-01-01,Vermont,508821,359006,335086,23920
2010-01-01,Virginia,6043575,4139523,3823909,315614
2010-01-01,Washington,5217186,3454420,3133335,321085
2010-01-01,Wisconsin,4430954,3086454,2800945,285509
2010-01-01,Wyoming,420608,301350,278343,23007
2010-02-01,Alabama,3637985,2145780,1909481,236299
2010-02-01,Alaska,514760,360957,330579,30378
2010-02-01,Arizona,4999841,3116749,2786396,330353
2010-02-01,Arkansas,2214703,1345947,1239114,106833
2010-02-01,California,28168472,18327194,16020128,2307066
2010-02-01,Colorado,3876247,2714852,2471124,243728
2010-02-01,Connecticut,2758668,1897276,1714982,182294
2010-02-01,Delaware,690834,431248,392300,38948
2010-02-01,Florida,14681071,9039135,8052755,986380
2010-02-01,Georgia,7364379,4725950,4213413,512537
2010-02-01,Hawaii,985714,637461,593468,43993
2010-02-01,Idaho,1158417,763525,694203,69322
2010-02-01,Illinois,9914870,6628765,5878039,750726
2010-02-01,Indiana,4927158,3172852,2834812,338040
2010-02-01,Iowa,2342488,1671781,1564951,106830
2010-02-01,Kansas,2139596,1502043,1394188,107855
2010-02-01,Kentucky,3344688,2060696,1838044,222652
2010-02-01,Louisiana,3408339,2071784,1922452,149332
2010-02-01,Maine,1066067,697409,636533,60876
2010-02-01,Maryland,4426148,3057423,2810540,246883
2010-02-01,Massachusetts,5266159,3473982,3180656,293326
2010-02-01,Michigan,7777182,4784327,4158820,625507
2010-02-01,Minnesota,4102269,2933933,2707327,226606
2010-02-01,Mississippi,2206814,1268874,1135839,133035
2010-02-01,Missouri,4630244,3043869,2749657,294212
2010-02-01,Montana,770816,500923,463419,37504
2010-02-01,Nebraska,1370817,988776,939919,48857
2010-02-01,Nevada,2010225,1359771,1174541,185230
2010-02-01,Ohio,8967563,5902220,5248612,653608
2010-02-01,Oklahoma,2791092,1765258,1643105,122153
2010-02-01,Oregon,3028729,1977638,1762239,215399
2010-02-01,Pennsylvania,9969289,6350528,5812330,538198
2010-02-01,Tennessee,4897491,3063620,2745903,317717
2010-02-01,Texas,18299762,12151988,11146453,1005535
2010-02-01,Utah,1994390,1354151,1245598,108553
2010-02-01,Vermont,509023,359539,335633,23906
2010-02-01,Virginia,6049306,4146809,3829743,317066
2010-02-01,Washington,5222744,3458632,3136999,321633
2010-02-01,Wisconsin,4432255,3089495,2806625,282870
2010-02-01,Wyoming,420826,301933,278975,22958
2010-03-01,Alabama,3639724,2146904,1912541,234363
2010-03-01,Alaska,514896,361357,331099,30258
2010-03-01,Arizona,5005603,3116147,2787165,328982
2010-03-01,Arkansas,2215934,1348707,1242264,106443
2010-03-01,California,28195088,18359589,16050996,2308593
2010-03-01,Colorado,3880636,2717321,2471367,245954
2010-03-01,Connecticut,2759910,1902002,1718400,183602
2010-03-01,Delaware,691403,432340,393640,38700
2010-03-01,Florida,14692208,9065533,8076970,988563
2010-03-01,Georgia,7372287,4708859,4201580,507279
2010-03-01,Hawaii,986160,640630,596671,43959
2010-03-01,Idaho,1159426,763983,695240,68743
2010-03-01,Illinois,9918785,6634842,5894031,740811
2010-03-01,Indiana,4929346,3177346,2841624,335722
2010-03-01,Iowa,2343400,1675368,1570007,105361
2010-03-01,Kansas,2140798,1501694,1394805,106889
2010-03-01,Kentucky,3346711,2062897,1842725,220172
2010-03-01,Louisiana,3410594,2077866,1927051,150815
2010-03-01,Maine,1066137,698109,637570,60539
2010-03-01,Maryland,4429620,3064844,2818977,245867
2010-03-01,Massachusetts,5269256,3478448,3187591,290857
2010-03-01,Michigan,7777301,4783504,4165926,617578
2010-03-01,Minnesota,4104281,2938371,2714349,224022
2010-03-01,Mississippi,2207537,1271407,1138614,132793
2010-03-01,Missouri,4632421,3044587,2751280,293307
2010-03-01,Montana,771187,501546,464199,37347
2010-03-01,Nebraska,1371688,990060,941517,48543
2010-03-01,Nevada,2011335,1360604,1173988,186616
2010-03-01,Ohio,8968417,5904597,5259913,644684
2010-03-01,Oklahoma,2792911,1766675,1645979,120696
2010-03-01,Oregon,3031074,1984778,1768457,216321
2010-03-01,Pennsylvania,9972037,6359683,5820638,539045
2010-03-01,Tennessee,4900953,3076129,2762469,313660
2010-03-01,Texas,18325113,12191275,11184615,1006660
2010-03-01,Utah,1997075,1354198,1245524,108674
2010-03-01,Vermont,509216,359952,336236,23716
2010-03-01,Virginia,6055213,4153490,3837310,316180
2010-03-01,Washington,5228475,3462164,3141865,320299
2010-03-01,Wisconsin,4433668,3090610,2812648,277962
2010-03-01,Wyoming,421067,302202,279686,22516
2010-04-01,Alabama,3696845,2197720,1966202,231518
2010-04-01,Alaska,515851,361538,331564,29974
2010-04-01,Arizona,4838466,3113354,2786810,326544
2010-04-01,Arkansas,2231366,1351964,1246062,105902
2010-04-01,California,28538466,18381603,16078778,2302825
2010-04-01,Colorado,3848295,2718188,2471781,246407
2010-04-01,Connecticut,2802329,1906595,1722636,183959
2010-04-01,Delaware,701527,433690,395333,38357
2010-04-01,Florida,14959822,9099777,8111208,988569
2010-04-01,Georgia,7276848,4701086,4199284,501802
2010-04-01,Hawaii,1039195,643754,599835,43919
2010-04-01,Idaho,1163327,764012,696013,67999
2010-04-01,Illinois,9881090,6634091,5907874,726217
2010-04-01,Indiana,4962744,3181319,2849394,331925
2010-04-01,Iowa,2358250,1677557,1573836,103721
2010-04-01,Kansas,2147765,1501224,1395682,105542
2010-04-01,Kentucky,3340225,2063774,1847055,216719
2010-04-01,Louisiana,3434434,2083571,1931260,152311
2010-04-01,Maine,1074471,698248,638356,59892
2010-04-01,Maryland,4490945,3071526,2827499,244027
2010-04-01,Massachusetts,5224455,3480846,3193516,287330
2010-04-01,Michigan,7718784,4781950,4173309,608641
2010-04-01,Minnesota,4108452,2941579,2720784,220795
2010-04-01,Mississippi,2228901,1273382,1141411,131971
2010-04-01,Missouri,4618728,3044286,2752890,291396
2010-04-01,Montana,777438,501897,464966,36931
2010-04-01,Nebraska,1388012,991039,943174,47865
2010-04-01,Nevada,2073299,1360595,1173507,187088
2010-04-01,Ohio,8958283,5901230,5269891,631339
2010-04-01,Oklahoma,2836218,1767216,1648598,118618
2010-04-01,Oregon,3024399,1990068,1773965,216103
2010-04-01,Pennsylvania,10056682,6364141,5829048,535093
2010-04-01,Tennessee,4916740,3087199,2778857,308342
2010-04-01,Texas,18541655,12222661,11218075,1004586
2010-04-01,Utah,1952084,1353881,1245364,108517
2010-04-01,Vermont,506421,360198,336797,23401
2010-04-01,Virginia,6149198,4159068,3845699,313369
2010-04-01,Washington,5233189,3463843,3146041,317802
2010-04-01,Wisconsin,4428585,3089354,2817875,271479
2010-04-01,Wyoming,433003,302183,280341,21842
2010-05-01,Alabama,3700013,2211777,1983756,228021
2010-05-01,Alaska,516810,361511,331982,29529
2010-05-01,Arizona,4843931,3108504,2785501,323003
2010-05-01,Arkansas,2233214,1355055,1249752,105303
2010-05-01,California,28564851,18391244,16101040,2290204
2010-05-01,Colorado,3852091,2717428,2471774,245654
2010-05-01,Connecticut,2804758,1910818,1727354,183464
2010-05-01,Delaware,702130,435187,397214,37973
2010-05-01,Florida,14974268,9128507,8141742,986765
2010-05-01,Georgia,7285144,4695916,4199284,496632
2010-05-01,Hawaii,1040697,646474,602624,43850
2010-05-01,Idaho,1164326,763624,696473,67151
2010-05-01,Illinois,9885775,6627042,5918616,708426
2010-05-01,Indiana,4965541,3183430,2856480,326950
2010-05-01,Iowa,2359389,1677764,1575622,102142
2010-05-01,Kansas,2148511,1500581,1396641,103940
2010-05-01,Kentucky,3343644,2063716,1851019,212697
2010-05-01,Louisiana,3437625,2088368,1934470,153898
2010-05-01,Maine,1074480,697946,638921,59025
2010-05-01,Maryland,4495161,3077202,2835458,241744
2010-05-01,Massachusetts,5230789,3481152,3198192,282960
2010-05-01,Michigan,7719607,4779667,4179998,599669
2010-05-01,Minnesota,4111034,2943440,2726065,217375
2010-05-01,Mississippi,2230751,1274962,1144100,130862
2010-05-01,Missouri,4621534,3043234,2754497,288737
2010-05-01,Montana,777863,501975,465645,36330
2010-05-01,Nebraska,1388844,991699,944751,46948
2010-05-01,Nevada,2074378,1359713,1173032,186681
2010-05-01,Ohio,8961281,5892307,5276565,615742
2010-05-01,Oklahoma,2838991,1766844,1650772,116072
2010-05-01,Oregon,3027045,1992953,1778073,214880
2010-05-01,Pennsylvania,10060817,6363851,5836971,526880
2010-05-01,Tennessee,4921391,3096008,2793510,302498
2010-05-01,Texas,18567698,12244873,11246029,998844
2010-05-01,Utah,1954737,1353095,1245042,108053
2010-05-01,Vermont,506599,360279,337283,22996
2010-05-01,Virginia,6155076,4163253,3854150,309103
2010-05-01,Washington,5237362,3463335,3148394,314941
2010-05-01,Wisconsin,4430315,3086350,2821846,264504
2010-05-01,Wyoming,433341,301985,280897,21088
2010-06-01,Alabama,3703287,2214822,1990063,224759
2010-06-01,Alaska,517816,361350,332315,29035
2010-06-01,Arizona,4849422,3102036,2782917,319119
2010-06-01,Arkansas,2235014,1357180,1252284,104896
2010-06-01,California,28591878,18389824,16113195,2276629
2010-06-01,Colorado,3855998,2715479,2470389,245090
2010-06-01,Connecticut,2807133,1914097,1731412,182685
2010-06-01,Delaware,702750,436637,398992,37645
2010-06-01,Florida,14988894,9150806,8165455,985351
2010-06-01,Georgia,7293730,4692273,4199144,493129
2010-06-01,Hawaii,1042459,648687,604821,43866
2010-06-01,Idaho,1165402,762884,696497,66387
2010-06-01,Illinois,9890376,6615981,5925185,690796
2010-06-01,Indiana,4968191,3183185,2861326,321859
2010-06-01,Iowa,2360458,1676132,1575290,100842
2010-06-01,Kansas,2149335,1499954,1397316,102638
2010-06-01,Kentucky,3347186,2063356,1854264,209092
2010-06-01,Louisiana,3440859,2091461,1935671,155790
2010-06-01,Maine,1074478,697428,639223,58205
2010-06-01,Maryland,4499403,3081487,2841759,239728
2010-06-01,Massachusetts,5237003,3479736,3201063,278673
2010-06-01,Michigan,7720262,4776679,4184137,592542
2010-06-01,Minnesota,4113576,2943802,2729228,214574
2010-06-01,Mississippi,2232572,1309109,1179145,129964
2010-06-01,Missouri,4624402,3041931,2755633,286298
2010-06-01,Montana,778260,501750,466046,35704
2010-06-01,Nebraska,1389679,992091,945979,46112
2010-06-01,Nevada,2075511,1358272,1172324,185948
2010-06-01,Ohio,8964153,5879456,5278705,600751
2010-06-01,Oklahoma,2841937,1765862,1652192,113670
2010-06-01,Oregon,3029692,1994048,1780620,213428
2010-06-01,Pennsylvania,10064783,6360595,5842888,517707
2010-06-01,Tennessee,4926066,3101945,2804364,297581
2010-06-01,Texas,18594205,12259778,11267141,992637
2010-06-01,Utah,1957360,1351732,1244308,107424
2010-06-01,Vermont,506795,360157,337576,22581
2010-06-01,Virginia,6161486,4165768,3861060,304708
2010-06-01,Washington,5241659,3461303,3148334,312969
2010-06-01,Wisconsin,4432000,3082609,2824115,258494
2010-06-01,Wyoming,433698,301753,281308,20445
2010-07-01,Alabama,3706618,2215237,1992482,222755
2010-07-01,Alaska,518874,361237,332532,28705
2010-07-01,Arizona,4855271,3094880,2779038,315842
2010-07-01,Arkansas,2237003,1358003,1253026,104977
2010-07-01,California,28619823,18384037,16113653,2270384
2010-07-01,Colorado,3860150,2713677,2467557,246120
2010-07-01,Connecticut,2809705,1916460,1734133,182327
2010-07-01,Delaware,703370,437815,400363,37452
2010-07-01,Florida,15004298,9169009,8181978,987031
2010-07-01,Georgia,7301868,4691252,4198521,492731
2010-07-01,Hawaii,1044210,650583,606535,44048
2010-07-01,Idaho,1166472,761967,696118,65849
2010-07-01,Illinois,9895347,6605960,5929180,676780
2010-07-01,Indiana,4971237,3180859,2863150,317709
2010-07-01,Iowa,2361712,1673866,1573698,100168
2010-07-01,Kansas,2150262,1499521,1397499,102022
2010-07-01,Kentucky,3350635,2063585,1856614,206971
2010-07-01,Louisiana,3444273,2092507,1934492,158015
2010-07-01,Maine,1074529,697027,639323,57704
2010-07-01,Maryland,4504017,3084531,2845807,238724
2010-07-01,Massachusetts,5243644,3478152,3202585,275567
2010-07-01,Michigan,7721434,4773819,4184857,588962
2010-07-01,Minnesota,4116358,2943204,2729891,213313
2010-07-01,Mississippi,2234489,1326873,1196962,129911
2010-07-01,Missouri,4627241,3041121,2756025,285096
2010-07-01,Montana,778719,501304,466066,35238
2010-07-01,Nebraska,1390608,992335,946748,45587
2010-07-01,Nevada,2076775,1357070,1171332,185738
2010-07-01,Ohio,8967602,5866162,5277025,589137
2010-07-01,Oklahoma,2844698,1764974,1652848,112126
2010-07-01,Oregon,3032496,1994552,1781970,212582
2010-07-01,Pennsylvania,10069471,6357444,5846188,511256
2010-07-01,Tennessee,4931020,3105034,2810185,294849
2010-07-01,Texas,18621263,12272590,11282344,990246
2010-07-01,Utah,1960150,1350000,1243121,106879
2010-07-01,Vermont,506980,359881,337624,22257
2010-07-01,Virginia,6168295,4167097,3865710,301387
2010-07-01,Washington,5246398,3458973,3146426,312547
2010-07-01,Wisconsin,4433927,3079417,2824935,254482
2010-07-01,Wyoming,434045,301585,281564,20021
2010-08-01,Alabama,3708665,2215825,1993456,222369
2010-08-01,Alaska,519938,361349,332690,28659
2010-08-01,Arizona,4862034,3088178,2774664,313514
2010-08-01,Arkansas,2238891,1357870,1252260,105610
2010-08-01,California,28651165,18380281,16106916,2273365
2010-08-01,Colorado,3866394,2713080,2464356,248724
2010-08-01,Connecticut,2811743,1918237,1735650,182587
2010-08-01,Delaware,704160,438620,401248,37372
2010-08-01,Florida,15024207,9186214,8194731,991483
2010-08-01,Georgia,7309203,4693766,4198504,495262
2010-08-01,Hawaii,1045500,652315,607978,44337
2010-08-01,Idaho,1167725,761137,695586,65551
2010-08-01,Illinois,9901550,6600053,5933099,666954
2010-08-01,Indiana,4974530,3177460,2862980,314480
2010-08-01,Iowa,2363261,1672341,1572218,100123
2010-08-01,Kansas,2151610,1499329,1397291,102038
2010-08-01,Kentucky,3352851,2064904,1858381,206523
2010-08-01,Louisiana,3447819,2091887,1931705,160182
2010-08-01,Maine,1075061,697050,639483,57567
2010-08-01,Maryland,4508940,3087064,2848274,238790
2010-08-01,Massachusetts,5248732,3477864,3203993,273871
2010-08-01,Michigan,7725162,4754004,4183007,570997
2010-08-01,Minnesota,4119761,2942522,2728897,213625
2010-08-01,Mississippi,2235801,1336480,1205884,130596
2010-08-01,Missouri,4629639,3041423,2755882,285541
2010-08-01,Montana,779335,500825,465795,35030
2010-08-01,Nebraska,1391584,992637,947230,45407
2010-08-01,Nevada,2078269,1356662,1170347,186315
2010-08-01,Ohio,8971266,5855186,5273622,581564
2010-08-01,Oklahoma,2847076,1764631,1653189,111442
2010-08-01,Oregon,3035865,1995295,1782838,212457
2010-08-01,Pennsylvania,10075228,6356859,5848142,508717
2010-08-01,Tennessee,4935322,3105998,2811416,294582
2010-08-01,Texas,18653451,12287949,11294712,993237
2010-08-01,Utah,1963071,1348321,1241798,106523
2010-08-01,Vermont,507341,359635,337553,22082
2010-08-01,Virginia,6175954,4168162,3868904,299258
2010-08-01,Washington,5252718,3457191,3143795,313396
2010-08-01,Wisconsin,4436495,3077502,2825260,252242
2010-08-01,Wyoming,434340,301540,281736,19804
2010-09-01,Alabama,3710620,2216902,1993580,223322
2010-09-01,Alaska,520706,361682,332846,28836
2010-09-01,Arizona,4868640,3082127,2770279,311848
2010-09-01,Arkansas,2240717,1357262,1250630,106632
2010-09-01,California,28682473,18378828,16097746,2281082
2010-09-01,Colorado,3872252,2713611,2461710,251901
2010-09-01,Connecticut,2813819,1919267,1736057,183210
2010-09-01,Delaware,704947,439101,401788,37313
2010-09-01,Florida,15043725,9203325,8206908,996417
2010-09-01,Georgia,7316156,4698525,4199495,499030
2010-09-01,Hawaii,1046297,653928,609279,44649
2010-09-01,Idaho,1168906,760571,695155,65416
2010-09-01,Illinois,9907377,6596284,5936658,659626
2010-09-01,Indiana,4977966,3173755,2862333,311422
2010-09-01,Iowa,2364850,1672191,1571768,100423
2010-09-01,Kansas,2152775,1499286,1396809,102477
2010-09-01,Kentucky,3354938,2066702,1859754,206948
2010-09-01,Louisiana,3451131,2090381,1928355,162026
2010-09-01,Maine,1075651,697492,639857,57635
2010-09-01,Maryland,4513628,3089416,2850163,239253
2010-09-01,Massachusetts,5253897,3478753,3205662,273091
2010-09-01,Michigan,7729079,4735269,4179731,555538
2010-09-01,Minnesota,4123243,2942201,2727753,214448
2010-09-01,Mississippi,2236920,1341711,1210162,131549
2010-09-01,Missouri,4632006,3042363,2755310,287053
2010-09-01,Montana,779928,500372,465321,35051
2010-09-01,Nebraska,1392543,993061,947558,45503
2010-09-01,Nevada,2079628,1356846,1169573,187273
2010-09-01,Ohio,8975063,5846806,5270258,576548
2010-09-01,Oklahoma,2849245,1764391,1653363,111028
2010-09-01,Oregon,3039325,1996450,1783866,212584
2010-09-01,Pennsylvania,10081106,6358506,5850062,508444
2010-09-01,Tennessee,4939470,3105987,2809706,296281
2010-09-01,Texas,18684832,12306687,11306167,1000520
2010-09-01,Utah,1965965,1346821,1240547,106274
2010-09-01,Vermont,507719,359493,337459,22034
2010-09-01,Virginia,6182352,4169589,3871974,297615
2010-09-01,Washington,5258655,3456058,3141316,314742
2010-09-01,Wisconsin,4439156,3076543,2825612,250931
2010-09-01,Wyoming,434583,301652,281862,19790
2010-10-01,Alabama,3712775,2217869,1993177,224692
2010-10-01,Alaska,521665,362226,333152,29074
2010-10-01,Arizona,4875453,3076852,2766599,310253
2010-10-01,Arkansas,2242644,1356803,1249134,107669
2010-10-01,California,28715259,18378713,16092500,2286213
2010-10-01,Colorado,3878447,2714795,2460636,254159
2010-10-01,Connecticut,2815960,1919649,1735952,183697
2010-10-01,Delaware,705737,439480,402336,37144
2010-10-01,Florida,15063974,9215892,8216792,999100
2010-10-01,Georgia,7323865,4703944,4202054,501890
2010-10-01,Hawaii,1047433,655653,610770,44883
2010-10-01,Idaho,1170177,760364,695058,65306
2010-10-01,Illinois,9913651,6592116,5939556,652560
2010-10-01,Indiana,4981455,3170742,2863424,307318
2010-10-01,Iowa,2366432,1673392,1572819,100573
2010-10-01,Kansas,2154068,1499560,1396563,102997
2010-10-01,Kentucky,3357264,2068269,1861137,207132
2010-10-01,Louisiana,3454715,2089083,1925719,163364
2010-10-01,Maine,1076239,698162,640515,57647
2010-10-01,Maryland,4518646,3091736,2852813,238923
2010-10-01,Massachusetts,5259094,3480429,3208079,272350
2010-10-01,Michigan,7733095,4717673,4177199,540474
2010-10-01,Minnesota,4126763,2942469,2728215,214254
2010-10-01,Mississippi,2238228,1344467,1212089,132378
2010-10-01,Missouri,4634573,3043450,2755173,288277
2010-10-01,Montana,780526,500038,464869,35169
2010-10-01,Nebraska,1393532,993816,948117,45699
2010-10-01,Nevada,2081102,1357352,1169345,188007
2010-10-01,Ohio,8978933,5840618,5269337,571281
2010-10-01,Oklahoma,2851655,1764070,1653719,110351
2010-10-01,Oregon,3042809,1998014,1786006,212008
2010-10-01,Pennsylvania,10087177,6362019,5854037,507982
2010-10-01,Tennessee,4943817,3106786,2808210,298576
2010-10-01,Texas,18717463,12329159,11320132,1009027
2010-10-01,Utah,1968852,1345724,1239726,105998
2010-10-01,Vermont,508111,359468,337452,22016
2010-10-01,Virginia,6190036,4172079,3876726,295353
2010-10-01,Washington,5264988,3455291,3139893,315398
2010-10-01,Wisconsin,4441858,3076209,2826902,249307
2010-10-01,Wyoming,434866,301921,282034,19887
2010-11-01,Alabama,3714308,2217791,1992440,225351
2010-11-01,Alaska,522685,362765,333546,29219
2010-11-01,Arizona,4881581,3072209,2763909,308300
2010-11-01,Arkansas,2244183,1356630,1248235,108395
2010-11-01,California,28745035,18376501,16093722,2282779
2010-11-01,Colorado,3884216,2715531,2461626,253905
2010-11-01,Connecticut,2817651,1919392,1735829,183563
2010-11-01,Delaware,706439,439945,403158,36787
2010-11-01,Florida,15081696,9239476,8241889,997587
2010-11-01,Georgia,7330672,4708019,4205813,502206
2010-11-01,Hawaii,1048818,657494,612571,44923
2010-11-01,Idaho,1171219,760441,695300,65141
2010-11-01,Illinois,9918371,6584845,5940621,644224
2010-11-01,Indiana,4984018,3168580,2867137,301443
2010-11-01,Iowa,2367571,1675189,1574964,100225
2010-11-01,Kansas,2155106,1499951,1396803,103148
2010-11-01,Kentucky,3359139,2069007,1862657,206350
2010-11-01,Louisiana,3457717,2088150,1924248,163902
2010-11-01,Maine,1076699,698775,641355,57420
2010-11-01,Maryland,4522968,3093338,2856158,237180
2010-11-01,Massachusetts,5263454,3482203,3211354,270849
2010-11-01,Michigan,7735723,4700743,4176364,524379
2010-11-01,Minnesota,4129555,2942990,2730889,212101
2010-11-01,Mississippi,2239207,1345720,1212871,132849
2010-11-01,Missouri,4636373,3043917,2755917,288000
2010-11-01,Montana,781026,499828,464588,35240
2010-11-01,Nebraska,1394320,994951,949114,45837
2010-11-01,Nevada,2082333,1357786,1169711,188075
2010-11-01,Ohio,8981177,5834361,5271037,563324
2010-11-01,Oklahoma,2853727,1763618,1654525,109093
2010-11-01,Oregon,3045757,1999456,1789598,209858
2010-11-01,Pennsylvania,10091215,6365866,5860034,505832
2010-11-01,Tennessee,4947403,3109113,2809060,300053
2010-11-01,Texas,18748043,12352386,11337423,1014963
2010-11-01,Utah,1971498,1345016,1239409,105607
2010-11-01,Vermont,508419,359473,337528,21945
2010-11-01,Virginia,6197094,4175447,3883599,291848
2010-11-01,Washington,5270758,3453762,3139343,314419
2010-11-01,Wisconsin,4443782,3075716,2829157,246559
2010-11-01,Wyoming,435098,302247,282256,19991
2010-12-01,Alabama,3715741,2216409,1991718,224691
2010-12-01,Alaska,523689,363140,333936,29204
2010-12-01,Arizona,4887492,3067605,2762374,305231
2010-12-01,Arkansas,2245614,1356570,1247898,108672
2010-12-01,California,28773773,18370136,16100812,2269324
2010-12-01,Colorado,3889801,2715890,2464572,251318
2010-12-01,Connecticut,2819242,1918366,1735774,182592
2010-12-01,Delaware,707142,440553,404310,36243
2010-12-01,Florida,15098874,9245364,8253492,991872
2010-12-01,Georgia,7337313,4709976,4210339,499637
2010-12-01,Hawaii,1050130,659209,614428,44781
2010-12-01,Idaho,1172254,760670,695790,64880
2010-12-01,Illinois,9922695,6573920,5938573,635347
2010-12-01,Indiana,4986382,3167428,2873191,294237
2010-12-01,Iowa,2368633,1676546,1577238,99308
2010-12-01,Kansas,2156053,1500190,1397503,102687
2010-12-01,Kentucky,3360884,2068709,1864297,204412
2010-12-01,Louisiana,3460659,2087244,1923828,163416
2010-12-01,Maine,1077041,699099,642145,56954
2010-12-01,Maryland,4527177,3093874,2859411,234463
2010-12-01,Massachusetts,5267534,3483339,3215075,268264
2010-12-01,Michigan,7738064,4684248,4176837,507411
2010-12-01,Minnesota,4132148,2943772,2735520,208252
2010-12-01,Mississippi,2240112,1346211,1213311,132900
2010-12-01,Missouri,4637996,3043280,2757397,285883
2010-12-01,Montana,781473,499719,464553,35166
2010-12-01,Nebraska,1395040,996345,950496,45849
2010-12-01,Nevada,2083488,1357880,1170535,187345
2010-12-01,Ohio,8983084,5826065,5273672,552393
2010-12-01,Oklahoma,2855615,1762867,1655823,107044
2010-12-01,Oregon,3048548,2000082,1794045,206037
2010-12-01,Pennsylvania,10094881,6367685,5866464,501221
2010-12-01,Tennessee,4950759,3112714,2812682,300032
2010-12-01,Texas,18777822,12372836,11356570,1016266
2010-12-01,Utah,1974065,1344606,1239497,105109
2010-12-01,Vermont,508692,359459,337650,21809
2010-12-01,Virginia,6203808,4179321,3892116,287205
2010-12-01,Washington,5276239,3450811,3139125,311686
2010-12-01,Wisconsin,4445481,3074471,2831638,242833
2010-12-01,Wyoming,435291,302487,282475,20012
2011-01-01,Alabama,3717148,2214624,1991574,223050
2011-01-01,Alaska,524423,363404,334356,29048
2011-01-01,Arizona,4893368,3063471,2761928,301543
2011-01-01,Arkansas,2247108,1356376,1247709,108667
2011-01-01,California,28802283,18363805,16113386,2250419
2011-01-01,Colorado,3895089,2716453,2469040,247413
2011-01-01,Connecticut,2820871,1917092,1736022,181070
2011-01-01,Delaware,707838,441299,405681,35618
2011-01-01,Florida,15115903,9251721,8267299,984422
2011-01-01,Georgia,7343837,4711595,4216168,495427
2011-01-01,Hawaii,1050960,660636,616041,44595
2011-01-01,Idaho,1173278,761044,696460,64584
2011-01-01,Illinois,9927281,6562937,5934625,628312
2011-01-01,Indiana,4988952,3168166,2881081,287085
2011-01-01,Iowa,2369761,1676887,1578751,98136
2011-01-01,Kansas,2156803,1500267,1398503,101764
2011-01-01,Kentucky,3362512,2067917,1866158,201759
2011-01-01,Louisiana,3463488,2086142,1924090,162052
2011-01-01,Maine,1077430,699101,642726,56375
2011-01-01,Maryland,4531264,3094091,2862372,231719
2011-01-01,Massachusetts,5271792,3483533,3218531,265002
2011-01-01,Michigan,7740726,4669483,4178511,490972
2011-01-01,Minnesota,4134872,2945255,2741797,203458
2011-01-01,Mississippi,2240917,1346725,1213959,132766
2011-01-01,Missouri,4639686,3042146,2759423,282723
2011-01-01,Montana,781908,499721,464781,34940
2011-01-01,Nebraska,1395701,997896,952121,45775
2011-01-01,Nevada,2084614,1357776,1171682,186094
2011-01-01,Ohio,8985195,5816035,5275424,540611
2011-01-01,Oklahoma,2857438,1761984,1657557,104427
2011-01-01,Oregon,3051463,1999833,1798493,201340
2011-01-01,Pennsylvania,10098875,6367786,5872521,495265
2011-01-01,Tennessee,4954125,3117268,2818458,298810
2011-01-01,Texas,18807299,12391831,11377422,1014409
2011-01-01,Utah,1976608,1344519,1239913,104606
2011-01-01,Vermont,509005,359441,337829,21612
2011-01-01,Virginia,6209446,4183595,3901342,282253
2011-01-01,Washington,5281394,3447125,3139152,307973
2011-01-01,Wisconsin,4447290,3072930,2834013,238917
2011-01-01,Wyoming,435435,302548,282676,19872
2011-02-01,Alabama,3718178,2212917,1991849,221068
2011-02-01,Alaska,525057,363514,334711,28803
2011-02-01,Arizona,4898622,3060176,2761805,298371
2011-02-01,Arkansas,2248324,1355709,1247149,108560
2011-02-01,California,28826883,18359121,16127796,2231325
2011-02-01,Colorado,3900018,2717045,2474007,243038
2011-02-01,Connecticut,2822128,1915799,1736443,179356
2011-02-01,Delaware,708429,442047,407022,35025
2011-02-01,Florida,15130726,9252149,8280635,971514
2011-02-01,Georgia,7349349,4713939,4222918,491021
2011-02-01,Hawaii,1051535,661609,617144,44465
2011-02-01,Idaho,1174126,761435,697172,64263
2011-02-01,Illinois,9930629,6554409,5929766,624643
2011-02-01,Indiana,4991071,3170670,2889335,281335
2011-02-01,Iowa,2370604,1676002,1579056,96946
2011-02-01,Kansas,2157303,1499954,1399506,100448
2011-02-01,Kentucky,3363785,2066889,1867770,199119
2011-02-01,Louisiana,3465991,2084405,1924223,160182
2011-02-01,Maine,1077709,698816,643048,55768
2011-02-01,Maryland,4534863,3094149,2864621,229528
2011-02-01,Massachusetts,5275498,3482261,3220677,261584
2011-02-01,Michigan,7742608,4665113,4180564,484549
2011-02-01,Minnesota,4137246,2947224,2747825,199399
2011-02-01,Mississippi,2241481,1347354,1214734,132620
2011-02-01,Missouri,4640819,3040520,2761650,278870
2011-02-01,Montana,782278,499700,465116,34584
2011-02-01,Nebraska,1396240,999312,953729,45583
2011-02-01,Nevada,2085509,1357524,1172858,184666
2011-02-01,Ohio,8986497,5804853,5274342,530511
2011-02-01,Oklahoma,2858912,1760853,1659149,101704
2011-02-01,Oregon,3054102,1998756,1801913,196843
2011-02-01,Pennsylvania,10101882,6366806,5876807,489999
2011-02-01,Tennessee,4956991,3121614,2824825,296789
2011-02-01,Texas,18834479,12409993,11398153,1011840
2011-02-01,Utah,1979059,1344597,1240415,104182
2011-02-01,Vermont,509200,359320,337959,21361
2011-02-01,Virginia,6214418,4187549,3909662,277887
2011-02-01,Washington,5286052,3443437,3139149,304288
2011-02-01,Wisconsin,4448743,3071357,2835627,235730
2011-02-01,Wyoming,435625,302436,282854,19582
2011-03-01,Alabama,3719329,2210958,1991840,219118
2011-03-01,Alaska,525998,363451,334935,28516
2011-03-01,Arizona,4903936,3057262,2761339,295923
2011-03-01,Arkansas,2249580,1354508,1246167,108341
2011-03-01,California,28851906,18354669,16139805,2214864
2011-03-01,Colorado,3905335,2717265,2478257,239008
2011-03-01,Connecticut,2823420,1914283,1736677,177606
2011-03-01,Delaware,709022,442611,408089,34522
2011-03-01,Florida,15145898,9250847,8290918,959929
2011-03-01,Georgia,7355534,4716845,4229650,487195
2011-03-01,Hawaii,1052652,662006,617560,44446
2011-03-01,Idaho,1175062,761692,697768,63924
2011-03-01,Illinois,9934177,6548847,5923813,625034
2011-03-01,Indiana,4993128,3173805,2895813,277992
2011-03-01,Iowa,2371487,1674053,1578220,95833
2011-03-01,Kansas,2158094,1499072,1400245,98827
2011-03-01,Kentucky,3365375,2065391,1868492,196899
2011-03-01,Louisiana,3468626,2081558,1923559,157999
2011-03-01,Maine,1077980,698343,643153,55190
2011-03-01,Maryland,4538624,3093519,2865617,227902
2011-03-01,Massachusetts,5279236,3479416,3221128,258288
2011-03-01,Michigan,7744339,4643729,4182090,461639
2011-03-01,Minnesota,4139617,2948872,2751699,197173
2011-03-01,Mississippi,2242215,1347717,1215162,132555
2011-03-01,Missouri,4642214,3038234,2763601,274633
2011-03-01,Montana,782660,499536,465377,34159
2011-03-01,Nebraska,1396850,1000380,955070,45310
2011-03-01,Nevada,2086463,1357202,1173836,183366
2011-03-01,Ohio,8987798,5793724,5270128,523596
2011-03-01,Oklahoma,2860602,1759425,1660147,99278
2011-03-01,Oregon,3056622,1997052,1803636,193416
2011-03-01,Pennsylvania,10104727,6364495,5877895,486600
2011-03-01,Tennessee,4960063,3124286,2830057,294229
2011-03-01,Texas,18862126,12426745,11416366,1010379
2011-03-01,Utah,1981579,1344706,1240829,103877
2011-03-01,Vermont,509462,358981,337921,21060
2011-03-01,Virginia,6220972,4189997,3915249,274748
2011-03-01,Washington,5291169,3440138,3139014,301124
2011-03-01,Wisconsin,4450178,3069439,2835861,233578
2011-03-01,Wyoming,435792,302188,283016,19172
2011-04-01,Alabama,3720594,2208488,1990933,217555
2011-04-01,Alaska,526677,363367,335095,28272
2011-04-01,Arizona,4909573,3054212,2760059,294153
2011-04-01,Arkansas,2250956,1353056,1244909,108147
2011-04-01,California,28878193,18352428,16147585,2204843
2011-04-01,Colorado,3910501,2717501,2481268,236233
2011-04-01,Connecticut,2824880,1912529,1736438,176091
2011-04-01,Delaware,709653,442904,408731,34173
2011-04-01,Florida,15161610,9247888,8297312,950576
2011-04-01,Georgia,7361501,4720314,4235488,484826
2011-04-01,Hawaii,1053281,661862,617235,44627
2011-04-01,Idaho,1176067,761780,698168,63612
2011-04-01,Illinois,9938364,6547150,5917025,630125
2011-04-01,Indiana,4995709,3177281,2899609,277672
2011-04-01,Iowa,2372558,1671639,1576628,95011
2011-04-01,Kansas,2158718,1497707,1400475,97232
2011-04-01,Kentucky,3366900,2063457,1867982,195475
2011-04-01,Louisiana,3471308,2077821,1922007,155814
2011-04-01,Maine,1078360,697858,643097,54761
2011-04-01,Maryland,4542385,3092166,2865055,227111
2011-04-01,Massachusetts,5283400,3476255,3220663,255592
2011-04-01,Michigan,7746818,4649446,4182815,466631
2011-04-01,Minnesota,4142356,2950303,2753517,196786
2011-04-01,Mississippi,2242874,1347672,1214885,132787
2011-04-01,Missouri,4643748,3035428,2764617,270811
2011-04-01,Montana,783082,499306,465514,33792
2011-04-01,Nebraska,1397510,1000982,955970,45012
2011-04-01,Nevada,2087465,1357102,1174492,182610
2011-04-01,Ohio,8989863,5784616,5264185,520431
2011-04-01,Oklahoma,2862265,1758254,1660641,97613
2011-04-01,Oregon,3059486,1995371,1803756,191615
2011-04-01,Pennsylvania,10108542,6362143,5875646,486497
2011-04-01,Tennessee,4963320,3124721,2832937,291784
2011-04-01,Texas,18890272,12444275,11431447,1012828
2011-04-01,Utah,1984210,1344845,1241064,103781
2011-04-01,Vermont,509732,358434,337692,20742
2011-04-01,Virginia,6226145,4191359,3917774,273585
2011-04-01,Washington,5296088,3437612,3138956,298656
2011-04-01,Wisconsin,4452042,3067488,2834768,232720
2011-04-01,Wyoming,435951,301888,283155,18733
2011-05-01,Alabama,3721955,2205934,1989359,216575
2011-05-01,Alaska,527433,363406,335267,28139
2011-05-01,Arizona,4915290,3051429,2758301,293128
2011-05-01,Arkansas,2252425,1352224,1244047,108177
2011-05-01,California,28904789,18358639,16155067,2203572
2011-05-01,Colorado,3915913,2719021,2483775,235246
2011-05-01,Connecticut,2826494,1911140,1736109,175031
2011-05-01,Delaware,710295,443006,408994,34012
2011-05-01,Florida,15177934,9246195,8302264,943931
2011-05-01,Georgia,7367896,4725451,4240831,484620
2011-05-01,Hawaii,1054070,661495,616453,45042
2011-05-01,Idaho,1177152,761901,698553,63348
2011-05-01,Illinois,9942921,6550817,5911356,639461
2011-05-01,Indiana,4998403,3181683,2901364,280319
2011-05-01,Iowa,2373762,1669479,1574841,94638
2011-05-01,Kansas,2159579,1496444,1400405,96039
2011-05-01,Kentucky,3368682,2061619,1866520,195099
2011-05-01,Louisiana,3474088,2074388,1920250,154138
2011-05-01,Maine,1078807,697593,643030,54563
2011-05-01,Maryland,4546292,3091054,2863648,227406
2011-05-01,Massachusetts,5287766,3474604,3220732,253872
2011-05-01,Michigan,7749462,4655295,4183535,471760
2011-05-01,Minnesota,4145265,2952020,2754433,197587
2011-05-01,Mississippi,2243657,1347406,1214100,133306
2011-05-01,Missouri,4645581,3032973,2764945,268028
2011-05-01,Montana,783539,499226,465635,33591
2011-05-01,Nebraska,1398234,1001373,956621,44752
2011-05-01,Nevada,2088489,1357610,1175043,182567
2011-05-01,Ohio,8992219,5778681,5258057,520624
2011-05-01,Oklahoma,2864136,1758164,1661115,97049
2011-05-01,Oregon,3062462,1994438,1802840,191598
2011-05-01,Pennsylvania,10112630,6362257,5872236,490021
2011-05-01,Tennessee,4966716,3123434,2833384,290050
2011-05-01,Texas,18918815,12467134,11445785,1021349
2011-05-01,Utah,1986941,1345294,1241349,103945
2011-05-01,Vermont,510055,357830,337364,20466
2011-05-01,Virginia,6231923,4193417,3918828,274589
2011-05-01,Washington,5301308,3436211,3139194,297017
2011-05-01,Wisconsin,4454088,3066514,2833324,233190
2011-05-01,Wyoming,436185,301719,283312,18407
2011-06-01,Alabama,3723324,2203524,1987938,215586
2011-06-01,Alaska,528424,363679,335579,28100
2011-06-01,Arizona,4921061,3049264,2757097,292167
2011-06-01,Arkansas,2253923,1352740,1244430,108310
2011-06-01,California,28932601,18375161,16169321,2205840
2011-06-01,Colorado,3921602,2722599,2487089,235510
2011-06-01,Connecticut,2828103,1910692,1736564,174128
2011-06-01,Delaware,710947,443112,409159,33953
2011-06-01,Florida,15194605,9247380,8309731,937649
2011-06-01,Georgia,7374731,4732626,4247308,485318
2011-06-01,Hawaii,1055250,661170,615617,45553
2011-06-01,Idaho,1178222,762271,699223,63048
2011-06-01,Illinois,9947621,6558897,5908670,650227
2011-06-01,Indiana,5000969,3186877,2902198,284679
2011-06-01,Iowa,2374926,1668016,1573438,94578
2011-06-01,Kansas,2160579,1495824,1400534,95290
2011-06-01,Kentucky,3370550,2060245,1865052,195193
2011-06-01,Louisiana,3476941,2072589,1919502,153087
2011-06-01,Maine,1079234,697688,643236,54452
2011-06-01,Maryland,4550304,3091103,2862954,228149
2011-06-01,Massachusetts,5292032,3475347,3222636,252711
2011-06-01,Michigan,7751914,4661368,4186322,475046
2011-06-01,Minnesota,4148114,2953753,2755639,198114
2011-06-01,Mississippi,2244505,1347132,1213310,133822
2011-06-01,Missouri,4647502,3031540,2765678,265862
2011-06-01,Montana,784030,499502,465976,33526
2011-06-01,Nebraska,1399025,1001954,957429,44525
2011-06-01,Nevada,2089613,1358808,1175945,182863
2011-06-01,Ohio,8994387,5774881,5253336,521545
2011-06-01,Oklahoma,2866167,1759602,1662261,97341
2011-06-01,Oregon,3065386,1994170,1801687,192483
2011-06-01,Pennsylvania,10116545,6366245,5870872,495373
2011-06-01,Tennessee,4970183,3121176,2832604,288572
2011-06-01,Texas,18948373,12497108,11463413,1033695
2011-06-01,Utah,1989686,1346394,1242153,104241
2011-06-01,Vermont,510359,357343,337129,20214
2011-06-01,Virginia,6238757,4197326,3920664,276662
2011-06-01,Washington,5306985,3435558,3139899,295659
2011-06-01,Wisconsin,4456029,3067022,2832807,234215
2011-06-01,Wyoming,436390,301800,283564,18236
2011-07-01,Alabama,3725094,2201393,1987565,213828
2011-07-01,Alaska,529293,364268,336147,28121
2011-07-01,Arizona,4927327,3047928,2757526,290402
2011-07-01,Arkansas,2255622,1354815,1246487,108328
2011-07-01,California,28961854,18400252,16196030,2204222
2011-07-01,Colorado,3927503,2728230,2492162,236068
2011-07-01,Connecticut,2829939,1911543,1738579,172964
2011-07-01,Delaware,711649,443468,409601,33867
2011-07-01,Florida,15212690,9251715,8322847,928868
2011-07-01,Georgia,7381294,4741366,4256369,484997
2011-07-01,Hawaii,1056275,660995,615010,45985
2011-07-01,Idaho,1179418,763074,700436,62638
2011-07-01,Illinois,9952918,6568779,5909893,658886
2011-07-01,Indiana,5004175,3192548,2903557,288991
2011-07-01,Iowa,2376369,1667412,1572853,94559
2011-07-01,Kansas,2161702,1496109,1401222,94887
2011-07-01,Kentucky,3372658,2059549,1864549,195000
2011-07-01,Louisiana,3480139,2073250,1920667,152583
2011-07-01,Maine,1079736,698174,643935,54239
2011-07-01,Maryland,4554788,3092882,2864451,228431
2011-07-01,Massachusetts,5296946,3478517,3227066,251451
2011-07-01,Michigan,7755325,4667917,4192853,475064
2011-07-01,Minnesota,4151463,2955400,2758359,197041
2011-07-01,Mississippi,2245527,1346784,1212959,133825
2011-07-01,Missouri,4649586,3031325,2767805,263520
2011-07-01,Montana,784578,500212,466749,33463
2011-07-01,Nebraska,1399924,1003040,958709,44331
2011-07-01,Nevada,2090907,1360553,1177623,182930
2011-07-01,Ohio,8997660,5771503,5251468,520035
2011-07-01,Oklahoma,2868176,1762735,1664718,98017
2011-07-01,Oregon,3068628,1994525,1801501,193024
2011-07-01,Pennsylvania,10121700,6374425,5874119,500306
2011-07-01,Tennessee,4974165,3118930,2832382,286548
2011-07-01,Texas,18978851,12534220,11487969,1046251
2011-07-01,Utah,1992633,1342776,1243911,98865
2011-07-01,Vermont,510702,357058,337145,19913
2011-07-01,Virginia,6245595,4203699,3925109,278590
2011-07-01,Washington,5312903,3434917,3141096,293821
2011-07-01,Wisconsin,4458463,3069100,2834342,234758
2011-07-01,Wyoming,436630,302182,283980,18202
2011-08-01,Alabama,3727077,2199378,1988543,210835
2011-08-01,Alaska,529932,365018,336857,28161
2011-08-01,Arizona,4934665,3047345,2759876,287469
2011-08-01,Arkansas,2256748,1357919,1249882,108037
2011-08-01,California,28992652,18428801,16234039,2194762
2011-08-01,Colorado,3933549,2735039,2498664,236375
2011-08-01,Connecticut,2831528,1913385,1742023,171362
2011-08-01,Delaware,712334,444138,410471,33667
2011-08-01,Florida,15233573,9261107,8341528,919579
2011-08-01,Georgia,7389941,4750409,4267651,482758
2011-08-01,Hawaii,1057360,660874,614669,46205
2011-08-01,Idaho,1180641,764301,702187,62114
2011-08-01,Illinois,9956696,6577947,5914841,663106
2011-08-01,Indiana,5006739,3197873,2906147,291726
2011-08-01,Iowa,2377594,1667469,1573169,94300
2011-08-01,Kansas,2163057,1497076,1402453,94623
2011-08-01,Kentucky,3374290,2059402,1865360,194042
2011-08-01,Louisiana,3482300,2076019,1923582,152437
2011-08-01,Maine,1080008,698915,645058,53857
2011-08-01,Maryland,4559232,3096098,2868279,227819
2011-08-01,Massachusetts,5301948,3483335,3233573,249762
2011-08-01,Michigan,7758849,4674626,4202912,471714
2011-08-01,Minnesota,4154458,2956624,2762729,193895
2011-08-01,Mississippi,2246385,1346413,1213238,133175
2011-08-01,Missouri,4651535,3031636,2771395,260241
2011-08-01,Montana,785191,501247,467977,33270
2011-08-01,Nebraska,1400978,1004575,960475,44100
2011-08-01,Nevada,2093893,1362462,1180132,182330
2011-08-01,Ohio,9000165,5767102,5252818,514284
2011-08-01,Oklahoma,2870614,1767198,1668501,98697
2011-08-01,Oregon,3071373,1995328,1802792,192536
2011-08-01,Pennsylvania,10125377,6385122,5881816,503306
2011-08-01,Tennessee,4978538,3116910,2833535,283375
2011-08-01,Texas,19010408,12546014,11519770,1026244
2011-08-01,Utah,1995505,1340068,1246666,93402
2011-08-01,Vermont,510779,356927,337389,19538
2011-08-01,Virginia,6252917,4211579,3932076,279503
2011-08-01,Washington,5319387,3434295,3143050,291245
2011-08-01,Wisconsin,4460535,3072085,2838003,234082
2011-08-01,Wyoming,437302,302814,284545,18269
2011-09-01,Alabama,3729221,2197051,1990625,206426
2011-09-01,Alaska,530484,365643,337487,28156
2011-09-01,Arizona,4942294,3047212,2763942,283270
2011-09-01,Arkansas,2258033,1361072,1253820,107252
2011-09-01,California,29024770,18453635,16277760,2175875
2011-09-01,Colorado,3939619,2741753,2505623,236130
2011-09-01,Connecticut,2833192,1915535,1746278,169257
2011-09-01,Delaware,713095,444928,411634,33294
2011-09-01,Florida,15255186,9265057,8363923,901134
2011-09-01,Georgia,7398785,4758203,4279885,478318
2011-09-01,Hawaii,1058144,660501,614430,46071
2011-09-01,Idaho,1181963,765783,704282,61501
2011-09-01,Illinois,9961151,6585180,5924042,661138
2011-09-01,Indiana,5009696,3201966,2910302,291664
2011-09-01,Iowa,2379045,1667811,1574205,93606
2011-09-01,Kansas,2164394,1498090,1403990,94100
2011-09-01,Kentucky,3375991,2059397,1867511,191886
2011-09-01,Louisiana,3484631,2079673,1927408,152265
2011-09-01,Maine,1080363,699670,646382,53288
2011-09-01,Maryland,4563796,3099892,2873749,226143
2011-09-01,Massachusetts,5307262,3488645,3241226,247419
2011-09-01,Michigan,7762898,4680596,4215213,465383
2011-09-01,Minnesota,4157759,2956803,2767696,189107
2011-09-01,Mississippi,2247302,1346047,1214189,131858
2011-09-01,Missouri,4653762,3031257,2775879,255378
2011-09-01,Montana,785840,502388,469513,32875
2011-09-01,Nebraska,1402092,1006289,962554,43735
2011-09-01,Nevada,2096935,1364043,1183282,180761
2011-09-01,Ohio,9003266,5760793,5256975,503818
2011-09-01,Oklahoma,2873141,1772359,1673387,98972
2011-09-01,Oregon,3074353,1995988,1805189,190799
2011-09-01,Pennsylvania,10129765,6395422,5892027,503395
2011-09-01,Tennessee,4983075,3114511,2835806,278705
2011-09-01,Texas,19042812,12559256,11556548,1002708
2011-09-01,Utah,1998526,1338091,1250211,87880
2011-09-01,Vermont,510881,356866,337751,19115
2011-09-01,Virginia,6259719,4219107,3940336,278771
2011-09-01,Washington,5325852,3434445,3146622,287823
2011-09-01,Wisconsin,4462951,3074803,2842921,231882
2011-09-01,Wyoming,438037,303525,285193,18332
2011-10-01,Alabama,3731395,2194108,1992980,201128
2011-10-01,Alaska,531239,365963,337901,28062
2011-10-01,Arizona,4949772,3047502,2769137,278365
2011-10-01,Arkansas,2259197,1363485,1257461,106024
2011-10-01,California,29057308,18470587,16320810,2149777
2011-10-01,Colorado,3945966,2747237,2511976,235261
2011-10-01,Connecticut,2834869,1917084,1750252,166832
2011-10-01,Delaware,713826,445636,412856,32780
2011-10-01,Florida,15276781,9276833,8387525,889308
2011-10-01,Georgia,7408384,4764049,4291750,472299
2011-10-01,Hawaii,1059477,659648,614041,45607
2011-10-01,Idaho,1183280,767335,706484,60851
2011-10-01,Illinois,9965604,6589604,5936827,652777
2011-10-01,Indiana,5012382,3204480,2915887,288593
2011-10-01,Iowa,2380345,1668085,1575631,92454
2011-10-01,Kansas,2165921,1498563,1405412,93151
2011-10-01,Kentucky,3377830,2058960,1870409,188551
2011-10-01,Louisiana,3486935,2083093,1931181,151912
2011-10-01,Maine,1080688,700205,647591,52614
2011-10-01,Maryland,4568504,3103611,2879948,223663
2011-10-01,Massachusetts,5312353,3493484,3248942,244542
2011-10-01,Michigan,7766568,4684885,4227863,457022
2011-10-01,Minnesota,4160868,2955882,2772119,183763
2011-10-01,Mississippi,2248307,1345330,1215492,129838
2011-10-01,Missouri,4656052,3029495,2780269,249226
2011-10-01,Montana,786491,503378,471088,32290
2011-10-01,Nebraska,1403237,1007812,964612,43200
2011-10-01,Nevada,2099973,1364991,1186737,178254
2011-10-01,Ohio,9005983,5753316,5263328,489988
2011-10-01,Oklahoma,2875894,1777478,1678931,98547
2011-10-01,Oregon,3077143,1996000,1807834,188166
2011-10-01,Pennsylvania,10133621,6403565,5903108,500457
2011-10-01,Tennessee,4987636,3111419,2838553,272866
2011-10-01,Texas,19075801,12570673,11594803,975870
2011-10-01,Utah,2001502,1336631,1254196,82435
2011-10-01,Vermont,510996,356776,338090,18686
2011-10-01,Virginia,6268025,4224836,3948490,276346
2011-10-01,Washington,5332729,3436373,3152344,284029
2011-10-01,Wisconsin,4465132,3076325,2847838,228487
2011-10-01,Wyoming,438779,304140,285821,18319
2011-11-01,Alabama,3733018,2190069,1994495,195574
2011-11-01,Alaska,531683,365959,338096,27863
2011-11-01,Arizona,4956614,3047623,2774329,273294
2011-11-01,Arkansas,2260105,1364537,1260075,104462
2011-11-01,California,29086234,18475806,16356584,2119222
2011-11-01,Colorado,3951498,2750166,2516276,233890
2011-11-01,Connecticut,2836156,1917061,1752728,164333
2011-11-01,Delaware,714415,446063,413853,32210
2011-11-01,Florida,15295953,9285382,8409108,876274
2011-11-01,Georgia,7416536,4767256,4301696,465560
2011-11-01,Hawaii,1060261,658261,613338,44923
2011-11-01,Idaho,1184380,768639,708451,60188
2011-11-01,Illinois,9968779,6590025,5950626,639399
2011-11-01,Indiana,5014631,3204528,2921443,283085
2011-11-01,Iowa,2381354,1667807,1576906,90901
2011-11-01,Kansas,2166958,1498063,1406203,91860
2011-11-01,Kentucky,3379079,2057306,1873049,184257
2011-11-01,Louisiana,3488699,2085470,1934241,151229
2011-11-01,Maine,1080869,700345,648450,51895
2011-11-01,Maryland,4572406,3106452,2885725,220727
2011-11-01,Massachusetts,5316976,3496743,3255358,241385
2011-11-01,Michigan,7769497,4686341,4238754,447587
2011-11-01,Minnesota,4163536,2953876,2775177,178699
2011-11-01,Mississippi,2248891,1343817,1216515,127302
2011-11-01,Missouri,4657686,3025832,2783434,242398
2011-11-01,Montana,787015,503969,472384,31585
2011-11-01,Nebraska,1404152,1008729,966232,42497
2011-11-01,Nevada,2102736,1365040,1190017,175023
2011-11-01,Ohio,9007712,5745836,5270678,475158
2011-11-01,Oklahoma,2877986,1781679,1684282,97397
2011-11-01,Oregon,3079645,1994860,1809617,185243
2011-11-01,Pennsylvania,10136404,6408612,5913540,495072
2011-11-01,Tennessee,4991472,3107219,2840913,266306
2011-11-01,Texas,19105904,12576962,11630243,946719
2011-11-01,Utah,2004296,1335333,1258132,77201
2011-11-01,Vermont,511024,356508,338251,18257
2011-11-01,Virginia,6274099,4227390,3954876,272514
2011-11-01,Washington,5338490,3440275,3159925,280350
2011-11-01,Wisconsin,4466891,3075869,2851587,224282
2011-11-01,Wyoming,439418,304504,286325,18179
2011-12-01,Alabama,3734683,2185010,1994618,190392
2011-12-01,Alaska,532076,365671,338095,27576
2011-12-01,Arizona,4963381,3047727,2778825,268902
2011-12-01,Arkansas,2261056,1364056,1261291,102765
2011-12-01,California,29114664,18469241,16381644,2087597
2011-12-01,Colorado,3956931,2749769,2517876,231893
2011-12-01,Connecticut,2837493,1915340,1753314,162026
2011-12-01,Delaware,715053,446201,414510,31691
2011-12-01,Florida,15315092,9289835,8426736,863099
2011-12-01,Georgia,7424650,4767599,4308707,458892
2011-12-01,Hawaii,1060869,656523,612414,44109
2011-12-01,Idaho,1185520,769548,709965,59583
2011-12-01,Illinois,9972047,6586549,5962923,623626
2011-12-01,Indiana,5016897,3201486,2925295,276191
2011-12-01,Iowa,2382411,1666736,1577591,89145
2011-12-01,Kansas,2167913,1496515,1406144,90371
2011-12-01,Kentucky,3380258,2054336,1874902,179434
2011-12-01,Louisiana,3490514,2086631,1936543,150088
2011-12-01,Maine,1081085,700108,648912,51196
2011-12-01,Maryland,4576360,3107880,2890142,217738
2011-12-01,Massachusetts,5321573,3497899,3259580,238319
2011-12-01,Michigan,7772459,4684886,4246482,438404
2011-12-01,Minnesota,4166245,2950830,2776403,174427
2011-12-01,Mississippi,2249476,1341351,1216791,124560
2011-12-01,Missouri,4659337,3020372,2784865,235507
2011-12-01,Montana,787517,504138,473258,30880
2011-12-01,Nebraska,1405024,1008982,967276,41706
2011-12-01,Nevada,2105492,1364376,1192847,171529
2011-12-01,Ohio,9009541,5739218,5277947,461271
2011-12-01,Oklahoma,2880077,1784491,1688775,95716
2011-12-01,Oregon,3082145,1992429,1809926,182503
2011-12-01,Pennsylvania,10139206,6411019,5922406,488613
2011-12-01,Tennessee,4995309,3101996,2842262,259734
2011-12-01,Texas,19135673,12576704,11659891,916813
2011-12-01,Utah,2007032,1333971,1261754,72217
2011-12-01,Vermont,511064,356006,338170,17836
2011-12-01,Virginia,6280095,4226121,3958263,267858
2011-12-01,Washington,5344052,3445721,3168491,277230
2011-12-01,Wisconsin,4468666,3073596,2853852,219744
2011-12-01,Wyoming,440037,304580,286683,17897
2012-01-01,Alabama,3736437,2179750,1993523,186227
2012-01-01,Alaska,532472,365200,337946,27254
2012-01-01,Arizona,4970220,3048161,2782738,265423
2012-01-01,Arkansas,2262001,1362428,1261262,101166
2012-01-01,California,29143906,18456650,16397835,2058815
2012-01-01,Colorado,3962382,2747283,2517729,229554
2012-01-01,Connecticut,2838829,1912351,1752189,160162
2012-01-01,Delaware,715709,446183,414872,31311
2012-01-01,Florida,15334438,9292160,8441097,851063
2012-01-01,Georgia,7433130,4765809,4312847,452962
2012-01-01,Hawaii,1061464,654711,611452,43259
2012-01-01,Idaho,1186669,770197,711077,59120
2012-01-01,Illinois,9975600,6580816,5972028,608788
2012-01-01,Indiana,5019202,3195782,2926439,269343
2012-01-01,Iowa,2383466,1665187,1577773,87414
2012-01-01,Kansas,2168823,1494362,1405492,88870
2012-01-01,Kentucky,3381405,2050998,1876189,174809
2012-01-01,Louisiana,3492387,2087233,1938549,148684
2012-01-01,Maine,1081268,699764,649142,50622
2012-01-01,Maryland,4580372,3108021,2892744,215277
2012-01-01,Massachusetts,5326196,3498166,3262377,235789
2012-01-01,Michigan,7775523,4681300,4250546,430754
2012-01-01,Minnesota,4168954,2947490,2776132,171358
2012-01-01,Mississippi,2250158,1338147,1216211,121936
2012-01-01,Missouri,4661081,3013958,2784819,229139
2012-01-01,Montana,788035,504102,473787,30315
2012-01-01,Nebraska,1405885,1008839,967953,40886
2012-01-01,Nevada,2108162,1363603,1195245,168358
2012-01-01,Ohio,9011434,5734275,5284949,449326
2012-01-01,Oklahoma,2882186,1786242,1692448,93794
2012-01-01,Oregon,3084630,1988854,1808723,180131
2012-01-01,Pennsylvania,10142177,6412680,5929453,483227
2012-01-01,Tennessee,4999080,3097157,2843050,254107
2012-01-01,Texas,19165965,12571937,11683759,888178
2012-01-01,Utah,2009736,1335279,1265082,70197
2012-01-01,Vermont,511126,355362,337888,17474
2012-01-01,Virginia,6285701,4222321,3959095,263226
2012-01-01,Washington,5349660,3452355,3177413,274942
2012-01-01,Wisconsin,4470446,3070628,2854971,215657
2012-01-01,Wyoming,440634,304445,286913,17532
2012-02-01,Alabama,3737775,2175635,1992089,183546
2012-02-01,Alaska,533089,364748,337774,26974
2012-02-01,Arizona,4976397,3048882,2786310,262572
2012-02-01,Arkansas,2262688,1360339,1260404,99935
2012-02-01,California,29169798,18447162,16411184,2035978
2012-02-01,Colorado,3967744,2744941,2517116,227825
2012-02-01,Connecticut,2839834,1908624,1749642,158982
2012-02-01,Delaware,716266,446164,415034,31130
2012-02-01,Florida,15351863,9296328,8454837,841491
2012-02-01,Georgia,7441106,4764273,4315884,448389
2012-02-01,Hawaii,1062469,653076,610580,42496
2012-02-01,Idaho,1187686,770719,711923,58796
2012-02-01,Illinois,9977857,6576290,5978214,598076
2012-02-01,Indiana,5020887,3188573,2924640,263933
2012-02-01,Iowa,2384208,1663580,1577533,86047
2012-02-01,Kansas,2169771,1492333,1404669,87664
2012-02-01,Kentucky,3382463,2048659,1877591,171068
2012-02-01,Louisiana,3494007,2088242,1940786,147456
2012-02-01,Maine,1081314,699615,649301,50314
2012-02-01,Maryland,4584142,3108088,2894197,213891
2012-02-01,Massachusetts,5330155,3498974,3264746,234228
2012-02-01,Michigan,7777560,4677505,4251976,425529
2012-02-01,Minnesota,4171190,2944994,2775710,169284
2012-02-01,Mississippi,2250749,1334895,1215042,119853
2012-02-01,Missouri,4662219,3008235,2784077,224158
2012-02-01,Montana,788463,504157,474178,29979
2012-02-01,Nebraska,1406707,1008717,968546,40171
2012-02-01,Nevada,2110764,1363319,1197373,165946
2012-02-01,Ohio,9012201,5731180,5291278,439902
2012-02-01,Oklahoma,2884156,1787662,1695613,92049
2012-02-01,Oregon,3086730,1984596,1806253,178343
2012-02-01,Pennsylvania,10143682,6416137,5935248,480889
2012-02-01,Tennessee,5002582,3094096,2843731,250365
2012-02-01,Texas,19194543,12581835,11704383,877452
2012-02-01,Utah,2012392,1331198,1268263,62935
2012-02-01,Vermont,511107,354783,337552,17231
2012-02-01,Virginia,6292490,4218049,3958507,259542
2012-02-01,Washington,5355254,3459848,3185999,273849
2012-02-01,Wisconsin,4471727,3068522,2855567,212955
2012-02-01,Wyoming,441268,304220,287031,17189
2012-03-01,Alabama,3739321,2173644,1991104,182540
2012-03-01,Alaska,533381,364426,337625,26801
2012-03-01,Arizona,4982803,3050044,2789251,260793
2012-03-01,Arkansas,2263565,1358109,1258810,99299
2012-03-01,California,29195443,18445792,16424830,2020962
2012-03-01,Colorado,3972960,2743601,2516649,226952
2012-03-01,Connecticut,2841002,1904314,1745620,158694
2012-03-01,Delaware,716829,446185,414992,31193
2012-03-01,Florida,15369634,9303773,8468399,835374
2012-03-01,Georgia,7449017,4764404,4318945,445459
2012-03-01,Hawaii,1062816,651755,609893,41862
2012-03-01,Idaho,1188795,771103,712536,58567
2012-03-01,Illinois,9980816,6574536,5981261,593275
2012-03-01,Indiana,5023170,3180618,2919810,260808
2012-03-01,Iowa,2385211,1662015,1576690,85325
2012-03-01,Kansas,2170593,1490738,1403751,86987
2012-03-01,Kentucky,3383526,2048252,1879434,168818
2012-03-01,Louisiana,3495696,2089768,1943114,146654
2012-03-01,Maine,1081497,699718,649374,50344
2012-03-01,Maryland,4587822,3108973,2895102,213871
2012-03-01,Massachusetts,5334673,3500416,3266409,234007
2012-03-01,Michigan,7780449,4674978,4251685,423293
2012-03-01,Minnesota,4173907,2943537,2775538,167999
2012-03-01,Mississippi,2251220,1332365,1213667,118698
2012-03-01,Missouri,4663809,3004112,2783008,221104
2012-03-01,Montana,788963,504449,474559,29890
2012-03-01,Nebraska,1407566,1008820,969077,39743
2012-03-01,Nevada,2113359,1363757,1199248,164509
2012-03-01,Ohio,9013965,5727867,5294585,433282
2012-03-01,Oklahoma,2886108,1789039,1698086,90953
2012-03-01,Oregon,3089178,1980071,1802745,177326
2012-03-01,Pennsylvania,10146344,6422861,5939931,482930
2012-03-01,Tennessee,5006319,3092834,2843922,248912
2012-03-01,Texas,19222731,12563758,11722322,841436
2012-03-01,Utah,2015192,1335297,1271263,64034
2012-03-01,Vermont,511158,354381,337236,17145
2012-03-01,Virginia,6297993,4214269,3956965,257304
2012-03-01,Washington,5360596,3466956,3192664,274292
2012-03-01,Wisconsin,4473499,3067746,2855416,212330
2012-03-01,Wyoming,441895,303990,287027,16963
2012-04-01,Alabama,3740838,2173494,1991037,182457
2012-04-01,Alaska,533893,364174,337455,26719
2012-04-01,Arizona,4989316,3051345,2791656,259689
2012-04-01,Arkansas,2264414,1355831,1256764,99067
2012-04-01,California,29222479,18449665,16440520,2009145
2012-04-01,Colorado,3978413,2743294,2516847,226447
2012-04-01,Connecticut,2842175,1899200,1740242,158958
2012-04-01,Delaware,717434,446181,414769,31412
2012-04-01,Florida,15387537,9312582,8481558,831024
2012-04-01,Georgia,7457330,4765619,4322617,443002
2012-04-01,Hawaii,1063591,650783,609546,41237
2012-04-01,Idaho,1189917,771346,713010,58336
2012-04-01,Illinois,9983758,6574291,5981264,593027
2012-04-01,Indiana,5025264,3172844,2913076,259768
2012-04-01,Iowa,2386148,1660230,1575227,85003
2012-04-01,Kansas,2171582,1489485,1402934,86551
2012-04-01,Kentucky,3384772,2049721,1881638,168083
2012-04-01,Louisiana,3497367,2090997,1945016,145981
2012-04-01,Maine,1081643,699864,649294,50570
2012-04-01,Maryland,4591610,3110612,2895918,214694
2012-04-01,Massachusetts,5339050,3501752,3267063,234689
2012-04-01,Michigan,7783072,4673683,4250642,423041
2012-04-01,Minnesota,4176493,2942677,2775106,167571
2012-04-01,Mississippi,2251754,1330658,1212323,118335
2012-04-01,Missouri,4665382,3001221,2782139,219082
2012-04-01,Montana,789449,504942,474995,29947
2012-04-01,Nebraska,1408411,1009179,969646,39533
2012-04-01,Nevada,2116001,1364616,1200986,163630
2012-04-01,Ohio,9015464,5721910,5293517,428393
2012-04-01,Oklahoma,2888262,1790363,1699795,90568
2012-04-01,Oregon,3091529,1975219,1798555,176664
2012-04-01,Pennsylvania,10148660,6431482,5943284,488198
2012-04-01,Tennessee,5010012,3092229,2843514,248715
2012-04-01,Texas,19251790,12588954,11737849,851105
2012-04-01,Utah,2017934,1338994,1274152,64842
2012-04-01,Vermont,511169,354130,336947,17183
2012-04-01,Virginia,6304108,4210876,3954894,255982
2012-04-01,Washington,5366242,3472271,3196410,275861
2012-04-01,Wisconsin,4475073,3067471,2854173,213298
2012-04-01,Wyoming,442538,303802,286933,16869
2012-05-01,Alabama,3742396,2174754,1992484,182270
2012-05-01,Alaska,534483,364032,337365,26667
2012-05-01,Arizona,4995794,3052719,2794227,258492
2012-05-01,Arkansas,2265279,1353594,1254657,98937
2012-05-01,California,29249074,18457489,16462781,1994708
2012-05-01,Colorado,3984038,2744233,2518570,225663
2012-05-01,Connecticut,2843391,1893644,1734363,159281
2012-05-01,Delaware,717996,446177,414524,31653
2012-05-01,Florida,15405602,9322199,8496177,826022
2012-05-01,Georgia,7465750,4767757,4327976,439781
2012-05-01,Hawaii,1064477,650165,609679,40486
2012-05-01,Idaho,1191067,771563,713524,58039
2012-05-01,Illinois,9986723,6576078,5981247,594831
2012-05-01,Indiana,5027375,3166824,2906905,259919
2012-05-01,Iowa,2387179,1658427,1573642,84785
2012-05-01,Kansas,2172714,1488736,1402661,86075
2012-05-01,Kentucky,3386098,2052837,1884530,168307
2012-05-01,Louisiana,3499054,2091414,1946434,144980
2012-05-01,Maine,1081842,700078,649263,50815
2012-05-01,Maryland,4595395,3113280,2897677,215603
2012-05-01,Massachusetts,5343485,3503312,3267718,235594
2012-05-01,Michigan,7785658,4674360,4250834,423526
2012-05-01,Minnesota,4179146,2942728,2775088,167640
2012-05-01,Mississippi,2252365,1329787,1211394,118393
2012-05-01,Missouri,4667067,2999746,2782417,217329
2012-05-01,Montana,789993,505634,475624,30010
2012-05-01,Nebraska,1409361,1009977,970546,39431
2012-05-01,Nevada,2118612,1365728,1202977,162751
2012-05-01,Ohio,9016980,5714684,5290887,423797
2012-05-01,Oklahoma,2890509,1791951,1701275,90676
2012-05-01,Oregon,3093887,1970481,1794592,175889
2012-05-01,Pennsylvania,10151079,6440986,5946445,494541
2012-05-01,Tennessee,5013814,3092082,2843398,248684
2012-05-01,Texas,19280899,12611625,11754758,856867
2012-05-01,Utah,2020773,1342475,1277306,65169
2012-05-01,Vermont,511223,354020,336755,17265
2012-05-01,Virginia,6310753,4208645,3953818,254827
2012-05-01,Washington,5372135,3475950,3198232,277718
2012-05-01,Wisconsin,4476792,3067402,2852787,214615
2012-05-01,Wyoming,443188,303711,286848,16863
2012-06-01,Alabama,3744108,2176818,1995546,181272
2012-06-01,Alaska,535035,363960,337406,26554
2012-06-01,Arizona,5002599,3054066,2797416,256650
2012-06-01,Arkansas,2266248,1351226,1252563,98663
2012-06-01,California,29277450,18468110,16494261,1973849
2012-06-01,Colorado,3989781,2746042,2521989,224053
2012-06-01,Connecticut,2844747,1887999,1728720,159279
2012-06-01,Delaware,718652,446176,414378,31798
2012-06-01,Florida,15424547,9332286,8513758,818528
2012-06-01,Georgia,7474404,4770468,4335207,435261
2012-06-01,Hawaii,1065305,649786,610269,39517
2012-06-01,Idaho,1192291,771845,714218,57627
2012-06-01,Illinois,9990366,6579685,5983696,595989
2012-06-01,Indiana,5029844,3163404,2903332,260072
2012-06-01,Iowa,2388331,1657167,1572697,84470
2012-06-01,Kansas,2173881,1488524,1403130,85394
2012-06-01,Kentucky,3387548,2057041,1888219,168822
2012-06-01,Louisiana,3500949,2090759,1947689,143070
2012-06-01,Maine,1082090,700348,649429,50919
2012-06-01,Maryland,4599386,3116975,2900940,216035
2012-06-01,Massachusetts,5348291,3505430,3269278,236152
2012-06-01,Michigan,7788775,4676951,4253239,423712
2012-06-01,Minnesota,4182116,2944302,2776517,167785
2012-06-01,Mississippi,2253035,1329476,1211194,118282
2012-06-01,Missouri,4668979,2999577,2784194,215383
2012-06-01,Montana,790548,506446,476486,29960
2012-06-01,Nebraska,1410340,1011216,971883,39333
2012-06-01,Nevada,2121395,1366798,1205447,161351
2012-06-01,Ohio,9019108,5708474,5289595,418879
2012-06-01,Oklahoma,2892866,1793879,1702959,90920
2012-06-01,Oregon,3096538,1966171,1791433,174738
2012-06-01,Pennsylvania,10154135,6450474,5950829,499645
2012-06-01,Tennessee,5017869,3092371,2844370,248001
2012-06-01,Texas,19311048,12632078,11776105,855973
2012-06-01,Utah,2023694,1345980,1280955,65025
2012-06-01,Vermont,511282,353999,336688,17311
2012-06-01,Virginia,6317350,4208558,3955368,253190
2012-06-01,Washington,5378257,3478835,3199945,278890
2012-06-01,Wisconsin,4478791,3067586,2852421,215165
2012-06-01,Wyoming,443886,303733,286852,16881
2012-07-01,Alabama,3745940,2178985,1999860,179125
2012-07-01,Alaska,535584,363887,337576,26311
2012-07-01,Arizona,5009540,3055366,2801303,254063
2012-07-01,Arkansas,2267294,1348643,1250599,98044
2012-07-01,California,29305807,18479876,16534689,1945187
2012-07-01,Colorado,3995677,2748077,2526809,221268
2012-07-01,Connecticut,2846179,1882615,1723907,158708
2012-07-01,Delaware,719282,446132,414347,31785
2012-07-01,Florida,15443876,9342026,8534305,807721
2012-07-01,Georgia,7482739,4773009,4343500,429509
2012-07-01,Hawaii,1066084,649583,611262,38321
2012-07-01,Idaho,1193509,772210,715144,57066
2012-07-01,Illinois,9993695,6583994,5989315,594679
2012-07-01,Indiana,5032436,3162320,2902854,259466
2012-07-01,Iowa,2389557,1656736,1572880,83856
2012-07-01,Kansas,2175109,1488847,1404335,84512
2012-07-01,Kentucky,3389137,2061588,1892555,169033
2012-07-01,Louisiana,3502948,2089201,1949077,140124
2012-07-01,Maine,1082354,700592,649809,50783
2012-07-01,Maryland,4603555,3121317,2905634,215683
2012-07-01,Massachusetts,5353276,3507770,3271778,235992
2012-07-01,Michigan,7792111,4680759,4257873,422886
2012-07-01,Minnesota,4185165,2947024,2779521,167503
2012-07-01,Mississippi,2253714,1329451,1211838,117613
2012-07-01,Missouri,4670914,3000439,2787304,213135
2012-07-01,Montana,791138,507185,477470,29715
2012-07-01,Nebraska,1411388,1012787,973628,39159
2012-07-01,Nevada,2124233,1367483,1208382,159101
2012-07-01,Ohio,9021458,5703982,5290271,413711
2012-07-01,Oklahoma,2895161,1795981,1705012,90969
2012-07-01,Oregon,3099215,1962128,1789026,173102
2012-07-01,Pennsylvania,10157546,6458986,5957166,501820
2012-07-01,Tennessee,5022071,3093294,2847096,246198
2012-07-01,Texas,19341277,12649825,11802014,847811
2012-07-01,Utah,2026680,1349636,1285107,64529
2012-07-01,Vermont,511355,353993,336722,17271
2012-07-01,Virginia,6324085,4210712,3960179,250533
2012-07-01,Washington,5384419,3475293,3203044,272249
2012-07-01,Wisconsin,4480877,3068026,2853712,214314
2012-07-01,Wyoming,444553,303794,286966,16828
2012-08-01,Alabama,3748082,2180942,2004716,176226
2012-08-01,Alaska,535878,363879,337853,26026
2012-08-01,Arizona,5016602,3056822,2805561,251261
2012-08-01,Arkansas,2268387,1346157,1248907,97250
2012-08-01,California,29335993,18494681,16581684,1912997
2012-08-01,Colorado,4001980,2750560,2532901,217659
2012-08-01,Connecticut,2847427,1878205,1720408,157797
2012-08-01,Delaware,720044,446071,414386,31685
2012-08-01,Florida,15465332,9352027,8556664,795363
2012-08-01,Georgia,7489471,4775669,4351928,423741
2012-08-01,Hawaii,1066807,649534,612513,37021
2012-08-01,Idaho,1194918,772638,716202,56436
2012-08-01,Illinois,9997508,6588983,5997041,591942
2012-08-01,Indiana,5035833,3163313,2904676,258637
2012-08-01,Iowa,2391195,1657235,1574109,83126
2012-08-01,Kansas,2176025,1489743,1405991,83752
2012-08-01,Kentucky,3391439,2065968,1897095,168873
2012-08-01,Louisiana,3505274,2087894,1950819,137075
2012-08-01,Maine,1082712,700906,650411,50495
2012-08-01,Maryland,4607139,3126121,2911289,214832
2012-08-01,Massachusetts,5358546,3510235,3274743,235492
2012-08-01,Michigan,7796014,4685915,4264274,421641
2012-08-01,Minnesota,4188566,2950631,2783832,166799
2012-08-01,Mississippi,2254835,1329468,1212890,116578
2012-08-01,Missouri,4673088,3002370,2791175,211195
2012-08-01,Montana,791933,507764,478438,29326
2012-08-01,Nebraska,1412373,1014558,975571,38987
2012-08-01,Nevada,2127048,1367955,1211574,156381
2012-08-01,Ohio,9025886,5701818,5292044,409774
2012-08-01,Oklahoma,2897653,1798319,1707423,90896
2012-08-01,Oregon,3101836,1958250,1786947,171303
2012-08-01,Pennsylvania,10160869,6466612,5964896,501716
2012-08-01,Tennessee,5026242,3095301,2851322,243979
2012-08-01,Texas,19372177,12666216,11830108,836108
2012-08-01,Utah,2030026,1353555,1289584,63971
2012-08-01,Vermont,511540,353956,336820,17136
2012-08-01,Virginia,6329538,4215085,3967765,247320
2012-08-01,Washington,5389609,3472450,3207615,264835
2012-08-01,Wisconsin,4483459,3068963,2856403,212560
2012-08-01,Wyoming,444980,303836,287159,16677
2012-09-01,Alabama,3750371,2182771,2009352,173419
2012-09-01,Alaska,536044,364057,338216,25841
2012-09-01,Arizona,5023844,3058702,2809750,248952
2012-09-01,Arkansas,2269551,1344172,1247567,96605
2012-09-01,California,29367307,18515366,16631825,1883541
2012-09-01,Colorado,4008367,2753956,2539967,213989
2012-09-01,Connecticut,2848760,1875209,1718236,156973
2012-09-01,Delaware,720904,446070,414465,31605
2012-09-01,Florida,15487278,9363037,8578931,784106
2012-09-01,Georgia,7496368,4778749,4359383,419366
2012-09-01,Hawaii,1067398,649620,613823,35797
2012-09-01,Idaho,1196379,773091,717238,55853
2012-09-01,Illinois,10001763,6594683,6003932,590751
2012-09-01,Indiana,5039417,3166249,2907739,258510
2012-09-01,Iowa,2393002,1658681,1576085,82596
2012-09-01,Kansas,2176962,1491050,1407653,83397
2012-09-01,Kentucky,3393813,2069786,1901222,168564
2012-09-01,Louisiana,3507678,2088122,1953077,135045
2012-09-01,Maine,1083081,701441,651204,50237
2012-09-01,Maryland,4610857,3131152,2917104,214048
2012-09-01,Massachusetts,5364133,3512915,3277612,235303
2012-09-01,Michigan,7800273,4692724,4271479,421245
2012-09-01,Minnesota,4192145,2955118,2789269,165849
2012-09-01,Mississippi,2255957,1329339,1213704,115635
2012-09-01,Missouri,4675357,3005264,2795016,210248
2012-09-01,Montana,792794,508244,479327,28917
2012-09-01,Nebraska,1413365,1016381,977411,38970
2012-09-01,Nevada,2129876,1368573,1214739,153834
2012-09-01,Ohio,9030686,5702365,5293329,409036
2012-09-01,Oklahoma,2900237,1800762,1709795,90967
2012-09-01,Oregon,3104634,1954589,1784773,169816
2012-09-01,Pennsylvania,10164609,6473455,5972618,500837
2012-09-01,Tennessee,5030564,3098402,2855937,242465
2012-09-01,Texas,19403718,12683588,11857386,826202
2012-09-01,Utah,2033498,1357700,1294133,63567
2012-09-01,Vermont,511749,353835,336908,16927
2012-09-01,Virginia,6334899,4221076,3976567,244509
2012-09-01,Washington,5394909,3470187,3212569,257618
2012-09-01,Wisconsin,4486283,3070787,2859838,210949
2012-09-01,Wyoming,445436,303842,287381,16461
2012-10-01,Alabama,3752500,2184006,2012918,171088
2012-10-01,Alaska,536291,364283,338526,25757
2012-10-01,Arizona,5030865,3060209,2812844,247365
2012-10-01,Arkansas,2270630,1342472,1246289,96183
2012-10-01,California,29397331,18536565,16678616,1857949
2012-10-01,Colorado,4014667,2757466,2546891,210575
2012-10-01,Connecticut,2849989,1873204,1716902,156302
2012-10-01,Delaware,721681,446007,414443,31564
2012-10-01,Florida,15508601,9372631,8597972,774659
2012-10-01,Georgia,7503210,4780398,4364003,416395
2012-10-01,Hawaii,1068094,649565,614838,34727
2012-10-01,Idaho,1197771,773385,718040,55345
2012-10-01,Illinois,10005658,6598498,6006076,592422
2012-10-01,Indiana,5042788,3169729,2910539,259190
2012-10-01,Iowa,2394680,1660482,1578228,82254
2012-10-01,Kansas,2177847,1492122,1408760,83362
2012-10-01,Kentucky,3396151,2072317,1904250,168067
2012-10-01,Louisiana,3510000,2089992,1955491,134501
2012-10-01,Maine,1083447,702058,652017,50041
2012-10-01,Maryland,4614496,3135207,2921744,213463
2012-10-01,Massachusetts,5369430,3514788,3279317,235471
2012-10-01,Michigan,7804152,4699999,4278209,421790
2012-10-01,Minnesota,4195557,2959485,2795149,164336
2012-10-01,Mississippi,2257102,1328815,1213839,114976
2012-10-01,Missouri,4677466,3007710,2797738,209972
2012-10-01,Montana,793568,508604,480064,28540
2012-10-01,Nebraska,1414318,1017762,978737,39025
2012-10-01,Nevada,2132662,1369063,1217434,151629
2012-10-01,Ohio,9035065,5703549,5291979,411570
2012-10-01,Oklahoma,2902708,1802490,1711251,91239
2012-10-01,Oregon,3107259,1950570,1782030,168540
2012-10-01,Pennsylvania,10167893,6477053,5977594,499459
2012-10-01,Tennessee,5034781,3101365,2859257,242108
2012-10-01,Texas,19434632,12700534,11879763,820771
2012-10-01,Utah,2036856,1361555,1298314,63241
2012-10-01,Vermont,511935,353543,336872,16671
2012-10-01,Virginia,6340613,4226595,3984368,242227
2012-10-01,Washington,5400070,3467617,3216647,250970
2012-10-01,Wisconsin,4488898,3072854,2862941,209913
2012-10-01,Wyoming,445861,303715,287540,16175
2012-11-01,Alabama,3754422,2184400,2015057,169343
2012-11-01,Alaska,536679,364384,338657,25727
2012-11-01,Arizona,5037642,3060910,2814217,246693
2012-11-01,Arkansas,2271525,1340897,1244873,96024
2012-11-01,California,29427545,18553309,16717341,1835968
2012-11-01,Colorado,4020894,2760368,2552987,207381
2012-11-01,Connecticut,2851060,1871522,1715773,155749
2012-11-01,Delaware,722434,445776,414226,31550
2012-11-01,Florida,15529025,9379264,8612023,767241
2012-11-01,Georgia,7510285,4779443,4365109,414334
2012-11-01,Hawaii,1069163,649173,615327,33846
2012-11-01,Idaho,1199143,773460,718524,54936
2012-11-01,Illinois,10009289,6598094,6001684,596410
2012-11-01,Indiana,5045719,3172886,2912626,260260
2012-11-01,Iowa,2396074,1661913,1579766,82147
2012-11-01,Kansas,2178728,1492672,1409248,83424
2012-11-01,Kentucky,3398358,2073384,1905934,167450
2012-11-01,Louisiana,3512113,2092996,1957453,135543
2012-11-01,Maine,1083716,702606,652681,49925
2012-11-01,Maryland,4617887,3137652,2924538,213114
2012-11-01,Massachusetts,5374322,3515318,3279422,235896
2012-11-01,Michigan,7807358,4706523,4283628,422895
2012-11-01,Minnesota,4198575,2962759,2800283,162476
2012-11-01,Mississippi,2258163,1327884,1213261,114623
2012-11-01,Missouri,4679343,3008994,2799168,209826
2012-11-01,Montana,794361,508875,480628,28247
2012-11-01,Nebraska,1415169,1018499,979433,39066
2012-11-01,Nevada,2135395,1369310,1219490,149820
2012-11-01,Ohio,9038657,5703304,5287084,416220
2012-11-01,Oklahoma,2905208,1802927,1711235,91692
2012-11-01,Oregon,3109580,1945807,1778641,167166
2012-11-01,Pennsylvania,10170070,6475700,5977993,497707
2012-11-01,Tennessee,5038650,3103321,2860286,243035
2012-11-01,Texas,19465766,12716045,11895325,820720
2012-11-01,Utah,2040092,1364818,1301946,62872
2012-11-01,Vermont,512079,353111,336683,16428
2012-11-01,Virginia,6346515,4230245,3989727,240518
2012-11-01,Washington,5405191,3464221,3219140,245081
2012-11-01,Wisconsin,4491084,3074792,2864732,210060
2012-11-01,Wyoming,446255,303456,287578,15878
2012-12-01,Alabama,3756121,2183700,2015725,167975
2012-12-01,Alaska,537018,364287,338581,25706
2012-12-01,Arizona,5044028,3060362,2813704,246658
2012-12-01,Arkansas,2272297,1339452,1243386,96066
2012-12-01,California,29455494,18562700,16747321,1815379
2012-12-01,Colorado,4026842,2762211,2558031,204180
2012-12-01,Connecticut,2851914,1869431,1714212,155219
2012-12-01,Delaware,723135,445343,413820,31523
2012-12-01,Florida,15548277,9382701,8621568,761133
2012-12-01,Georgia,7516903,4776076,4363590,412486
2012-12-01,Hawaii,1070064,648487,615337,33150
2012-12-01,Idaho,1200386,773323,718703,54620
2012-12-01,Illinois,10012126,6592899,5991770,601129
2012-12-01,Indiana,5048319,3175152,2914128,261024
2012-12-01,Iowa,2397326,1662647,1580457,82190
2012-12-01,Kansas,2179407,1492648,1409265,83383
2012-12-01,Kentucky,3400281,2072953,1906182,166771
2012-12-01,Louisiana,3514047,2096245,1958519,137726
2012-12-01,Maine,1083895,703024,653171,49853
2012-12-01,Maryland,4621036,3138497,2925667,212830
2012-12-01,Massachusetts,5378843,3514801,3278423,236378
2012-12-01,Michigan,7810081,4711644,4287975,423669
2012-12-01,Minnesota,4201294,2964526,2803934,160592
2012-12-01,Mississippi,2259083,1326506,1212063,114443
2012-12-01,Missouri,4680944,3009177,2799741,209436
2012-12-01,Montana,795056,509103,481061,28042
2012-12-01,Nebraska,1415931,1018587,979573,39014
2012-12-01,Nevada,2137941,1369233,1220968,148265
2012-12-01,Ohio,9041658,5701489,5279998,421491
2012-12-01,Oklahoma,2907466,1802218,1709988,92230
2012-12-01,Oregon,3111712,1940426,1775016,165410
2012-12-01,Pennsylvania,10171681,6469454,5974427,495027
2012-12-01,Tennessee,5042229,3103871,2859008,244863
2012-12-01,Texas,19495239,12730458,11905455,825003
2012-12-01,Utah,2043202,1367434,1305067,62367
2012-12-01,Vermont,512177,352575,336348,16227
2012-12-01,Virginia,6351838,4231663,3992299,239364
2012-12-01,Washington,5409915,3459702,3219911,239791
2012-12-01,Wisconsin,4493010,3076106,2864807,211299
2012-12-01,Wyoming,446641,303094,287479,15615
2013-01-01,Alabama,3757648,2181651,2015043,166608
2013-01-01,Alaska,537343,364023,338344,25679
2013-01-01,Arizona,5050211,3058620,2811785,246835
2013-01-01,Arkansas,2272945,1338053,1241811,96242
2013-01-01,California,29482749,18564212,16769858,1794354
2013-01-01,Colorado,4032567,2762675,2561687,200988
2013-01-01,Connecticut,2852640,1866718,1712022,154696
2013-01-01,Delaware,723860,444691,413236,31455
2013-01-01,Florida,15566837,9383321,8628007,755314
2013-01-01,Georgia,7523422,4771071,4360605,410466
2013-01-01,Hawaii,1070910,647730,615167,32563
2013-01-01,Idaho,1201563,773064,718684,54380
2013-01-01,Illinois,10014774,6584280,5978819,605461
2013-01-01,Indiana,5050615,3176337,2915330,261007
2013-01-01,Iowa,2398438,1662643,1580382,82261
2013-01-01,Kansas,2179995,1492010,1408859,83151
2013-01-01,Kentucky,3402047,2071047,1904810,166237
2013-01-01,Louisiana,3515759,2098900,1958670,140230
2013-01-01,Maine,1084015,703233,653477,49756
2013-01-01,Maryland,4623925,3138015,2925435,212580
2013-01-01,Massachusetts,5383100,3513585,3276681,236904
2013-01-01,Michigan,7812340,4715747,4292124,423623
2013-01-01,Minnesota,4203761,2964871,2806119,158752
2013-01-01,Mississippi,2259916,1316549,1202216,114333
2013-01-01,Missouri,4682302,3008594,2799781,208813
2013-01-01,Montana,795706,509349,481423,27926
2013-01-01,Nebraska,1416648,1018110,979223,38887
2013-01-01,Nevada,2140368,1368931,1222071,146860
2013-01-01,Ohio,9044122,5699301,5272736,426565
2013-01-01,Oklahoma,2909622,1800908,1708092,92816
2013-01-01,Oregon,3113662,1934879,1771649,163230
2013-01-01,Pennsylvania,10172653,6459448,5968637,490811
2013-01-01,Tennessee,5045479,3102423,2855543,246880
2013-01-01,Texas,19524317,12743658,11912520,831138
2013-01-01,Utah,2046163,1369579,1307839,61740
2013-01-01,Vermont,512268,351969,335874,16095
2013-01-01,Virginia,6356655,4230986,3992211,238775
2013-01-01,Washington,5414242,3457127,3219092,238035
2013-01-01,Wisconsin,4494635,3076445,2863647,212798
2013-01-01,Wyoming,446965,302668,287303,15365
2013-02-01,Alabama,3758678,2178756,2013876,164880
2013-02-01,Alaska,537489,363684,338057,25627
2013-02-01,Arizona,5055713,3056893,2810201,246692
2013-02-01,Arkansas,2273256,1336764,1240366,96398
2013-02-01,California,29506019,18561589,16789624,1771965
2013-02-01,Colorado,4037908,2762415,2564483,197932
2013-02-01,Connecticut,2852925,1864254,1710153,154101
2013-02-01,Delaware,724430,443906,412611,31295
2013-02-01,Florida,15582898,9383328,8634844,748484
2013-02-01,Georgia,7528788,4765817,4357909,407908
2013-02-01,Hawaii,1071588,647257,615252,32005
2013-02-01,Idaho,1202567,773031,718812,54219
2013-02-01,Illinois,10015870,6574749,5966349,608400
2013-02-01,Indiana,5052297,3177057,2917239,259818
2013-02-01,Iowa,2399210,1662690,1580469,82221
2013-02-01,Kansas,2180283,1491109,1408465,82644
2013-02-01,Kentucky,3403390,2068320,1902317,166003
2013-02-01,Louisiana,3517123,2100577,1958498,142079
2013-02-01,Maine,1083932,703337,653775,49562
2013-02-01,Maryland,4626344,3136770,2924605,212165
2013-02-01,Massachusetts,5386735,3512599,3275220,237379
2013-02-01,Michigan,7813604,4719805,4297093,422712
2013-02-01,Minnesota,4205765,2964112,2807168,156944
2013-02-01,Mississippi,2260438,1306538,1192627,113911
2013-02-01,Missouri,4682883,3008137,2800121,208016
2013-02-01,Montana,796277,509687,481801,27886
2013-02-01,Nebraska,1417132,1017500,978771,38729
2013-02-01,Nevada,2142588,1368771,1223325,145446
2013-02-01,Ohio,9045438,5698685,5268265,430420
2013-02-01,Oklahoma,2911344,1799714,1706445,93269
2013-02-01,Oregon,3115248,1929899,1769268,160631
2013-02-01,Pennsylvania,10172294,6448317,5963576,484741
2013-02-01,Tennessee,5048169,3099418,2851148,248270
2013-02-01,Texas,19550750,12757010,11921233,835777
2013-02-01,Utah,2048975,1371797,1310766,61031
2013-02-01,Vermont,512289,351387,335357,16030
2013-02-01,Virginia,6360904,4229626,3991100,238526
2013-02-01,Washington,5418035,3447914,3217874,230040
2013-02-01,Wisconsin,4495713,3076554,2862894,213660
2013-02-01,Wyoming,447276,302300,287193,15107
2013-03-01,Alabama,3759971,2175993,2013323,162670
2013-03-01,Alaska,537668,363411,337876,25535
2013-03-01,Arizona,5061297,3056334,2810619,245715
2013-03-01,Arkansas,2273760,1335682,1239345,96337
2013-03-01,California,29528672,18560032,16812502,1747530
2013-03-01,Colorado,4043296,2762705,2567602,195103
2013-03-01,Connecticut,2853432,1863120,1709824,153296
2013-03-01,Delaware,725014,443158,412171,30987
2013-03-01,Florida,15599379,9385906,8646346,739560
2013-03-01,Georgia,7534514,4761620,4357295,404325
2013-03-01,Hawaii,1071995,647266,615831,31435
2013-03-01,Idaho,1203694,773507,719407,54100
2013-03-01,Illinois,10017644,6567333,5958222,609111
2013-03-01,Indiana,5054512,3178518,2921428,257090
2013-03-01,Iowa,2400220,1664171,1582269,81902
2013-03-01,Kansas,2180605,1490526,1408599,81927
2013-03-01,Kentucky,3404973,2065701,1899808,165893
2013-03-01,Louisiana,3518645,2101504,1958880,142624
2013-03-01,Maine,1084035,703516,654325,49191
2013-03-01,Maryland,4628785,3135411,2924180,211231
2013-03-01,Massachusetts,5390711,3513023,3275474,237549
2013-03-01,Michigan,7815609,4724478,4303586,420892
2013-03-01,Minnesota,4208174,2962646,2807616,155030
2013-03-01,Mississippi,2261049,1296897,1183985,112912
2013-03-01,Missouri,4683981,3008816,2801682,207134
2013-03-01,Montana,796883,510119,482245,27874
2013-03-01,Nebraska,1417718,1017147,978654,38493
2013-03-01,Nevada,2144822,1368999,1225232,143767
2013-03-01,Ohio,9047646,5701127,5269020,432107
2013-03-01,Oklahoma,2913218,1799353,1706007,93346
2013-03-01,Oregon,3117028,1926144,1768464,157680
2013-03-01,Pennsylvania,10172856,6439008,5961886,477122
2013-03-01,Tennessee,5051173,3095898,2847593,248305
2013-03-01,Texas,19577084,12772688,11936855,835833
2013-03-01,Utah,2051950,1374623,1314333,60290
2013-03-01,Vermont,512344,350931,334949,15982
2013-03-01,Virginia,6364931,4229584,3991308,238276
2013-03-01,Washington,5421904,3449293,3218064,231229
2013-03-01,Wisconsin,4497218,3077411,2864201,213210
2013-03-01,Wyoming,447597,302083,287262,14821
2013-04-01,Alabama,3761425,2174613,2014210,160403
2013-04-01,Alaska,537746,363341,337923,25418
2013-04-01,Arizona,5067183,3057784,2813639,244145
2013-04-01,Arkansas,2274396,1334874,1238821,96053
2013-04-01,California,29553252,18565682,16842626,1723056
2013-04-01,Colorado,4048786,2764238,2571622,192616
2013-04-01,Connecticut,2854082,1863931,1711614,152317
2013-04-01,Delaware,725670,442681,412135,30546
2013-04-01,Florida,15616676,9394008,8664776,729232
2013-04-01,Georgia,7540542,4759649,4359853,399796
2013-04-01,Hawaii,1072314,647794,616903,30891
2013-04-01,Idaho,1204876,774575,720581,53994
2013-04-01,Illinois,10020076,6564365,5956555,607810
2013-04-01,Indiana,5056968,3181648,2928625,253023
2013-04-01,Iowa,2401380,1668153,1586806,81347
2013-04-01,Kansas,2180991,1490653,1409461,81192
2013-04-01,Kentucky,3406648,2064135,1898417,165718
2013-04-01,Louisiana,3520231,2102390,1960578,141812
2013-04-01,Maine,1084137,704005,655326,48679
2013-04-01,Maryland,4631489,3134729,2925125,209604
2013-04-01,Massachusetts,5395058,3515403,3278014,237389
2013-04-01,Michigan,7818028,4730864,4311970,418894
2013-04-01,Minnesota,4210788,2961290,2808242,153048
2013-04-01,Mississippi,2261758,1288199,1176746,111453
2013-04-01,Missouri,4685292,3011278,2804770,206508
2013-04-01,Montana,797508,510594,482766,27828
2013-04-01,Nebraska,1418345,1017223,978991,38232
2013-04-01,Nevada,2147154,1369806,1227979,141827
2013-04-01,Ohio,9050334,5706929,5274989,431940
2013-04-01,Oklahoma,2915228,1800235,1707161,93074
2013-04-01,Oregon,3119039,1924158,1769494,154664
2013-04-01,Pennsylvania,10173942,6433901,5964767,469134
2013-04-01,Tennessee,5054403,3092912,2845925,246987
2013-04-01,Texas,19604472,12793456,11962083,831373
2013-04-01,Utah,2055016,1378344,1318709,59635
2013-04-01,Vermont,512436,350684,334772,15912
2013-04-01,Virginia,6368944,4232119,3994223,237896
2013-04-01,Washington,5425892,3452380,3220670,231710
2013-04-01,Wisconsin,4499003,3079639,2868180,211459
2013-04-01,Wyoming,447925,302063,287539,14524
2013-05-01,Alabama,3763029,2174482,2015808,158674
2013-05-01,Alaska,538284,363431,338083,25348
2013-05-01,Arizona,5073301,3060694,2818192,242502
2013-05-01,Arkansas,2275077,1334104,1238431,95673
2013-05-01,California,29579760,18576563,16874399,1702164
2013-05-01,Colorado,4054895,2766305,2575647,190658
2013-05-01,Connecticut,2854892,1866153,1714775,151378
2013-05-01,Delaware,726339,442526,412480,30046
2013-05-01,Florida,15635293,9405649,8686257,719392
2013-05-01,Georgia,7547515,4758784,4363716,395068
2013-05-01,Hawaii,1073510,648702,618211,30491
2013-05-01,Idaho,1206138,776008,722073,53935
2013-05-01,Illinois,10022943,6564150,5958543,605607
2013-05-01,Indiana,5059482,3185716,2937252,248464
2013-05-01,Iowa,2402634,1673821,1593137,80684
2013-05-01,Kansas,2181864,1491094,1410482,80612
2013-05-01,Kentucky,3408721,2063352,1897711,165641
2013-05-01,Louisiana,3522141,2103144,1963094,140050
2013-05-01,Maine,1084318,704715,656605,48110
2013-05-01,Maryland,4634490,3134344,2926541,207803
2013-05-01,Massachusetts,5399486,3518522,3281377,237145
2013-05-01,Michigan,7820362,4738195,4320494,417701
2013-05-01,Minnesota,4213509,2960131,2808881,151250
2013-05-01,Mississippi,2262701,1280192,1170333,109859
2013-05-01,Missouri,4687010,3014209,2808028,206181
2013-05-01,Montana,798209,510966,483222,27744
2013-05-01,Nebraska,1419166,1017337,979326,38011
2013-05-01,Nevada,2149619,1370943,1231067,139876
2013-05-01,Ohio,9053073,5713147,5281766,431381
2013-05-01,Oklahoma,2917592,1801681,1708925,92756
2013-05-01,Oregon,3121022,1923376,1771464,151912
2013-05-01,Pennsylvania,10175207,6431705,5969205,462500
2013-05-01,Tennessee,5057965,3089865,2844913,244952
2013-05-01,Texas,19633581,12816378,11991479,824899
2013-05-01,Utah,2058133,1382531,1323353,59178
2013-05-01,Vermont,512553,350554,334741,15813
2013-05-01,Virginia,6375248,4236152,3998446,237706
2013-05-01,Washington,5430881,3456355,3224598,231757
2013-05-01,Wisconsin,4500856,3082194,2873099,209095
2013-05-01,Wyoming,448342,302153,287874,14279
2013-06-01,Alabama,3764923,2174677,2016898,157779
2013-06-01,Alaska,538281,363613,338220,25393
2013-06-01,Arizona,5079772,3064094,2822985,241109
2013-06-01,Arkansas,2276045,1333280,1237985,95295
2013-06-01,California,29606950,18587359,16900895,1686464
2013-06-01,Colorado,4060727,2768303,2579085,189218
2013-06-01,Connecticut,2855924,1868813,1718256,150557
2013-06-01,Delaware,727078,442641,413085,29556
2013-06-01,Florida,15654708,9417639,8706200,711439
2013-06-01,Georgia,7554106,4757233,4366608,390625
2013-06-01,Hawaii,1073629,649806,619477,30329
2013-06-01,Idaho,1207515,777564,723613,53951
2013-06-01,Illinois,10026812,6564252,5960949,603303
2013-06-01,Indiana,5062772,3190582,2946381,244201
2013-06-01,Iowa,2404245,1679506,1599483,80023
2013-06-01,Kansas,2182471,1491270,1411118,80152
2013-06-01,Kentucky,3410807,2062469,1896774,165695
2013-06-01,Louisiana,3524095,2103648,1965593,138055
2013-06-01,Maine,1084636,705441,657855,47586
2013-06-01,Maryland,4637576,3133645,2927329,206316
2013-06-01,Massachusetts,5404700,3520920,3284024,236896
2013-06-01,Michigan,7823981,4745039,4327389,417650
2013-06-01,Minnesota,4216855,2959310,2809549,149761
2013-06-01,Mississippi,2263641,1272370,1163744,108626
2013-06-01,Missouri,4689032,3015995,2810122,205873
2013-06-01,Montana,798963,511208,483568,27640
2013-06-01,Nebraska,1420027,1017004,979203,37801
2013-06-01,Nevada,2152150,1372012,1233932,138080
2013-06-01,Ohio,9057146,5717334,5285529,431805
2013-06-01,Oklahoma,2919929,1802864,1710192,92672
2013-06-01,Oregon,3123530,1923051,1773458,149593
2013-06-01,Pennsylvania,10178028,6429380,5971295,458085
2013-06-01,Tennessee,5061823,3085954,2843190,242764
2013-06-01,Texas,19662766,12837490,12018765,818725
2013-06-01,Utah,2061510,1386526,1327663,58863
2013-06-01,Vermont,512724,350425,334728,15697
2013-06-01,Virginia,6379556,4240224,4002240,237984
2013-06-01,Washington,5435401,3460427,3228621,231806
2013-06-01,Wisconsin,4503389,3083584,2876730,206854
2013-06-01,Wyoming,448731,302234,288123,14111
2013-07-01,Alabama,3766869,2174320,2016720,157600
2013-07-01,Alaska,538697,363803,338308,25495
2013-07-01,Arizona,5086380,3067255,2827358,239897
2013-07-01,Arkansas,2276997,1332281,1237390,94891
2013-07-01,California,29635123,18593103,16919448,1673655
2013-07-01,Colorado,4067025,2769662,2581932,187730
2013-07-01,Connecticut,2857034,1870801,1721124,149677
2013-07-01,Delaware,727812,442935,413831,29104
2013-07-01,Florida,15674637,9427528,8722512,705016
2013-07-01,Georgia,7560981,4753872,4367542,386330
2013-07-01,Hawaii,1074519,650974,620569,30405
2013-07-01,Idaho,1208893,779087,725099,53988
2013-07-01,Illinois,10030317,6562584,5961642,600942
2013-07-01,Indiana,5065926,3196530,2956324,240206
2013-07-01,Iowa,2405753,1683993,1604608,79385
2013-07-01,Kansas,2183388,1490847,1411224,79623
2013-07-01,Kentucky,3413114,2060497,1894998,165499
2013-07-01,Louisiana,3526293,2103958,1967784,136174
2013-07-01,Maine,1084942,705989,658878,47111
2013-07-01,Maryland,4640951,3132042,2927100,204942
2013-07-01,Massachusetts,5409770,3521770,3285397,236373
2013-07-01,Michigan,7827369,4749853,4332010,417843
2013-07-01,Minnesota,4220108,2959245,2810761,148484
2013-07-01,Mississippi,2264709,1268048,1160302,107746
2013-07-01,Missouri,4691093,3015876,2810658,205218
2013-07-01,Montana,799737,511458,483921,27537
2013-07-01,Nebraska,1420974,1015997,978454,37543
2013-07-01,Nevada,2154816,1372712,1236337,136375
2013-07-01,Ohio,9061057,5718793,5285992,432801
2013-07-01,Oklahoma,2922377,1803164,1710369,92795
2013-07-01,Oregon,3125928,1922652,1775086,147566
2013-07-01,Pennsylvania,10180604,6424767,5969474,455293
2013-07-01,Tennessee,5065824,3080892,2840265,240627
2013-07-01,Texas,19692871,12855277,12041788,813489
2013-07-01,Utah,2064852,1389933,1331380,58553
2013-07-01,Vermont,512904,350240,334676,15564
2013-07-01,Virginia,6385274,4243322,4005011,238311
2013-07-01,Washington,5440583,3464183,3232372,231811
2013-07-01,Wisconsin,4505801,3083217,2878077,205140
2013-07-01,Wyoming,449152,302271,288226,14045
2013-08-01,Alabama,3768499,2172637,2015204,157433
2013-08-01,Alaska,539112,363845,338340,25505
2013-08-01,Arizona,5094765,3069196,2831079,238117
2013-08-01,Arkansas,2278011,1330709,1236614,94095
2013-08-01,California,29665950,18587188,16930930,1656258
2013-08-01,Colorado,4073981,2769322,2584166,185156
2013-08-01,Connecticut,2858175,1871349,1723188,148161
2013-08-01,Delaware,728676,443283,414660,28623
2013-08-01,Florida,15699539,9432470,8735091,697379
2013-08-01,Georgia,7568874,4747684,4366691,380993
2013-08-01,Hawaii,1075489,652138,621567,30571
2013-08-01,Idaho,1210463,780447,726569,53878
2013-08-01,Illinois,10032173,6556695,5960397,596298
2013-08-01,Indiana,5068571,3201733,2966614,235119
2013-08-01,Iowa,2407129,1686408,1607835,78573
2013-08-01,Kansas,2184718,1489665,1411057,78608
2013-08-01,Kentucky,3414664,2056498,1892207,164291
2013-08-01,Louisiana,3528368,2103449,1969745,133704
2013-08-01,Maine,1085388,705978,659479,46499
2013-08-01,Maryland,4643937,3128842,2925935,202907
2013-08-01,Massachusetts,5414595,3520422,3285726,234696
2013-08-01,Michigan,7830628,4750495,4334709,415786
2013-08-01,Minnesota,4223049,2959719,2812839,146880
2013-08-01,Mississippi,2265558,1254811,1148171,106640
2013-08-01,Missouri,4693101,3013797,2810184,203613
2013-08-01,Montana,800442,511695,484345,27350
2013-08-01,Nebraska,1422003,1014398,977305,37093
2013-08-01,Nevada,2158236,1372608,1238307,134301
2013-08-01,Ohio,9064677,5716629,5284908,431721
2013-08-01,Oklahoma,2924485,1802134,1709443,92691
2013-08-01,Oregon,3129332,1921985,1776755,145230
2013-08-01,Pennsylvania,10183403,6416123,5964676,451447
2013-08-01,Tennessee,5069972,3074336,2836800,237536
2013-08-01,Texas,19728313,12867238,12061310,805928
2013-08-01,Utah,2067849,1392500,1334511,57989
2013-08-01,Vermont,512966,349953,334580,15373
2013-08-01,Virginia,6391397,4244602,4007012,237590
2013-08-01,Washington,5448331,3466584,3235962,230622
2013-08-01,Wisconsin,4507808,3080977,2877730,203247
2013-08-01,Wyoming,449222,302231,288200,14031
2013-09-01,Alabama,3770214,2169847,2013022,156825
2013-09-01,Alaska,539171,363710,338320,25390
2013-09-01,Arizona,5103215,3069703,2834283,235420
2013-09-01,Arkansas,2279106,1328616,1235898,92718
2013-09-01,California,29696653,18570217,16939401,1630816
2013-09-01,Colorado,4080567,2767570,2586419,181151
2013-09-01,Connecticut,2859384,1870764,1724994,145770
2013-09-01,Delaware,729578,443676,415572,28104
2013-09-01,Florida,15724553,9433614,8746255,687359
2013-09-01,Georgia,7576721,4739785,4365522,374263
2013-09-01,Hawaii,1075926,653325,622633,30692
2013-09-01,Idaho,1212088,781625,728067,53558
2013-09-01,Illinois,10034545,6547345,5959101,588244
2013-09-01,Indiana,5071500,3204516,2976182,228334
2013-09-01,Iowa,2408648,1686554,1609044,77510
2013-09-01,Kansas,2185822,1488146,1411091,77055
2013-09-01,Kentucky,3416171,2050680,1888658,162022
2013-09-01,Louisiana,3530459,2102001,1971714,130287
2013-09-01,Maine,1085923,705310,659610,45700
2013-09-01,Maryland,4646932,3124472,2924492,199980
2013-09-01,Massachusetts,5419749,3517704,3286121,231583
2013-09-01,Michigan,7834323,4747499,4336984,410515
2013-09-01,Minnesota,4226279,2960319,2815492,144827
2013-09-01,Mississippi,2266375,1252815,1147763,105052
2013-09-01,Missouri,4695256,3011160,2809780,201380
2013-09-01,Montana,801146,511880,484863,27017
2013-09-01,Nebraska,1423047,1012637,976235,36402
2013-09-01,Nevada,2161607,1371772,1240084,131688
2013-09-01,Ohio,9068774,5711245,5284794,426451
2013-09-01,Oklahoma,2926590,1800109,1707972,92137
2013-09-01,Oregon,3132931,1921524,1778975,142549
2013-09-01,Pennsylvania,10186846,6404340,5959318,445022
2013-09-01,Tennessee,5074160,3066803,2833931,232872
2013-09-01,Texas,19763523,12873858,12079341,794517
2013-09-01,Utah,2070938,1394372,1337267,57105
2013-09-01,Vermont,513076,349601,334486,15115
2013-09-01,Virginia,6396539,4244434,4009047,235387
2013-09-01,Washington,5455719,3467375,3239639,227736
2013-09-01,Wisconsin,4510094,3077408,2877039,200369
2013-09-01,Wyoming,449293,302130,288119,14011
2013-10-01,Alabama,3771896,2167230,2011093,156137
2013-10-01,Alaska,539295,363558,338279,25279
2013-10-01,Arizona,5111574,3070375,2837884,232491
2013-10-01,Arkansas,2280144,1326715,1235660,91055
2013-10-01,California,29726663,18553825,16951113,1602712
2013-10-01,Colorado,4087135,2766264,2589867,176397
2013-10-01,Connecticut,2860520,1870128,1727081,143047
2013-10-01,Delaware,730453,444215,416563,27652
2013-10-01,Florida,15749207,9436839,8759566,677273
2013-10-01,Georgia,7584668,4733883,4366214,367669
2013-10-01,Hawaii,1076293,654646,623909,30737
2013-10-01,Idaho,1213707,782755,729577,53178
2013-10-01,Illinois,10036798,6539322,5960606,578716
2013-10-01,Indiana,5074366,3205501,2984597,220904
2013-10-01,Iowa,2410150,1685404,1608832,76572
2013-10-01,Kansas,2186901,1487170,1411799,75371
2013-10-01,Kentucky,3417645,2044372,1884947,159425
2013-10-01,Louisiana,3532431,2100686,1974140,126546
2013-10-01,Maine,1086416,704366,659476,44890
2013-10-01,Maryland,4649825,3120510,2923641,196869
2013-10-01,Massachusetts,5424816,3516257,3288254,228003
2013-10-01,Michigan,7837931,4744156,4340565,403591
2013-10-01,Minnesota,4229411,2961292,2818328,142964
2013-10-01,Mississippi,2267144,1250602,1147147,103455
2013-10-01,Missouri,4697387,3010507,2810589,199918
2013-10-01,Montana,801824,512116,485480,26636
2013-10-01,Nebraska,1424077,1011485,975674,35811
2013-10-01,Nevada,2164903,1371166,1242032,129134
2013-10-01,Ohio,9072686,5705087,5287632,417455
2013-10-01,Oklahoma,2928709,1798068,1706719,91349
2013-10-01,Oregon,3136440,1922159,1781810,140349
2013-10-01,Pennsylvania,10189979,6393597,5956291,437306
2013-10-01,Tennessee,5078253,3059810,2832394,227416
2013-10-01,Texas,19798357,12880739,12099121,781618
2013-10-01,Utah,2073970,1396158,1339974,56184
2013-10-01,Vermont,513176,349300,334450,14850
2013-10-01,Virginia,6401486,4244667,4011855,232812
2013-10-01,Washington,5462940,3467791,3243553,224238
2013-10-01,Wisconsin,4512294,3073994,2877113,196881
2013-10-01,Wyoming,449366,302077,288075,14002
2013-11-01,Alabama,3773384,2165715,2010028,155687
2013-11-01,Alaska,539263,363547,338306,25241
2013-11-01,Arizona,5119649,3072551,2843115,229436
2013-11-01,Arkansas,2281058,1325461,1236175,89286
2013-11-01,California,29756007,18547876,16971722,1576154
2013-11-01,Colorado,4093376,2767651,2595558,172093
2013-11-01,Connecticut,2861561,1870266,1729880,140386
2013-11-01,Delaware,731214,444909,417594,27315
2013-11-01,Florida,15772705,9446215,8777668,668547
2013-11-01,Georgia,7592498,4732267,4370024,362243
2013-11-01,Hawaii,1076475,656212,625532,30680
2013-11-01,Idaho,1215253,781042,731179,49863
2013-11-01,Illinois,10038967,6536335,5967239,569096
2013-11-01,Indiana,5077084,3206192,2992216,213976
2013-11-01,Iowa,2411521,1684452,1608558,75894
2013-11-01,Kansas,2187720,1487212,1413405,73807
2013-11-01,Kentucky,3418877,2038670,1881766,156904
2013-11-01,Louisiana,3534161,2100476,1977442,123034
2013-11-01,Maine,1086870,703474,659283,44191
2013-11-01,Maryland,4652421,3118057,2924041,194016
2013-11-01,Massachusetts,5429678,3517745,3293116,224629
2013-11-01,Michigan,7841202,4743413,4346689,396724
2013-11-01,Minnesota,4232451,2962764,2821182,141582
2013-11-01,Mississippi,2267787,1248764,1146573,102191
2013-11-01,Missouri,4699421,3012981,2813239,199742
2013-11-01,Montana,802467,512380,486132,26248
2013-11-01,Nebraska,1424973,1011351,975833,35518
2013-11-01,Nevada,2168144,1371342,1244462,126880
2013-11-01,Ohio,9076263,5700211,5294623,405588
2013-11-01,Oklahoma,2930743,1796614,1706259,90355
2013-11-01,Oregon,3139813,1924468,1785385,139083
2013-11-01,Pennsylvania,10192700,6387329,5958121,429208
2013-11-01,Tennessee,5082093,3054206,2832369,221837
2013-11-01,Texas,19832481,12892128,12124031,768097
2013-11-01,Utah,2076934,1398215,1342906,55309
2013-11-01,Vermont,513249,349089,334466,14623
2013-11-01,Virginia,6405584,4246742,4016111,230631
2013-11-01,Washington,5469691,3468654,3247718,220936
2013-11-01,Wisconsin,4514392,3071951,2878978,192973
2013-11-01,Wyoming,449390,302109,288157,13952
2013-12-01,Alabama,3774572,2165388,2009949,155439
2013-12-01,Alaska,539431,363695,338449,25246
2013-12-01,Arizona,5127350,3076382,2850146,226236
2013-12-01,Arkansas,2281785,1324767,1237331,87436
2013-12-01,California,29783733,18554149,17001882,1552267
2013-12-01,Colorado,4099604,2772177,2603433,168744
2013-12-01,Connecticut,2862341,1871503,1733625,137878
2013-12-01,Delaware,732002,445675,418596,27079
2013-12-01,Florida,15795270,9461489,8800149,661340
2013-12-01,Georgia,7600196,4734481,4376243,358238
2013-12-01,Hawaii,1077144,657879,627380,30499
2013-12-01,Idaho,1216693,779488,732868,46620
2013-12-01,Illinois,10040361,6537549,5978331,559218
2013-12-01,Indiana,5079216,3207647,2999291,208356
2013-12-01,Iowa,2412622,1684792,1609386,75406
2013-12-01,Kansas,2188613,1488263,1415787,72476
2013-12-01,Kentucky,3419898,2034084,1879552,154532
2013-12-01,Louisiana,3535754,2101607,1981332,120275
2013-12-01,Maine,1087193,702632,659022,43610
2013-12-01,Maryland,4654826,3117158,2925695,191463
2013-12-01,Massachusetts,5433952,3522182,3300577,221605
2013-12-01,Michigan,7843590,4745607,4354920,390687
2013-12-01,Minnesota,4234970,2964246,2823768,140478
2013-12-01,Mississippi,2268395,1247492,1146243,101249
2013-12-01,Missouri,4701109,3017799,2817410,200389
2013-12-01,Montana,803034,512516,486660,25856
2013-12-01,Nebraska,1425825,1012031,976601,35430
2013-12-01,Nevada,2171241,1372217,1247354,124863
2013-12-01,Ohio,9078805,5696553,5304884,391669
2013-12-01,Oklahoma,2932602,1795533,1706508,89025
2013-12-01,Oregon,3142820,1928211,1789567,138644
2013-12-01,Pennsylvania,10194255,6386175,5964685,421490
2013-12-01,Tennessee,5085584,3049904,2833383,216521
2013-12-01,Texas,19865772,12907972,12154284,753688
2013-12-01,Utah,2079764,1400436,1346017,54419
2013-12-01,Vermont,513269,348937,334491,14446
2013-12-01,Virginia,6410731,4250846,4021840,229006
2013-12-01,Washington,5476537,3469934,3251784,218150
2013-12-01,Wisconsin,4515931,3071403,2882705,188698
2013-12-01,Wyoming,449393,302194,288374,13820
2014-01-01,Alabama,3775896,2165971,2010942,155029
2014-01-01,Alaska,539619,363966,338735,25231
2014-01-01,Arizona,5135007,3081484,2858474,223010
2014-01-01,Arkansas,2282487,1324443,1238994,85449
2014-01-01,California,29812266,18569356,17040259,1529097
2014-01-01,Colorado,4105799,2778644,2613030,165614
2014-01-01,Connecticut,2863185,1873722,1738339,135383
2014-01-01,Delaware,732837,446546,419663,26883
2014-01-01,Florida,15818006,9479786,8825090,654696
2014-01-01,Georgia,7608115,4738716,4383593,355123
2014-01-01,Hawaii,1077742,659402,629214,30188
2014-01-01,Idaho,1218117,778076,734548,43528
2014-01-01,Illinois,10041949,6539433,5991934,547499
2014-01-01,Indiana,5081350,3210348,3006208,204140
2014-01-01,Iowa,2413708,1686880,1611910,74970
2014-01-01,Kansas,2189481,1490102,1418761,71341
2014-01-01,Kentucky,3420974,2030616,1878659,151957
2014-01-01,Louisiana,3537379,2103844,1985316,118528
2014-01-01,Maine,1087515,701831,658792,43039
2014-01-01,Maryland,4657298,3117343,2928422,188921
2014-01-01,Massachusetts,5438307,3528825,3310181,218644
2014-01-01,Michigan,7846050,4749538,4364414,385124
2014-01-01,Minnesota,4237487,2965437,2826045,139392
2014-01-01,Mississippi,2269079,1246805,1146363,100442
2014-01-01,Missouri,4702832,3023454,2822595,200859
2014-01-01,Montana,803600,512421,486983,25438
2014-01-01,Nebraska,1426584,1013076,977740,35336
2014-01-01,Nevada,2174343,1373421,1250571,122850
2014-01-01,Ohio,9081389,5693500,5316915,376585
2014-01-01,Oklahoma,2934523,1794313,1707122,87191
2014-01-01,Oregon,3145835,1932624,1794235,138389
2014-01-01,Pennsylvania,10195861,6388276,5974041,414235
2014-01-01,Tennessee,5089069,3046560,2834891,211669
2014-01-01,Texas,19899461,12926206,12188294,737912
2014-01-01,Utah,2082531,1402644,1349185,53459
2014-01-01,Vermont,513280,348806,334528,14278
2014-01-01,Virginia,6415418,4256299,4028612,227687
2014-01-01,Washington,5483240,3471141,3255449,215692
2014-01-01,Wisconsin,4517494,3071739,2887465,184274
2014-01-01,Wyoming,449367,302308,288675,13633
2014-02-01,Alabama,3776877,2166876,2012653,154223
2014-02-01,Alaska,539509,364333,339157,25176
2014-02-01,Arizona,5142282,3087246,2867319,219927
2014-02-01,Arkansas,2283060,1324270,1240888,83382
2014-02-01,California,29837518,18588369,17083487,1504882
2014-02-01,Colorado,4111541,2785590,2623718,161872
2014-02-01,Connecticut,2863789,1876435,1743577,132858
2014-02-01,Delaware,733503,447591,420921,26670
2014-02-01,Florida,15838937,9497821,8849988,647833
2014-02-01,Georgia,7615165,4743210,4390706,352504
2014-02-01,Hawaii,1077845,660678,630881,29797
2014-02-01,Idaho,1219442,776745,736121,40624
2014-02-01,Illinois,10042715,6539294,6006418,532876
2014-02-01,Indiana,5083309,3214183,3013026,201157
2014-02-01,Iowa,2414682,1690118,1615655,74463
2014-02-01,Kansas,2190055,1492219,1421820,70399
2014-02-01,Kentucky,3421719,2027674,1878905,148769
2014-02-01,Louisiana,3538761,2107066,1989022,118044
2014-02-01,Maine,1087757,701068,658705,42363
2014-02-01,Maryland,4659350,3118114,2931696,186418
2014-02-01,Massachusetts,5442411,3536741,3321159,215582
2014-02-01,Michigan,7848175,4754121,4374624,379497
2014-02-01,Minnesota,4239854,2966801,2828846,137955
2014-02-01,Mississippi,2269514,1246453,1146767,99686
2014-02-01,Missouri,4704124,3028252,2827952,200300
2014-02-01,Montana,804113,512169,487185,24984
2014-02-01,Nebraska,1427283,1013940,978832,35108
2014-02-01,Nevada,2177240,1374578,1253863,120715
2014-02-01,Ohio,9083600,5691029,5328838,362191
2014-02-01,Oklahoma,2936088,1792880,1707926,84954
2014-02-01,Oregon,3148678,1936905,1799250,137655
2014-02-01,Pennsylvania,10197005,6390970,5983678,407292
2014-02-01,Tennessee,5092218,3043669,2835964,207705
2014-02-01,Texas,19931260,12944743,12223189,721554
2014-02-01,Utah,2085290,1404680,1352211,52469
2014-02-01,Vermont,513290,348678,334573,14105
2014-02-01,Virginia,6418890,4261740,4035391,226349
2014-02-01,Washington,5489276,3471891,3258702,213189
2014-02-01,Wisconsin,4518845,3072006,2892285,179721
2014-02-01,Wyoming,449336,302412,288990,13422
2014-03-01,Alabama,3777962,2167429,2014263,153166
2014-03-01,Alaska,539754,364723,339585,25138
2014-03-01,Arizona,5149581,3093246,2875911,217335
2014-03-01,Arkansas,2283711,1324213,1242674,81539
2014-03-01,California,29863107,18608224,17126546,1481678
2014-03-01,Colorado,4117658,2791859,2634418,157441
2014-03-01,Connecticut,2864494,1879255,1748668,130587
2014-03-01,Delaware,734258,448826,422367,26459
2014-03-01,Florida,15860256,9513557,8872130,641427
2014-03-01,Georgia,7622847,4746928,4396047,350881
2014-03-01,Hawaii,1078425,661775,632329,29446
2014-03-01,Idaho,1220865,775559,737567,37992
2014-03-01,Illinois,10043753,6535796,6019511,516285
2014-03-01,Indiana,5085349,3218859,3019531,199328
2014-03-01,Iowa,2415666,1693311,1619332,73979
2014-03-01,Kansas,2190902,1494043,1424398,69645
2014-03-01,Kentucky,3422732,2024499,1879447,145052
2014-03-01,Louisiana,3540264,2111847,1992426,119421
2014-03-01,Maine,1088088,700376,658761,41615
2014-03-01,Maryland,4661547,3119340,2934794,184546
2014-03-01,Massachusetts,5446508,3544719,3331902,212817
2014-03-01,Michigan,7850278,4758378,4384836,373542
2014-03-01,Minnesota,4242288,2969112,2833095,136017
2014-03-01,Mississippi,2270082,1246033,1147012,99021
2014-03-01,Missouri,4705663,3030991,2832619,198372
2014-03-01,Montana,804660,511966,487393,24573
2014-03-01,Nebraska,1428099,1014248,979472,34776
2014-03-01,Nevada,2180188,1375605,1256934,118671
2014-03-01,Ohio,9085936,5690228,5339396,350832
2014-03-01,Oklahoma,2937906,1791504,1708779,82725
2014-03-01,Oregon,3151548,1940643,1804298,136345
2014-03-01,Pennsylvania,10198199,6392273,5991065,401208
2014-03-01,Tennessee,5095612,3041048,2835726,205322
2014-03-01,Texas,19963437,12962485,12254958,707527
2014-03-01,Utah,2088050,1406514,1354871,51643
2014-03-01,Vermont,513286,348585,334605,13980
2014-03-01,Virginia,6423820,4265948,4040682,225266
2014-03-01,Washington,5495957,3472850,3261947,210903
2014-03-01,Wisconsin,4520263,3072114,2896598,175516
2014-03-01,Wyoming,449330,302506,289248,13258
2014-04-01,Alabama,3779148,2166887,2015052,151835
2014-04-01,Alaska,539920,364982,339829,25153
2014-04-01,Arizona,5157085,3098896,2883663,215233
2014-04-01,Arkansas,2284412,1324212,1244129,80083
2014-04-01,California,29890084,18624963,17164661,1460302
2014-04-01,Colorado,4123834,2796320,2644060,152260
2014-04-01,Connecticut,2865227,1882025,1753324,128701
2014-04-01,Delaware,735008,450102,423844,26258
2014-04-01,Florida,15881941,9525298,8890013,635285
2014-04-01,Georgia,7630658,4748750,4398631,350119
2014-04-01,Hawaii,1078966,662692,633518,29174
2014-04-01,Idaho,1222312,774476,738865,35611
2014-04-01,Illinois,10045091,6528094,6029065,499029
2014-04-01,Indiana,5087465,3222985,3024974,198011
2014-04-01,Iowa,2416760,1695751,1622168,73583
2014-04-01,Kansas,2191747,1495057,1426026,69031
2014-04-01,Kentucky,3423820,2020074,1879242,140832
2014-04-01,Louisiana,3541777,2118328,1995649,122679
2014-04-01,Maine,1088386,699680,658856,40824
2014-04-01,Maryland,4663823,3120501,2937114,183387
2014-04-01,Massachusetts,5450754,3551300,3340784,210516
2014-04-01,Michigan,7852565,4760730,4393862,366868
2014-04-01,Minnesota,4244776,2971996,2838498,133498
2014-04-01,Mississippi,2270655,1245010,1146757,98253
2014-04-01,Missouri,4707337,3031462,2836109,195353
2014-04-01,Montana,805196,511934,487669,24265
2014-04-01,Nebraska,1428903,1013835,979454,34381
2014-04-01,Nevada,2183244,1376354,1259583,116771
2014-04-01,Ohio,9088443,5691744,5348627,343117
2014-04-01,Oklahoma,2939772,1790356,1709600,80756
2014-04-01,Oregon,3154549,1943538,1808969,134569
2014-04-01,Pennsylvania,10199621,6390305,5994857,395448
2014-04-01,Tennessee,5099031,3038521,2834046,204475
2014-04-01,Texas,19996449,12977478,12280595,696883
2014-04-01,Utah,2090879,1408112,1357035,51077
2014-04-01,Vermont,513303,348513,334580,13933
2014-04-01,Virginia,6428555,4267774,4043315,224459
2014-04-01,Washington,5502692,3474684,3265637,209047
2014-04-01,Wisconsin,4521748,3072178,2900257,171921
2014-04-01,Wyoming,449340,302590,289389,13201
2014-05-01,Alabama,3780402,2165427,2015410,150017
2014-05-01,Alaska,539952,365047,339891,25156
2014-05-01,Arizona,5164679,3104438,2891087,213351
2014-05-01,Arkansas,2285227,1324336,1245446,78890
2014-05-01,California,29916600,18638929,17200175,1438754
2014-05-01,Colorado,4129980,2799033,2652822,146211
2014-05-01,Connecticut,2866111,1884757,1757743,127014
2014-05-01,Delaware,735746,451305,425282,26023
2014-05-01,Florida,15903940,9534040,8905898,628142
2014-05-01,Georgia,7638321,4748727,4399795,348932
2014-05-01,Hawaii,1079174,663424,634545,28879
2014-05-01,Idaho,1223807,774878,740193,34685
2014-05-01,Illinois,10046805,6518261,6036226,482035
2014-05-01,Indiana,5090010,3226182,3030027,196155
2014-05-01,Iowa,2418089,1697727,1624533,73194
2014-05-01,Kansas,2192602,1495273,1426868,68405
2014-05-01,Kentucky,3425003,2014317,1878442,135875
2014-05-01,Louisiana,3543376,2126535,1999443,127092
2014-05-01,Maine,1088766,698898,658932,39966
2014-05-01,Maryland,4666100,3121400,2939236,182164
2014-05-01,Massachusetts,5455405,3556705,3348340,208365
2014-05-01,Michigan,7855445,4760984,4402006,358978
2014-05-01,Minnesota,4247681,2975113,2844737,130376
2014-05-01,Mississippi,2271250,1243633,1146391,97242
2014-05-01,Missouri,4709237,3030820,2839226,191594
2014-05-01,Montana,805821,512134,488112,24022
2014-05-01,Nebraska,1429800,1012989,979097,33892
2014-05-01,Nevada,2186235,1376943,1262099,114844
2014-05-01,Ohio,9091567,5696376,5358794,337582
2014-05-01,Oklahoma,2941732,1790090,1711113,78977
2014-05-01,Oregon,3157729,1945984,1813583,132401
2014-05-01,Pennsylvania,10201740,6385963,5997076,388887
2014-05-01,Tennessee,5102669,3036563,2832484,204079
2014-05-01,Texas,20029222,12990622,12302615,688007
2014-05-01,Utah,2093891,1409831,1359074,50757
2014-05-01,Vermont,513384,348496,334560,13936
2014-05-01,Virginia,6432887,4267161,4043979,223182
2014-05-01,Washington,5509350,3478313,3270893,207420
2014-05-01,Wisconsin,4523688,3072776,2904115,168661
2014-05-01,Wyoming,449389,302688,289475,13213
2014-06-01,Alabama,3781842,2164102,2016249,147853
2014-06-01,Alaska,540093,364977,339893,25084
2014-06-01,Arizona,5172489,3110915,2899220,211695
2014-06-01,Arkansas,2286089,1324928,1247064,77864
2014-06-01,California,29944683,18656005,17238675,1417330
2014-06-01,Colorado,4136443,2800957,2661226,139731
2014-06-01,Connecticut,2867060,1887936,1762463,125473
2014-06-01,Delaware,736544,452472,426731,25741
2014-06-01,Florida,15926650,9543064,8923099,619965
2014-06-01,Georgia,7646501,4748412,4401903,346509
2014-06-01,Hawaii,1079608,664120,635619,28501
2014-06-01,Idaho,1225357,772518,741711,30807
2014-06-01,Illinois,10048895,6510457,6043882,466575
2014-06-01,Indiana,5092587,3228715,3035235,193480
2014-06-01,Iowa,2419419,1699665,1626906,72759
2014-06-01,Kansas,2193633,1495152,1427461,67691
2014-06-01,Kentucky,3426320,2008207,1877753,130454
2014-06-01,Louisiana,3545128,2136367,2004372,131995
2014-06-01,Maine,1089198,698129,659052,39077
2014-06-01,Maryland,4668668,3122644,2942245,180399
2014-06-01,Massachusetts,5460196,3562788,3356523,206265
2014-06-01,Michigan,7858371,4760581,4410586,349995
2014-06-01,Minnesota,4250635,2978678,2851608,127070
2014-06-01,Mississippi,2271966,1242518,1146590,95928
2014-06-01,Missouri,4711311,3030914,2843247,187667
2014-06-01,Montana,806454,512539,488704,23835
2014-06-01,Nebraska,1430764,1012254,978935,33319
2014-06-01,Nevada,2189378,1377865,1264946,112919
2014-06-01,Ohio,9094839,5704592,5372122,332470
2014-06-01,Oklahoma,2943814,1791491,1714066,77425
2014-06-01,Oregon,3160985,1948765,1818552,130213
2014-06-01,Pennsylvania,10204125,6382223,6001094,381129
2014-06-01,Tennessee,5106517,3036228,2832894,203334
2014-06-01,Texas,20063200,13005331,12325395,679936
2014-06-01,Utah,2096947,1412233,1361525,50708
2014-06-01,Vermont,513456,348595,334637,13958
2014-06-01,Virginia,6437866,4265150,4044124,221026
2014-06-01,Washington,5516406,3484570,3278515,206055
2014-06-01,Wisconsin,4525650,3074787,2909425,165362
2014-06-01,Wyoming,449410,302902,289593,13309
2014-07-01,Alabama,3783338,2163245,2017648,145597
2014-07-01,Alaska,540362,364744,339820,24924
2014-07-01,Arizona,5180459,3118643,2908222,210421
2014-07-01,Arkansas,2287037,1326166,1249184,76982
2014-07-01,California,29973268,18677566,17279967,1397599
2014-07-01,Colorado,4143100,2802732,2669021,133711
2014-07-01,Connecticut,2868086,1891461,1767363,124098
2014-07-01,Delaware,737354,453608,428207,25401
2014-07-01,Florida,15949789,9553381,8941700,611681
2014-07-01,Georgia,7654601,4748222,4405529,342693
2014-07-01,Hawaii,1080312,664779,636723,28056
2014-07-01,Idaho,1226932,774415,743273,31142
2014-07-01,Illinois,10050873,6506321,6053007,453314
2014-07-01,Indiana,5095338,3230459,3039980,190479
2014-07-01,Iowa,2420807,1701256,1628984,72272
2014-07-01,Kansas,2194773,1494899,1427996,66903
2014-07-01,Kentucky,3427780,2002336,1877122,125214
2014-07-01,Louisiana,3547016,2146989,2010030,136959
2014-07-01,Maine,1089642,697406,659150,38256
2014-07-01,Maryland,4671342,3124415,2946042,178373
2014-07-01,Massachusetts,5465033,3570532,3366302,204230
2014-07-01,Michigan,7861502,4760410,4419845,340565
2014-07-01,Minnesota,4253663,2982337,2858156,124181
2014-07-01,Mississippi,2272687,1241849,1147388,94461
2014-07-01,Missouri,4713419,3032475,2848329,184146
2014-07-01,Montana,807113,512909,489212,23697
2014-07-01,Nebraska,1431772,1011874,979130,32744
2014-07-01,Nevada,2192599,1379296,1268140,111156
2014-07-01,Ohio,9098363,5714956,5387836,327120
2014-07-01,Oklahoma,2945898,1794276,1718123,76153
2014-07-01,Oregon,3164306,1951938,1823499,128439
2014-07-01,Pennsylvania,10206633,6380460,6007565,372895
2014-07-01,Tennessee,5110481,3037420,2835451,201969
2014-07-01,Texas,20097595,13020533,12348864,671669
2014-07-01,Utah,2100046,1415313,1364434,50879
2014-07-01,Vermont,513527,348732,334745,13987
2014-07-01,Virginia,6443321,4261973,4043653,218320
2014-07-01,Washington,5523748,3493179,3287937,205242
2014-07-01,Wisconsin,4527717,3077724,2915883,161841
2014-07-01,Wyoming,449473,303175,289739,13436
2014-08-01,Alabama,3785171,2162943,2019514,143429
2014-08-01,Alaska,540603,364445,339777,24668
2014-08-01,Arizona,5189451,3127937,2918301,209636
2014-08-01,Arkansas,2288351,1328224,1251928,76296
2014-08-01,California,30003777,18704813,17324005,1380808
2014-08-01,Colorado,4151522,2805239,2676304,128935
2014-08-01,Connecticut,2868777,1894819,1771979,122840
2014-08-01,Delaware,738197,454713,429692,25021
2014-08-01,Florida,15979383,9565595,8961454,604141
2014-08-01,Georgia,7664292,4748449,4410760,337689
2014-08-01,Hawaii,1080863,665410,637809,27601
2014-08-01,Idaho,1228689,776184,744890,31294
2014-08-01,Illinois,10052122,6505638,6063338,442300
2014-08-01,Indiana,5097721,3233023,3044917,188106
2014-08-01,Iowa,2422082,1702696,1630943,71753
2014-08-01,Kansas,2195906,1494750,1428614,66136
2014-08-01,Kentucky,3429552,1997344,1876646,120698
2014-08-01,Louisiana,3549310,2157540,2015914,141626
2014-08-01,Maine,1089878,696893,659284,37609
2014-08-01,Maryland,4674244,3126888,2950361,176527
2014-08-01,Massachusetts,5469190,3580091,3377865,202226
2014-08-01,Michigan,7864342,4761597,4429841,331756
2014-08-01,Minnesota,4256649,2985812,2863719,122093
2014-08-01,Mississippi,2273462,1241705,1148638,93067
2014-08-01,Missouri,4715848,3035691,2854353,181338
2014-08-01,Montana,807887,513167,489580,23587
2014-08-01,Nebraska,1432717,1011897,979646,32251
2014-08-01,Nevada,2196560,1381318,1271663,109655
2014-08-01,Ohio,9102012,5726029,5404261,321768
2014-08-01,Oklahoma,2948530,1798094,1722930,75164
2014-08-01,Oregon,3168976,1955313,1828180,127133
2014-08-01,Pennsylvania,10209072,6382229,6016409,365820
2014-08-01,Tennessee,5115278,3040492,2840279,200213
2014-08-01,Texas,20135749,13036080,12373428,662652
2014-08-01,Utah,2103664,1418964,1367794,51170
2014-08-01,Vermont,513704,348863,334843,14020
2014-08-01,Virginia,6448300,4258573,4043065,215508
2014-08-01,Washington,5532478,3503437,3298328,205109
2014-08-01,Wisconsin,4529784,3081114,2922633,158481
2014-08-01,Wyoming,449719,303393,289922,13471
2014-09-01,Alabama,3787004,2162865,2021615,141250
2014-09-01,Alaska,540851,364135,339845,24290
2014-09-01,Arizona,5198387,3138216,2929099,209117
2014-09-01,Arkansas,2289722,1330805,1255079,75726
2014-09-01,California,30034552,18735234,17369795,1365439
2014-09-01,Colorado,4159972,2808186,2682837,125349
2014-09-01,Connecticut,2869566,1897546,1776030,121516
2014-09-01,Delaware,739121,455690,431084,24606
2014-09-01,Florida,16009146,9577872,8980727,597145
2014-09-01,Georgia,7674134,4748685,4416904,331781
2014-09-01,Hawaii,1081629,666039,638866,27173
2014-09-01,Idaho,1230456,777919,746662,31257
2014-09-01,Illinois,10053396,6506203,6073599,432604
2014-09-01,Indiana,5100064,3237161,3050703,186458
2014-09-01,Iowa,2423284,1704150,1633086,71064
2014-09-01,Kansas,2197146,1494751,1429313,65438
2014-09-01,Kentucky,3431380,1993235,1876403,116832
2014-09-01,Louisiana,3551647,2166638,2021167,145471
2014-09-01,Maine,1090164,696540,659456,37084
2014-09-01,Maryland,4677269,3129613,2954694,174919
2014-09-01,Massachusetts,5473295,3590220,3390213,200007
2014-09-01,Michigan,7867142,4763243,4439814,323429
2014-09-01,Minnesota,4259600,2988734,2868043,120691
2014-09-01,Mississippi,2274286,1241870,1150211,91659
2014-09-01,Missouri,4718289,3039992,2860932,179060
2014-09-01,Montana,808672,513367,489884,23483
2014-09-01,Nebraska,1433715,1012111,980321,31790
2014-09-01,Nevada,2200552,1383739,1275356,108383
2014-09-01,Ohio,9105659,5735306,5419107,316199
2014-09-01,Oklahoma,2951189,1802468,1728111,74357
2014-09-01,Oregon,3173535,1958331,1832536,125795
2014-09-01,Pennsylvania,10211398,6387480,6026772,360708
2014-09-01,Tennessee,5120089,3045235,2846964,198271
2014-09-01,Texas,20174227,13050337,12398563,651774
2014-09-01,Utah,2107319,1422899,1371451,51448
2014-09-01,Vermont,513902,348966,334944,14022
2014-09-01,Virginia,6453876,4255711,4042931,212780
2014-09-01,Washington,5541439,3513688,3308405,205283
2014-09-01,Wisconsin,4531863,3084262,2928668,155594
2014-09-01,Wyoming,449959,303460,290127,13333
2014-10-01,Alabama,3788819,2162682,2023989,138693
2014-10-01,Alaska,541178,363829,340035,23794
2014-10-01,Arizona,5207290,3147375,2939396,207979
2014-10-01,Arkansas,2291014,1333104,1258078,75026
2014-10-01,California,30065291,18760622,17413762,1346860
2014-10-01,Colorado,4168412,2810762,2688227,122535
2014-10-01,Connecticut,2870249,1899432,1779699,119733
2014-10-01,Delaware,739991,456448,432329,24119
2014-10-01,Florida,16038837,9586098,8996931,589167
2014-10-01,Georgia,7684016,4747387,4422548,324839
2014-10-01,Hawaii,1082361,666609,639868,26741
2014-10-01,Idaho,1232213,779643,748640,31003
2014-10-01,Illinois,10054590,6504445,6081936,422509
2014-10-01,Indiana,5102418,3241264,3056667,184597
2014-10-01,Iowa,2424508,1705341,1635343,69998
2014-10-01,Kansas,2198312,1494702,1429984,64718
2014-10-01,Kentucky,3433119,1989610,1876386,113224
2014-10-01,Louisiana,3553983,2172611,2024800,147811
2014-10-01,Maine,1090411,696052,659532,36520
2014-10-01,Maryland,4680246,3131723,2958485,173238
2014-10-01,Massachusetts,5477355,3598416,3401460,196956
2014-10-01,Michigan,7869825,4763011,4448646,314365
2014-10-01,Minnesota,4262535,2990545,2871022,119523
2014-10-01,Mississippi,2275099,1242310,1152316,89994
2014-10-01,Missouri,4720710,3044054,2867348,176706
2014-10-01,Montana,809429,513525,490239,23286
2014-10-01,Nebraska,1434661,1012100,980917,31183
2014-10-01,Nevada,2204509,1385877,1278928,106949
2014-10-01,Ohio,9109182,5740022,5429896,310126
2014-10-01,Oklahoma,2953863,1806752,1733263,73489
2014-10-01,Oregon,3178139,1960334,1836625,123709
2014-10-01,Pennsylvania,10213628,6393131,6036120,357011
2014-10-01,Tennessee,5124892,3049884,2854160,195724
2014-10-01,Texas,20212629,13058380,12420918,637462
2014-10-01,Utah,2110926,1426616,1375102,51514
2014-10-01,Vermont,514074,348999,335064,13935
2014-10-01,Virginia,6459517,4252749,4042841,209908
2014-10-01,Washington,5550339,3521452,3316839,204613
2014-10-01,Wisconsin,4533838,3086117,2933222,152895
2014-10-01,Wyoming,450204,303319,290316,13003
2014-11-01,Alabama,3790314,2162723,2026910,135813
2014-11-01,Alaska,541342,363530,340262,23268
2014-11-01,Arizona,5215731,3153926,2947951,205975
2014-11-01,Arkansas,2292159,1334565,1260362,74203
2014-11-01,California,30094154,18775765,17451977,1323788
2014-11-01,Colorado,4176464,2811968,2691945,120023
2014-11-01,Connecticut,2870767,1900520,1783052,117468
2014-11-01,Delaware,740761,457025,433436,23589
2014-11-01,Florida,16066665,9588482,9008617,579865
2014-11-01,Georgia,7693498,4744010,4426681,317329
2014-11-01,Hawaii,1082878,667024,640728,26296
2014-11-01,Idaho,1233894,781294,750676,30618
2014-11-01,Illinois,10055199,6498807,6086861,411946
2014-11-01,Indiana,5104411,3243507,3061704,181803
2014-11-01,Iowa,2425484,1705842,1637265,68577
2014-11-01,Kansas,2199173,1494484,1430308,64176
2014-11-01,Kentucky,3434586,1986279,1876349,109930
2014-11-01,Louisiana,3555955,2174782,2026322,148460
2014-11-01,Maine,1090608,695222,659414,35808
2014-11-01,Maryland,4682816,3132751,2961418,171333
2014-11-01,Massachusetts,5481096,3602853,3409823,193030
2014-11-01,Michigan,7871987,4759649,4455559,304090
2014-11-01,Minnesota,4265112,2991030,2872957,118073
2014-11-01,Mississippi,2275694,1243119,1155075,88044
2014-11-01,Missouri,4722848,3047123,2872738,174385
2014-11-01,Montana,810110,513751,490786,22965
2014-11-01,Nebraska,1435461,1011615,981159,30456
2014-11-01,Nevada,2208283,1387386,1282078,105308
2014-11-01,Ohio,9111983,5738510,5434432,304078
2014-11-01,Oklahoma,2956288,1810599,1737920,72679
2014-11-01,Oregon,3182459,1960742,1840037,120705
2014-11-01,Pennsylvania,10215030,6396471,6042204,354267
2014-11-01,Tennessee,5129292,3052910,2860333,192577
2014-11-01,Texas,20249578,13057664,12436708,620956
2014-11-01,Utah,2114402,1429762,1378419,51343
2014-11-01,Vermont,514237,348937,335207,13730
2014-11-01,Virginia,6463917,4249011,4042113,206898
2014-11-01,Washington,5558599,3525535,3323022,202513
2014-11-01,Wisconsin,4535533,3085929,2935868,150061
2014-11-01,Wyoming,450360,302997,290435,12562
2014-12-01,Alabama,3791522,2163996,2030603,133393
2014-12-01,Alaska,541292,363338,340470,22868
2014-12-01,Arizona,5223652,3158664,2954989,203675
2014-12-01,Arkansas,2293069,1335449,1261924,73525
2014-12-01,California,30119935,18785368,17484592,1300776
2014-12-01,Colorado,4183994,2812244,2694387,117857
2014-12-01,Connecticut,2871003,1901233,1786010,115223
2014-12-01,Delaware,741480,457575,434437,23138
2014-12-01,Florida,16093012,9588236,9017099,571137
2014-12-01,Georgia,7702197,4740275,4429609,310666
2014-12-01,Hawaii,1083135,667398,641508,25890
2014-12-01,Idaho,1235428,783031,752712,30319
2014-12-01,Illinois,10055054,6492057,6089359,402698
2014-12-01,Indiana,5106016,3243867,3065804,178063
2014-12-01,Iowa,2426356,1705596,1638437,67159
2014-12-01,Kansas,2199786,1494280,1430176,64104
2014-12-01,Kentucky,3435694,1983555,1876205,107350
2014-12-01,Louisiana,3557592,2174213,2026255,147958
2014-12-01,Maine,1090665,694247,659254,34993
2014-12-01,Maryland,4684903,3133445,2963878,169567
2014-12-01,Massachusetts,5484347,3603769,3414729,189040
2014-12-01,Michigan,7873568,4754985,4461008,293977
2014-12-01,Minnesota,4267379,2991295,2874858,116437
2014-12-01,Mississippi,2276091,1244773,1158482,86291
2014-12-01,Missouri,4724514,3049812,2877073,172739
2014-12-01,Montana,810716,514253,491643,22610
2014-12-01,Nebraska,1436119,1010872,980970,29902
2014-12-01,Nevada,2211859,1388719,1284896,103823
2014-12-01,Ohio,9114058,5732637,5433117,299520
2014-12-01,Oklahoma,2958392,1814538,1742065,72473
2014-12-01,Oregon,3186524,1960168,1842745,117423
2014-12-01,Pennsylvania,10215558,6397976,6045102,352874
2014-12-01,Tennessee,5133124,3054766,2865175,189591
2014-12-01,Texas,20284449,13051833,12446054,605779
2014-12-01,Utah,2117704,1432638,1381478,51160
2014-12-01,Vermont,514348,348838,335378,13460
2014-12-01,Virginia,6467759,4245503,4041135,204368
2014-12-01,Washington,5566204,3527147,3327558,199589
2014-12-01,Wisconsin,4536913,3084481,2937011,147470
2014-12-01,Wyoming,450507,302631,290474,12157
2015-01-01,Alabama,3792717,2166771,2034786,131985
2015-01-01,Alaska,541541,363226,340538,22688
2015-01-01,Arizona,5231632,3162393,2961081,201312
2015-01-01,Arkansas,2293962,1336169,1263086,73083
2015-01-01,California,30147095,18794302,17513360,1280942
2015-01-01,Colorado,4191682,2812740,2696305,116435
2015-01-01,Connecticut,2871234,1901701,1788370,113331
2015-01-01,Delaware,742189,458168,435330,22838
2015-01-01,Florida,16119608,9588873,9024705,564168
2015-01-01,Georgia,7711426,4737642,4431983,305659
2015-01-01,Hawaii,1083804,667875,642329,25546
2015-01-01,Idaho,1236985,785010,754789,30221
2015-01-01,Illinois,10054926,6487628,6091476,396152
2015-01-01,Indiana,5107398,3243609,3069876,173733
2015-01-01,Iowa,2427052,1704798,1638800,65998
2015-01-01,Kansas,2200557,1494068,1429606,64462
2015-01-01,Kentucky,3436806,1981477,1875886,105591
2015-01-01,Louisiana,3559303,2172224,2025344,146880
2015-01-01,Maine,1090698,693272,659092,34180
2015-01-01,Maryland,4687116,3134640,2966550,168090
2015-01-01,Massachusetts,5487464,3602272,3416690,185582
2015-01-01,Michigan,7874799,4751121,4465483,285638
2015-01-01,Minnesota,4269426,2992386,2877365,115021
2015-01-01,Mississippi,2276579,1247332,1162332,85000
2015-01-01,Missouri,4726122,3052395,2880669,171726
2015-01-01,Montana,811282,515033,492735,22298
2015-01-01,Nebraska,1436792,1010079,980427,29652
2015-01-01,Nevada,2215425,1390075,1287564,102511
2015-01-01,Ohio,9115824,5725314,5428302,297012
2015-01-01,Oklahoma,2960645,1819030,1745819,73211
2015-01-01,Oregon,3190400,1959718,1845083,114635
2015-01-01,Pennsylvania,10215735,6399411,6046534,352877
2015-01-01,Tennessee,5136969,3056389,2869136,187253
2015-01-01,Texas,20320317,13045727,12451402,594325
2015-01-01,Utah,2120965,1435490,1384452,51038
2015-01-01,Vermont,514435,348721,335527,13194
2015-01-01,Virginia,6472206,4242711,4040145,202566
2015-01-01,Washington,5574083,3528211,3331515,196696
2015-01-01,Wisconsin,4538023,3082864,2937399,145465
2015-01-01,Wyoming,450619,302350,290427,11923
2015-02-01,Alabama,3793390,2170601,2038928,131673
2015-02-01,Alaska,541749,363134,340415,22719
2015-02-01,Arizona,5238741,3165741,2966433,199308
2015-02-01,Arkansas,2294489,1336952,1264167,72785
2015-02-01,California,30170177,18804573,17539526,1265047
2015-02-01,Colorado,4199004,2813690,2698184,115506
2015-02-01,Connecticut,2871089,1901730,1789810,111920
2015-02-01,Delaware,742821,458835,436141,22694
2015-02-01,Florida,16143433,9592040,9032822,559218
2015-02-01,Georgia,7719736,4736239,4433957,302282
2015-02-01,Hawaii,1084437,668343,643165,25178
2015-02-01,Idaho,1238342,787221,756853,30368
2015-02-01,Illinois,10053295,6487282,6094125,393157
2015-02-01,Indiana,5108171,3243958,3074662,169296
2015-02-01,Iowa,2427387,1703904,1638715,65189
2015-02-01,Kansas,2201056,1493764,1428745,65019
2015-02-01,Kentucky,3437547,1979937,1875247,104690
2015-02-01,Louisiana,3560608,2169594,2024043,145551
2015-02-01,Maine,1090572,692242,658825,33417
2015-02-01,Maryland,4688804,3136563,2969832,166731
2015-02-01,Massachusetts,5489882,3599631,3416731,182900
2015-02-01,Michigan,7874962,4748842,4469325,279517
2015-02-01,Minnesota,4271024,2994638,2880470,114168
2015-02-01,Mississippi,2276813,1250514,1166324,84190
2015-02-01,Missouri,4727116,3054756,2883759,170997
2015-02-01,Montana,811751,515924,493824,22100
2015-02-01,Nebraska,1437272,1009386,979687,29699
2015-02-01,Nevada,2218759,1391547,1290189,101358
2015-02-01,Ohio,9116352,5719068,5423145,295923
2015-02-01,Oklahoma,2962478,1823885,1749030,74855
2015-02-01,Oregon,3193924,1960323,1847488,112835
2015-02-01,Pennsylvania,10214411,6402054,6048226,353828
2015-02-01,Tennessee,5140220,3058800,2873342,185458
2015-02-01,Texas,20353602,13042678,12455072,587606
2015-02-01,Utah,2124081,1438477,1387444,51033
2015-02-01,Vermont,514456,348536,335570,12966
2015-02-01,Virginia,6476073,4240767,4039464,201303
2015-02-01,Washington,5581414,3530246,3335608,194638
2015-02-01,Wisconsin,4538575,3081614,2937529,144085
2015-02-01,Wyoming,450732,302209,290287,11922
2015-03-01,Alabama,3794218,2174960,2042936,132024
2015-03-01,Alaska,541763,363053,340222,22831
2015-03-01,Arizona,5246030,3169469,2971786,197683
2015-03-01,Arkansas,2295183,1337920,1265637,72283
2015-03-01,California,30192273,18816299,17566611,1249688
2015-03-01,Colorado,4206284,2815196,2700859,114337
2015-03-01,Connecticut,2871016,1900978,1790269,110709
2015-03-01,Delaware,743467,459628,437007,22621
2015-03-01,Florida,16167449,9598497,9043681,554816
2015-03-01,Georgia,7727931,4735865,4436481,299384
2015-03-01,Hawaii,1084597,668758,644078,24680
2015-03-01,Idaho,1239788,789517,758877,30640
2015-03-01,Illinois,10052133,6491517,6098798,392719
2015-03-01,Indiana,5109371,3245723,3080816,164907
2015-03-01,Iowa,2428014,1703231,1638687,64544
2015-03-01,Kansas,2201561,1493443,1428091,65352
2015-03-01,Kentucky,3438481,1978823,1874526,104297
2015-03-01,Louisiana,3561944,2166522,2022881,143641
2015-03-01,Maine,1090565,691110,658472,32638
2015-03-01,Maryland,4690491,3139033,2974094,164939
2015-03-01,Massachusetts,5492682,3597341,3416770,180571
2015-03-01,Michigan,7875796,4748857,4473859,274998
2015-03-01,Minnesota,4272956,2998186,2884337,113849
2015-03-01,Mississippi,2277021,1253923,1170356,83567
2015-03-01,Missouri,4728406,3056791,2887036,169755
2015-03-01,Montana,812295,516734,494730,22004
2015-03-01,Nebraska,1437833,1009054,979132,29922
2015-03-01,Nevada,2222091,1393136,1292980,100156
2015-03-01,Ohio,9117696,5715533,5421129,294404
2015-03-01,Oklahoma,2964358,1828473,1751584,76889
2015-03-01,Oregon,3197709,1962380,1850584,111796
2015-03-01,Pennsylvania,10213980,6406408,6052263,354145
2015-03-01,Tennessee,5143697,3062426,2878956,183470
2015-03-01,Texas,20386355,13044962,12461125,583837
2015-03-01,Utah,2127259,1441814,1390696,51118
2015-03-01,Vermont,514531,348217,335461,12756
2015-03-01,Virginia,6479492,4239843,4040318,199525
2015-03-01,Washington,5588657,3533904,3340601,193303
2015-03-01,Wisconsin,4539542,3080867,2938085,142782
2015-03-01,Wyoming,450837,302218,290102,12116
2015-04-01,Alabama,3795273,2170166,2037552,132614
2015-04-01,Alaska,541860,362975,340096,22879
2015-04-01,Arizona,5253623,3174046,2977647,196399
2015-04-01,Arkansas,2296029,1338983,1267673,71310
2015-04-01,California,30216829,18826398,17594659,1231739
2015-04-01,Colorado,4213837,2817304,2704794,112510
2015-04-01,Connecticut,2871086,1899181,1789732,109449
2015-04-01,Delaware,744119,460528,437998,22530
2015-04-01,Florida,16192418,9607811,9058084,549727
2015-04-01,Georgia,7736619,4735991,4439804,296187
2015-04-01,Hawaii,1084940,669187,645104,24083
2015-04-01,Idaho,1241296,791724,760809,30915
2015-04-01,Illinois,10051577,6499013,6106082,392931
2015-04-01,Indiana,5110758,3249285,3088493,160792
2015-04-01,Iowa,2428690,1702323,1638444,63879
2015-04-01,Kansas,2202145,1493226,1428104,65122
2015-04-01,Kentucky,3439530,1977936,1873917,104019
2015-04-01,Louisiana,3563437,2162787,2021790,140997
2015-04-01,Maine,1090579,689909,658087,31822
2015-04-01,Maryland,4692382,3141417,2978798,162619
2015-04-01,Massachusetts,5495719,3595870,3417689,178181
2015-04-01,Michigan,7876897,4750757,4479763,270994
2015-04-01,Minnesota,4275054,3002331,2888543,113788
2015-04-01,Mississippi,2277330,1257058,1174188,82870
2015-04-01,Missouri,4729926,3058205,2890940,167265
2015-04-01,Montana,812851,517282,495305,21977
2015-04-01,Nebraska,1438471,1009259,979055,30204
2015-04-01,Nevada,2225535,1394785,1295937,98848
2015-04-01,Ohio,9119310,5713945,5422656,291289
2015-04-01,Oklahoma,2966457,1831977,1753289,78688
2015-04-01,Oregon,3201589,1965819,1854638,111181
2015-04-01,Pennsylvania,10213906,6412274,6059046,353228
2015-04-01,Tennessee,5147408,3066692,2885754,180938
2015-04-01,Texas,20420653,13052347,12471167,581180
2015-04-01,Utah,2130584,1445478,1394232,51246
2015-04-01,Vermont,514616,347766,335199,12567
2015-04-01,Virginia,6483301,4239190,4042765,196425
2015-04-01,Washington,5596195,3539114,3346743,192371
2015-04-01,Wisconsin,4540646,3080496,2939372,141124
2015-04-01,Wyoming,450938,302299,289899,12400
2015-05-01,Alabama,3796534,2164519,2031470,133049
2015-05-01,Alaska,542036,362798,339977,22821
2015-05-01,Arizona,5261501,3179024,2983595,195429
2015-05-01,Arkansas,2296996,1339839,1269993,69846
2015-05-01,California,30242644,18830333,17620363,1209970
2015-05-01,Colorado,4221620,2819533,2709579,109954
2015-05-01,Connecticut,2871419,1896379,1788339,108040
2015-05-01,Delaware,744838,461456,439061,22395
2015-05-01,Florida,16218527,9618147,9074570,543577
2015-05-01,Georgia,7745959,4735398,4442925,292473
2015-05-01,Hawaii,1085320,669614,646142,23472
2015-05-01,Idaho,1242885,793675,762546,31129
2015-05-01,Illinois,10051696,6506301,6114433,391868
2015-05-01,Indiana,5112558,3254041,3096911,157130
2015-05-01,Iowa,2429607,1700817,1637661,63156
2015-05-01,Kansas,2202959,1493024,1428789,64235
2015-05-01,Kentucky,3440841,1976817,1873250,103567
2015-05-01,Louisiana,3565205,2158261,2020294,137967
2015-05-01,Maine,1090689,688694,657703,30991
2015-05-01,Maryland,4694501,3142923,2982840,160083
2015-05-01,Massachusetts,5499163,3594220,3418656,175564
2015-05-01,Michigan,7878551,4753081,4486713,266368
2015-05-01,Minnesota,4277518,3005863,2892071,113792
2015-05-01,Mississippi,2277791,1259289,1177336,81953
2015-05-01,Missouri,4731896,3058587,2895171,163416
2015-05-01,Montana,813497,517493,495499,21994
2015-05-01,Nebraska,1439238,1009818,979369,30449
2015-05-01,Nevada,2229088,1396200,1298740,97460
2015-05-01,Ohio,9121634,5712467,5426068,286399
2015-05-01,Oklahoma,2968807,1833635,1753826,79809
2015-05-01,Oregon,3205720,1970139,1859558,110581
2015-05-01,Pennsylvania,10214662,6417950,6066953,350997
2015-05-01,Tennessee,5151480,3070773,2892935,177838
2015-05-01,Texas,20455987,13062363,12483045,579318
2015-05-01,Utah,2134048,1449095,1397733,51362
2015-05-01,Vermont,514728,347189,334785,12404
2015-05-01,Virginia,6487589,4237686,4045613,192073
2015-05-01,Washington,5604203,3544965,3353329,191636
2015-05-01,Wisconsin,4542174,3080195,2941178,139017
2015-05-01,Wyoming,451154,302311,289650,12661
2015-06-01,Alabama,3798019,2157472,2024484,132988
2015-06-01,Alaska,542351,362477,339787,22690
2015-06-01,Arizona,5269624,3183495,2988875,194620
2015-06-01,Arkansas,2298077,1340124,1272125,67999
2015-06-01,California,30269968,18825613,17640900,1184713
2015-06-01,Colorado,4229782,2821315,2714525,106790
2015-06-01,Connecticut,2871838,1892772,1786301,106471
2015-06-01,Delaware,745615,462330,440105,22225
2015-06-01,Florida,16245473,9627791,9091449,536342
2015-06-01,Georgia,7755736,4733228,4444943,288285
2015-06-01,Hawaii,1086160,669943,647039,22904
2015-06-01,Idaho,1244553,795165,763973,31192
2015-06-01,Illinois,10052135,6510435,6121275,389160
2015-06-01,Indiana,5114416,3258941,3105042,153899
2015-06-01,Iowa,2430604,1698838,1636400,62438
2015-06-01,Kansas,2204047,1492703,1429837,62866
2015-06-01,Kentucky,3442383,1975226,1872397,102829
2015-06-01,Louisiana,3567129,2152853,2017960,134893
2015-06-01,Maine,1090869,687442,657285,30157
2015-06-01,Maryland,4697090,3142915,2985301,157614
2015-06-01,Massachusetts,5502715,3591258,3418552,172706
2015-06-01,Michigan,7880361,4754815,4494018,260797
2015-06-01,Minnesota,4280102,3007688,2894004,113684
2015-06-01,Mississippi,2278424,1260313,1179455,80858
2015-06-01,Missouri,4734012,3057937,2899170,158767
2015-06-01,Montana,814167,517470,495452,22018
2015-06-01,Nebraska,1440080,1010488,979862,30626
2015-06-01,Nevada,2232794,1397085,1301068,96017
2015-06-01,Ohio,9124155,5709322,5428877,280445
2015-06-01,Oklahoma,2971286,1833226,1753090,80136
2015-06-01,Oregon,3209931,1974615,1865067,109548
2015-06-01,Pennsylvania,10215636,6421791,6073881,347910
2015-06-01,Tennessee,5155812,3073789,2899547,174242
2015-06-01,Texas,20492589,13072586,12493882,578704
2015-06-01,Utah,2137565,1452297,1400856,51441
2015-06-01,Vermont,514899,346525,334255,12270
2015-06-01,Virginia,6493089,4234686,4047714,186972
2015-06-01,Washington,5612692,3550112,3359187,190925
2015-06-01,Wisconsin,4543797,3079718,2943053,136665
2015-06-01,Wyoming,451324,302119,289316,12803
2015-07-01,Alabama,3799477,2149701,2017218,132483
2015-07-01,Alaska,542488,362134,339558,22576
2015-07-01,Arizona,5277926,3187178,2993303,193875
2015-07-01,Arkansas,2299219,1339927,1273942,65985
2015-07-01,California,30296923,18816836,17658045,1158791
2015-07-01,Colorado,4237868,2823037,2719557,103480
2015-07-01,Connecticut,2872304,1889106,1784137,104969
2015-07-01,Delaware,746397,463176,441109,22067
2015-07-01,Florida,16272655,9637406,9108581,528825
2015-07-01,Georgia,7764701,4730359,4446220,284139
2015-07-01,Hawaii,1086606,670277,647849,22428
2015-07-01,Idaho,1246242,796345,765212,31133
2015-07-01,Illinois,10052479,6511967,6125787,386180
2015-07-01,Indiana,5116564,3264081,3112811,151270
2015-07-01,Iowa,2431720,1697034,1635142,61892
2015-07-01,Kansas,2205000,1492465,1431085,61380
2015-07-01,Kentucky,3443963,1974094,1871994,102100
2015-07-01,Louisiana,3569129,2146855,2014908,131947
2015-07-01,Maine,1091034,686253,656874,29379
2015-07-01,Maryland,4699564,3141732,2986335,155397
2015-07-01,Massachusetts,5506549,3587263,3417329,169934
2015-07-01,Michigan,7882629,4756256,4501568,254688
2015-07-01,Minnesota,4282892,3008042,2894625,113417
2015-07-01,Mississippi,2278975,1260827,1180794,80033
2015-07-01,Missouri,4736104,3056934,2902982,153952
2015-07-01,Montana,814872,517499,495460,22039
2015-07-01,Nebraska,1440957,1011241,980537,30704
2015-07-01,Nevada,2236496,1397589,1302948,94641
2015-07-01,Ohio,9127172,5704862,5429949,274913
2015-07-01,Oklahoma,2973610,1831607,1751708,79899
2015-07-01,Oregon,3214297,1979176,1871082,108094
2015-07-01,Pennsylvania,10217178,6424397,6079630,344767
2015-07-01,Tennessee,5160228,3075793,2905360,170433
2015-07-01,Texas,20528677,13083798,12503348,580450
2015-07-01,Utah,2141186,1455143,1403612,51531
2015-07-01,Vermont,515055,345899,333746,12153
2015-07-01,Virginia,6497687,4231177,4049219,181958
2015-07-01,Washington,5621018,3554656,3363984,190672
2015-07-01,Wisconsin,4545633,3079639,2945129,134510
2015-07-01,Wyoming,451543,301719,288919,12800
2015-08-01,Alabama,3801201,2142296,2010491,131805
2015-08-01,Alaska,542917,361851,339307,22544
2015-08-01,Arizona,5287701,3190286,2997349,192937
2015-08-01,Arkansas,2300521,1339528,1275545,63983
2015-08-01,California,30322827,18810236,17674840,1135396
2015-08-01,Colorado,4245694,2825443,2724952,100491
2015-08-01,Connecticut,2872668,1886215,1782474,103741
2015-08-01,Delaware,747145,464036,442091,21945
2015-08-01,Florida,16304520,9648341,9126443,521898
2015-08-01,Georgia,7775261,4728148,4447634,280514
2015-08-01,Hawaii,1087442,670776,648736,22040
2015-08-01,Idaho,1248753,797404,766369,31035
2015-08-01,Illinois,10052472,6513391,6128765,384626
2015-08-01,Indiana,5119646,3269717,3120334,149383
2015-08-01,Iowa,2432799,1696005,1634411,61594
2015-08-01,Kansas,2206043,1492607,1432469,60138
2015-08-01,Kentucky,3445559,1974414,1872627,101787
2015-08-01,Louisiana,3570825,2141096,2011545,129551
2015-08-01,Maine,1091444,685224,656502,28722
2015-08-01,Maryland,4701204,3140095,2986765,153330
2015-08-01,Massachusetts,5510088,3583181,3415653,167528
2015-08-01,Michigan,7886210,4758144,4509543,248601
2015-08-01,Minnesota,4286218,3007887,2894759,113128
2015-08-01,Mississippi,2279661,1261680,1181932,79748
2015-08-01,Missouri,4738008,3056343,2906823,149520
2015-08-01,Montana,815722,517775,495684,22091
2015-08-01,Nebraska,1442076,1012103,981413,30690
2015-08-01,Nevada,2240387,1398013,1304599,93414
2015-08-01,Ohio,9130533,5700670,5429438,271232
2015-08-01,Oklahoma,2975237,1829635,1750196,79439
2015-08-01,Oregon,3220392,1983912,1877482,106430
2015-08-01,Pennsylvania,10219328,6426714,6084814,341900
2015-08-01,Tennessee,5165233,3077329,2910795,166534
2015-08-01,Texas,20562773,13096567,12512227,584340
2015-08-01,Utah,2145803,1457886,1406235,51651
2015-08-01,Vermont,515083,345384,333349,12035
2015-08-01,Virginia,6502056,4227968,4050212,177756
2015-08-01,Washington,5631123,3559448,3368239,191209
2015-08-01,Wisconsin,4547707,3080585,2947761,132824
2015-08-01,Wyoming,451558,301250,288478,12772
2015-09-01,Alabama,3802943,2136055,2004972,131083
2015-09-01,Alaska,543357,361622,339036,22586
2015-09-01,Arizona,5297456,3193508,3002093,191415
2015-09-01,Arkansas,2301817,1339273,1277195,62078
2015-09-01,California,30348765,18810658,17695331,1115327
2015-09-01,Colorado,4253521,2829407,2731343,98064
2015-09-01,Connecticut,2873060,1884305,1781625,102680
2015-09-01,Delaware,747902,464940,443116,21824
2015-09-01,Florida,16336389,9661738,9146394,515344
2015-09-01,Georgia,7785882,4727779,4450420,277359
2015-09-01,Hawaii,1088175,671504,649824,21680
2015-09-01,Idaho,1251267,798413,767529,30884
2015-09-01,Illinois,10052588,6517227,6132095,385132
2015-09-01,Indiana,5122740,3276546,3128292,148254
2015-09-01,Iowa,2433958,1696155,1634605,61550
2015-09-01,Kansas,2207110,1493272,1433984,59288
2015-09-01,Kentucky,3447166,1976725,1874730,101995
2015-09-01,Louisiana,3572509,2136562,2008611,127951
2015-09-01,Maine,1091811,684534,656347,28187
2015-09-01,Maryland,4702765,3138851,2987744,151107
2015-09-01,Massachusetts,5513606,3580147,3414849,165298
2015-09-01,Michigan,7889755,4761803,4518849,242954
2015-09-01,Minnesota,4289567,3008335,2895504,112831
2015-09-01,Mississippi,2280319,1263353,1183427,79926
2015-09-01,Missouri,4739901,3056675,2911038,145637
2015-09-01,Montana,816595,518275,496124,22151
2015-09-01,Nebraska,1443217,1013086,982465,30621
2015-09-01,Nevada,2244284,1398568,1306362,92206
2015-09-01,Ohio,9133856,5698995,5428901,270094
2015-09-01,Oklahoma,2976904,1828048,1749022,79026
2015-09-01,Oregon,3226425,1989069,1884395,104674
2015-09-01,Pennsylvania,10221392,6429981,6090516,339465
2015-09-01,Tennessee,5170211,3079250,2916889,162361
2015-09-01,Texas,20597035,13111812,12523886,587926
2015-09-01,Utah,2150498,1460802,1409096,51706
2015-09-01,Vermont,515145,345015,333114,11901
2015-09-01,Virginia,6506333,4225421,4050900,174521
2015-09-01,Washington,5641221,3565425,3373358,192067
2015-09-01,Wisconsin,4549782,3082966,2951433,131533
2015-09-01,Wyoming,451548,300853,288034,12819
2015-10-01,Alabama,3804782,2135797,2005232,130565
2015-10-01,Alaska,543664,361498,338801,22697
2015-10-01,Arizona,5307253,3198236,3008840,189396
2015-10-01,Arkansas,2303143,1339813,1279410,60403
2015-10-01,California,30374660,18824385,17724466,1099919
2015-10-01,Colorado,4261240,2835695,2739313,96382
2015-10-01,Connecticut,2873493,1883557,1781801,101756
2015-10-01,Delaware,748677,465959,444262,21697
2015-10-01,Florida,16368317,9679856,9170460,509396
2015-10-01,Georgia,7796741,4730976,4456067,274909
2015-10-01,Hawaii,1088651,672548,651209,21339
2015-10-01,Idaho,1253815,799645,768912,30733
2015-10-01,Illinois,10052875,6526537,6138315,388222
2015-10-01,Indiana,5125961,3286118,3137870,148248
2015-10-01,Iowa,2435125,1697907,1636189,61718
2015-10-01,Kansas,2208046,1494509,1435575,58934
2015-10-01,Kentucky,3448760,1981083,1878391,102692
2015-10-01,Louisiana,3574214,2134141,2006830,127311
2015-10-01,Maine,1092251,684485,656665,27820
2015-10-01,Maryland,4704406,3139081,2990357,148724
2015-10-01,Massachusetts,5517301,3579727,3416493,163234
2015-10-01,Michigan,7893558,4769314,4530470,238844
2015-10-01,Minnesota,4293032,3010487,2897657,112830
2015-10-01,Mississippi,2281019,1265802,1185416,80386
2015-10-01,Missouri,4741883,3058618,2916130,142488
2015-10-01,Montana,817456,519031,496790,22241
2015-10-01,Nebraska,1444360,1014321,983776,30545
2015-10-01,Nevada,2248135,1399703,1308661,91042
2015-10-01,Ohio,9137348,5702644,5430886,271758
2015-10-01,Oklahoma,2978633,1827831,1748766,79065
2015-10-01,Oregon,3232588,1995491,1892430,103061
2015-10-01,Pennsylvania,10223727,6436573,6098624,337949
2015-10-01,Tennessee,5175203,3083238,2925088,158150
2015-10-01,Texas,20631313,13133423,12543363,590060
2015-10-01,Utah,2155154,1464379,1412676,51703
2015-10-01,Vermont,515203,344859,333101,11758
2015-10-01,Virginia,6510187,4224998,4052719,172279
2015-10-01,Washington,5651071,3573801,3380768,193033
2015-10-01,Wisconsin,4551926,3087350,2956772,130578
2015-10-01,Wyoming,451574,300679,287649,13030
2015-11-01,Alabama,3806253,2127937,1997567,130370
2015-11-01,Alaska,544206,361518,338641,22877
2015-11-01,Arizona,5316586,3204955,3017642,187313
2015-11-01,Arkansas,2304202,1341300,1282346,58954
2015-11-01,California,30399646,18852382,17762494,1089888
2015-11-01,Colorado,4268872,2844179,2748716,95463
2015-11-01,Connecticut,2873656,1883966,1782985,100981
2015-11-01,Delaware,749351,467051,445489,21562
2015-11-01,Florida,16398883,9702643,9198031,504612
2015-11-01,Georgia,7807629,4737800,4464354,273446
2015-11-01,Hawaii,1089768,673778,652737,21041
2015-11-01,Idaho,1256189,801327,770672,30655
2015-11-01,Illinois,10052412,6542574,6148366,394208
2015-11-01,Indiana,5128517,3298722,3149094,149628
2015-11-01,Iowa,2435921,1701237,1639252,61985
2015-11-01,Kansas,2208941,1496037,1437062,58975
2015-11-01,Kentucky,3450120,1986651,1883128,103523
2015-11-01,Louisiana,3575593,2133748,2006151,127597
2015-11-01,Maine,1092544,685200,657554,27646
2015-11-01,Maryland,4705748,3141039,2994693,146346
2015-11-01,Massachusetts,5520358,3582932,3421499,161433
2015-11-01,Michigan,7896257,4781113,4544206,236907
2015-11-01,Minnesota,4295969,3014550,2901181,113369
2015-11-01,Mississippi,2281545,1268447,1187642,80805
2015-11-01,Missouri,4743494,3062018,2921813,140205
2015-11-01,Montana,818218,519981,497588,22393
2015-11-01,Nebraska,1445350,1015747,985231,30516
2015-11-01,Nevada,2251878,1401563,1311565,89998
2015-11-01,Ohio,9139608,5713128,5437112,276016
2015-11-01,Oklahoma,2980187,1829254,1749506,79748
2015-11-01,Oregon,3238237,2003622,1901807,101815
2015-11-01,Pennsylvania,10224547,6446815,6108866,337949
2015-11-01,Tennessee,5179769,3090043,2935651,154392
2015-11-01,Texas,20664893,13162283,12571333,590950
2015-11-01,Utah,2159614,1468832,1417067,51765
2015-11-01,Vermont,515222,344913,333306,11607
2015-11-01,Virginia,6515086,4227185,4056317,170868
2015-11-01,Washington,5661008,3585005,3390788,194217
2015-11-01,Wisconsin,4553525,3093448,2963483,129965
2015-11-01,Wyoming,451526,300834,287332,13502
2015-12-01,Alabama,3807670,2133700,2003525,130175
2015-12-01,Alaska,544288,361660,338572,23088
2015-12-01,Arizona,5325671,3212709,3027448,185261
2015-12-01,Arkansas,2305251,1343071,1285465,57606
2015-12-01,California,30422273,18886247,17804150,1082097
2015-12-01,Colorado,4275910,2853704,2758635,95069
2015-12-01,Connecticut,2873797,1884911,1784830,100081
2015-12-01,Delaware,749992,468016,446642,21374
2015-12-01,Florida,16428472,9726210,9226214,499996
2015-12-01,Georgia,7817713,4745734,4473442,272292
2015-12-01,Hawaii,1089802,674900,654135,20765
2015-12-01,Idaho,1258579,803322,772741,30581
2015-12-01,Illinois,10051892,6561973,6160489,401484
2015-12-01,Indiana,5131265,3312477,3160677,151800
2015-12-01,Iowa,2436877,1705328,1643195,62133
2015-12-01,Kansas,2209453,1497255,1438196,59059
2015-12-01,Kentucky,3451246,1992217,1888233,103984
2015-12-01,Louisiana,3576862,2134220,2005983,128237
2015-12-01,Maine,1092829,686446,658891,27555
2015-12-01,Maryland,4706659,3143703,2999779,143924
2015-12-01,Massachusetts,5523499,3588507,3428990,159517
2015-12-01,Michigan,7899267,4795181,4558668,236513
2015-12-01,Minnesota,4298949,3019343,2905253,114090
2015-12-01,Mississippi,2281963,1270497,1189803,80694
2015-12-01,Missouri,4745022,3065552,2927136,138416
2015-12-01,Montana,818959,520883,498325,22558
2015-12-01,Nebraska,1446285,1017042,986563,30479
2015-12-01,Nevada,2255466,1403650,1314754,88896
2015-12-01,Ohio,9142204,5728436,5446975,281461
2015-12-01,Oklahoma,2981527,1831352,1750553,80799
2015-12-01,Oregon,3244022,2012522,1911765,100757
2015-12-01,Pennsylvania,10225852,6458131,6118943,339188
2015-12-01,Tennessee,5184152,3098156,2947080,151076
2015-12-01,Texas,20696766,13194306,12603859,590447
2015-12-01,Utah,2164055,1473799,1421939,51860
2015-12-01,Vermont,515234,345067,333646,11421
2015-12-01,Virginia,6517537,4230228,4060702,169526
2015-12-01,Washington,5669906,3597830,3402683,195147
2015-12-01,Wisconsin,4555288,3099913,2970598,129315
2015-12-01,Wyoming,451469,301280,287030,14250
2016-01-01,Alabama,3808871,2138981,2009234,129747
2016-01-01,Alaska,545180,361853,338581,23272
2016-01-01,Arizona,5334647,3220542,3037144,183398
2016-01-01,Arkansas,2306098,1344484,1288132,56352
2016-01-01,California,30446733,18917326,17843140,1074186
2016-01-01,Colorado,4283491,2862652,2767788,94864
2016-01-01,Connecticut,2873756,1885910,1787016,98894
2016-01-01,Delaware,750671,468654,447512,21142
2016-01-01,Florida,16458012,9746916,9252093,494823
2016-01-01,Georgia,7828808,4752310,4481522,270788
2016-01-01,Hawaii,1091566,675700,655187,20513
2016-01-01,Idaho,1260815,805322,774854,30468
2016-01-01,Illinois,10050720,6579309,6171894,407415
2016-01-01,Indiana,5133138,3324395,3170641,153754
2016-01-01,Iowa,2437374,1708738,1646660,62078
2016-01-01,Kansas,2210492,1497864,1438842,59022
2016-01-01,Kentucky,3452439,1996889,1893069,103820
2016-01-01,Louisiana,3578098,2134557,2005777,128780
2016-01-01,Maine,1092946,687907,660486,27421
2016-01-01,Maryland,4707890,3145817,3004440,141377
2016-01-01,Massachusetts,5525824,3594084,3436899,157185
2016-01-01,Michigan,7900971,4808822,4571961,236861
2016-01-01,Minnesota,4301291,3022956,2908419,114537
2016-01-01,Mississippi,2282454,1271520,1191631,79889
2016-01-01,Missouri,4746243,3068547,2931518,137029
2016-01-01,Montana,819668,521545,498852,22693
2016-01-01,Nebraska,1447160,1018062,987626,30436
2016-01-01,Nevada,2259069,1405588,1317857,87731
2016-01-01,Ohio,9143345,5743731,5457717,286014
2016-01-01,Oklahoma,2982968,1832930,1751007,81923
2016-01-01,Oregon,3249240,2020991,1921114,99877
2016-01-01,Pennsylvania,10225383,6467536,6126634,340902
2016-01-01,Tennessee,5188358,3105686,2957506,148180
2016-01-01,Texas,20729955,13224910,12635778,589132
2016-01-01,Utah,2168291,1478801,1426877,51924
2016-01-01,Vermont,515143,345245,334036,11209
2016-01-01,Virginia,6523006,4232843,4065106,167737
2016-01-01,Washington,5679860,3610474,3415138,195336
2016-01-01,Wisconsin,4556269,3105263,2977051,128212
2016-01-01,Wyoming,451394,301853,286696,15157
2016-02-01,Alabama,3810043,2143456,2014380,129076
2016-02-01,Alaska,545399,362043,338619,23424
2016-02-01,Arizona,5343405,3227960,3046025,181935
2016-02-01,Arkansas,2306995,1345263,1289972,55291
2016-02-01,California,30467943,18941962,17875645,1066317
2016-02-01,Colorado,4290525,2870218,2775432,94786
2016-02-01,Connecticut,2873720,1886939,1789442,97497
2016-02-01,Delaware,751256,468905,447972,20933
2016-02-01,Florida,16486036,9763853,9274276,489577
2016-02-01,Georgia,7838741,4756401,4487435,268966
2016-02-01,Hawaii,1091817,676234,655874,20360
2016-02-01,Idaho,1263122,807148,776822,30326
2016-02-01,Illinois,10049562,6590470,6180514,409956
2016-02-01,Indiana,5135638,3332857,3178012,154845
2016-02-01,Iowa,2438141,1710383,1648419,61964
2016-02-01,Kansas,2210999,1497789,1438855,58934
2016-02-01,Kentucky,3453453,2000307,1897358,102949
2016-02-01,Louisiana,3579257,2134491,2005278,129213
2016-02-01,Maine,1093136,689398,662178,27220
2016-02-01,Maryland,4708745,3146807,3007840,138967
2016-02-01,Massachusetts,5528649,3598443,3443921,154522
2016-02-01,Michigan,7903525,4820513,4582714,237799
2016-02-01,Minnesota,4304127,3024171,2909497,114674
2016-02-01,Mississippi,2282748,1271510,1192863,78647
2016-02-01,Missouri,4747477,3070971,2934662,136309
2016-02-01,Montana,820356,521898,499113,22785
2016-02-01,Nebraska,1448030,1018720,988278,30442
2016-02-01,Nevada,2262476,1407222,1320668,86554
2016-02-01,Ohio,9145329,5754850,5466498,288352
2016-02-01,Oklahoma,2984249,1833389,1750363,83026
2016-02-01,Oregon,3254767,2028181,1928738,99443
2016-02-01,Pennsylvania,10225863,6473118,6130276,342842
2016-02-01,Tennessee,5192499,3111657,2965602,146055
2016-02-01,Texas,20761195,13252003,12662766,589237
2016-02-01,Utah,2172793,1483530,1431601,51929
2016-02-01,Vermont,515166,345423,334400,11023
2016-02-01,Virginia,6525781,4234522,4068700,165822
2016-02-01,Washington,5688716,3621594,3426657,194937
2016-02-01,Wisconsin,4557711,3108750,2981909,126841
2016-02-01,Wyoming,451385,302351,286294,16057
2016-03-01,Alabama,3811375,2146821,2018777,128044
2016-03-01,Alaska,545610,362120,338578,23542
2016-03-01,Arizona,5352249,3234359,3053620,180739
2016-03-01,Arkansas,2308015,1345319,1290874,54445
2016-03-01,California,30489297,18959258,17901022,1058236
2016-03-01,Colorado,4297576,2876122,2781378,94744
2016-03-01,Connecticut,2873702,1888081,1792129,95952
2016-03-01,Delaware,751898,468851,448073,20778
2016-03-01,Florida,16514110,9777290,9292824,484466
2016-03-01,Georgia,7849068,4796311,4529480,266831
2016-03-01,Hawaii,1091983,676608,656314,20294
2016-03-01,Idaho,1265474,808719,778561,30158
2016-03-01,Illinois,10048662,6593404,6185600,407804
2016-03-01,Indiana,5138247,3337674,3183002,154672
2016-03-01,Iowa,2438939,1710050,1648133,61917
2016-03-01,Kansas,2211607,1496952,1438043,58909
2016-03-01,Kentucky,3454600,2002784,1901323,101461
2016-03-01,Louisiana,3580477,2133521,2004061,129460
2016-03-01,Maine,1093359,690787,663837,26950
2016-03-01,Maryland,4709564,3146772,3009911,136861
2016-03-01,Massachusetts,5531634,3601685,3450057,151628
2016-03-01,Michigan,7906243,4829629,4590535,239094
2016-03-01,Minnesota,4307033,3023055,2908446,114609
2016-03-01,Mississippi,2283174,1270710,1193455,77255
2016-03-01,Missouri,4748932,3072852,2936300,136552
2016-03-01,Montana,821079,521936,499124,22812
2016-03-01,Nebraska,1448888,1018855,988365,30490
2016-03-01,Nevada,2265948,1408473,1323153,85320
2016-03-01,Ohio,9147631,5759537,5471393,288144
2016-03-01,Oklahoma,2985654,1832699,1748627,84072
2016-03-01,Oregon,3260421,2033640,1934161,99479
2016-03-01,Pennsylvania,10226626,6474416,6129729,344687
2016-03-01,Tennessee,5196802,3116195,2971290,144905
2016-03-01,Texas,20792661,13275533,12683175,592358
2016-03-01,Utah,2177280,1487708,1435988,51720
2016-03-01,Vermont,515178,345578,334690,10888
2016-03-01,Virginia,6528060,4235332,4070935,164397
2016-03-01,Washington,5697581,3630389,3436155,194234
2016-03-01,Wisconsin,4559314,3110352,2984977,125375
2016-03-01,Wyoming,451294,302567,285818,16749
2016-04-01,Alabama,3812782,2149261,2022346,126915
2016-04-01,Alaska,545942,362119,338457,23662
2016-04-01,Arizona,5361241,3239833,3059997,179836
2016-04-01,Arkansas,2309079,1344939,1291027,53912
2016-04-01,California,30512396,18973207,17921613,1051594
2016-04-01,Colorado,4304871,2880932,2786260,94672
2016-04-01,Connecticut,2873785,1889305,1794839,94466
2016-04-01,Delaware,752531,468680,447969,20711
2016-04-01,Florida,16542894,9790156,9309537,480619
2016-04-01,Georgia,7859831,4833906,4568888,265018
2016-04-01,Hawaii,1092461,676978,656743,20235
2016-04-01,Idaho,1267849,810104,780076,30028
2016-04-01,Illinois,10048172,6589117,6186891,402226
2016-04-01,Indiana,5140915,3339764,3186380,153384
2016-04-01,Iowa,2439789,1708496,1646486,62010
2016-04-01,Kansas,2212288,1495476,1436383,59093
2016-04-01,Kentucky,3455877,2005178,1905194,99984
2016-04-01,Louisiana,3581804,2131830,2002097,129733
2016-04-01,Maine,1093632,691999,665340,26659
2016-04-01,Maryland,4710558,3146561,3011264,135297
2016-04-01,Massachusetts,5534696,3604987,3456132,148855
2016-04-01,Michigan,7909088,4836910,4596471,240439
2016-04-01,Minnesota,4310025,3021085,2906473,114612
2016-04-01,Mississippi,2283610,1269674,1193563,76111
2016-04-01,Missouri,4750527,3074491,2936456,138035
2016-04-01,Montana,821797,521820,499039,22781
2016-04-01,Nebraska,1449875,1018474,987872,30602
2016-04-01,Nevada,2269583,1409538,1325445,84093
2016-04-01,Ohio,9150016,5759108,5472521,286587
2016-04-01,Oklahoma,2987151,1831282,1746117,85165
2016-04-01,Oregon,3266109,2037655,1937802,99853
2016-04-01,Pennsylvania,10227506,6472917,6126458,346459
2016-04-01,Tennessee,5201269,3120756,2975759,144997
2016-04-01,Texas,20825236,13297832,12698126,599706
2016-04-01,Utah,2181885,1491391,1440100,51291
2016-04-01,Vermont,515160,345690,334876,10814
2016-04-01,Virginia,6531334,4236772,4072587,164185
2016-04-01,Washington,5706896,3637282,3443618,193664
2016-04-01,Wisconsin,4560930,3110891,2986761,124130
2016-04-01,Wyoming,451233,302403,285301,17102
2016-05-01,Alabama,3814145,2151573,2025350,126223
2016-05-01,Alaska,546309,362119,338314,23805
2016-05-01,Arizona,5370157,3245197,3065928,179269
2016-05-01,Arkansas,2310084,1344591,1290913,53678
2016-05-01,California,30534603,18989520,17941250,1048270
2016-05-01,Colorado,4312234,2885680,2791195,94485
2016-05-01,Connecticut,2873870,1890682,1797493,93189
2016-05-01,Delaware,753166,468563,447804,20759
2016-05-01,Florida,16571697,9806455,9327449,479006
2016-05-01,Georgia,7870375,4870975,4606634,264341
2016-05-01,Hawaii,1092967,677630,657476,20154
2016-05-01,Idaho,1270248,811416,781429,29987
2016-05-01,Illinois,10047560,6580544,6184932,395612
2016-05-01,Indiana,5143600,3340290,3189022,151268
2016-05-01,Iowa,2440696,1706702,1644496,62206
2016-05-01,Kansas,2213068,1493780,1434209,59571
2016-05-01,Kentucky,3457188,2008503,1909307,99196
2016-05-01,Louisiana,3583030,2129860,1999764,130096
2016-05-01,Maine,1093899,693068,666646,26422
2016-05-01,Maryland,4711468,3147271,3012872,134399
2016-05-01,Massachusetts,5537771,3609457,3462973,146484
2016-05-01,Michigan,7911815,4843434,4601766,241668
2016-05-01,Minnesota,4313066,3019912,2904922,114990
2016-05-01,Mississippi,2284042,1269210,1193670,75540
2016-05-01,Missouri,4752183,3076191,2935649,140542
2016-05-01,Montana,822573,521715,498984,22731
2016-05-01,Nebraska,1450843,1017826,987002,30824
2016-05-01,Nevada,2273098,1410785,1327774,83011
2016-05-01,Ohio,9152322,5756166,5470836,285330
2016-05-01,Oklahoma,2988671,1829596,1743321,86275
2016-05-01,Oregon,3271771,2040822,1940533,100289
2016-05-01,Pennsylvania,10228380,6470707,6122515,348192
2016-05-01,Tennessee,5205703,3126578,2980257,146321
2016-05-01,Texas,20857325,13321031,12710616,610415
2016-05-01,Utah,2186473,1494904,1444126,50778
2016-05-01,Vermont,515170,345778,334986,10792
2016-05-01,Virginia,6534789,4240409,4074927,165482
2016-05-01,Washington,5716292,3643393,3449983,193410
2016-05-01,Wisconsin,4562657,3111252,2987959,123293
2016-05-01,Wyoming,451222,301896,284797,17099
2016-06-01,Alabama,3815642,2154315,2028210,126105
2016-06-01,Alaska,546635,362098,338159,23939
2016-06-01,Arizona,5379277,3250898,3072085,178813
2016-06-01,Arkansas,2311209,1344422,1290844,53578
2016-06-01,California,30557662,19008579,17961187,1047392
2016-06-01,Colorado,4319761,2891014,2797121,93893
2016-06-01,Connecticut,2874029,1892133,1800092,92041
2016-06-01,Delaware,753847,468515,447619,20896
2016-06-01,Florida,16601075,9826989,9347749,479240
2016-06-01,Georgia,7880992,4908561,4643573,264988
2016-06-01,Hawaii,1093490,678662,658647,20015
2016-06-01,Idaho,1272686,812750,782732,30018
2016-06-01,Illinois,10047244,6569841,6180798,389043
2016-06-01,Indiana,5146468,3339805,3191314,148491
2016-06-01,Iowa,2441687,1705132,1642812,62320
2016-06-01,Kansas,2213900,1492201,1431926,60275
2016-06-01,Kentucky,3458575,2012869,1913680,99189
2016-06-01,Louisiana,3584422,2127524,1997206,130318
2016-06-01,Maine,1094206,694036,667788,26248
2016-06-01,Maryland,4712540,3149300,3015276,134024
2016-06-01,Massachusetts,5541082,3614771,3470308,144463
2016-06-01,Michigan,7914881,4849566,4606797,242769
2016-06-01,Minnesota,4316269,3019989,2904199,115790
2016-06-01,Mississippi,2284502,1269750,1194254,75496
2016-06-01,Missouri,4753964,3077577,2934414,143163
2016-06-01,Montana,823348,521652,499016,22636
2016-06-01,Nebraska,1451894,1017046,985933,31113
2016-06-01,Nevada,2276707,1412384,1330298,82086
2016-06-01,Ohio,9155037,5752564,5467270,285294
2016-06-01,Oklahoma,2990230,1828018,1740924,87094
2016-06-01,Oregon,3277621,2043662,1943278,100384
2016-06-01,Pennsylvania,10229680,6468539,6119045,349494
2016-06-01,Tennessee,5210293,3133742,2985440,148302
2016-06-01,Texas,20889995,13344101,12722956,621145
2016-06-01,Utah,2191135,1498447,1448202,50245
2016-06-01,Vermont,515205,345859,335071,10788
2016-06-01,Virginia,6538478,4246189,4078270,167919
2016-06-01,Washington,5725845,3649388,3456222,193166
2016-06-01,Wisconsin,4564494,3111805,2989047,122758
2016-06-01,Wyoming,451169,301109,284349,16760
2016-07-01,Alabama,3817320,2157474,2031143,126331
2016-07-01,Alaska,547000,362029,338000,24029
2016-07-01,Arizona,5388764,3256816,3078706,178110
2016-07-01,Arkansas,2312505,1344309,1290861,53448
2016-07-01,California,30582360,19028074,17981056,1047018
2016-07-01,Colorado,4327483,2896793,2804247,92546
2016-07-01,Connecticut,2874369,1893536,1802669,90867
2016-07-01,Delaware,754560,468517,447440,21077
2016-07-01,Florida,16631565,9850017,9369741,480276
2016-07-01,Georgia,7891678,4947062,4680456,266606
2016-07-01,Hawaii,1094097,679858,660086,19772
2016-07-01,Idaho,1275237,814013,784003,30010
2016-07-01,Illinois,10047294,6558534,6175653,382881
2016-07-01,Indiana,5149720,3338179,3192914,145265
2016-07-01,Iowa,2442852,1703877,1641745,62132
2016-07-01,Kansas,2214883,1490884,1429885,60999
2016-07-01,Kentucky,3460228,2017591,1917963,99628
2016-07-01,Louisiana,3586053,2124777,1994428,130349
2016-07-01,Maine,1094627,694904,668817,26087
2016-07-01,Maryland,4714009,3152707,3018813,133894
2016-07-01,Massachusetts,5544738,3620318,3477693,142625
2016-07-01,Michigan,7918535,4855399,4611733,243666
2016-07-01,Minnesota,4319767,3021008,2904097,116911
2016-07-01,Mississippi,2285162,1270922,1195416,75506
2016-07-01,Missouri,4755898,3078141,2933221,144920
2016-07-01,Montana,824204,521634,499140,22494
2016-07-01,Nebraska,1453027,1016161,984777,31384
2016-07-01,Nevada,2280511,1414241,1333032,81209
2016-07-01,Ohio,9158454,5749748,5463246,286502
2016-07-01,Oklahoma,2991883,1826864,1739455,87409
2016-07-01,Oregon,3283694,2046599,1946984,99615
2016-07-01,Pennsylvania,10231756,6465434,6115856,349578
2016-07-01,Tennessee,5215287,3141665,2991411,150254
2016-07-01,Texas,20923730,13365941,12736496,629445
2016-07-01,Utah,2195928,1502055,1452325,49730
2016-07-01,Vermont,515265,345924,335154,10770
2016-07-01,Virginia,6542390,4253358,4082681,170677
2016-07-01,Washington,5735768,3655019,3462950,192069
2016-07-01,Wisconsin,4566737,3112393,2990301,122092
2016-07-01,Wyoming,451175,300247,283973,16274
2016-08-01,Alabama,3819041,2160744,2034025,126719
2016-08-01,Alaska,547166,361944,337853,24091
2016-08-01,Arizona,5398026,3262727,3085510,177217
2016-08-01,Arkansas,2313694,1344072,1290838,53234
2016-08-01,California,30603497,19046039,17999607,1046432
2016-08-01,Colorado,4333997,2902625,2812008,90617
2016-08-01,Connecticut,2874907,1894991,1805214,89777
2016-08-01,Delaware,755276,468615,447331,21284
2016-08-01,Florida,16660212,9873290,9391728,481562
2016-08-01,Georgia,7901048,4986532,4717653,268879
2016-08-01,Hawaii,1094428,680909,661451,19458
2016-08-01,Idaho,1277924,815143,785242,29901
2016-08-01,Illinois,10047320,6548208,6170083,378125
2016-08-01,Indiana,5152279,3335426,3193276,142150
2016-08-01,Iowa,2443877,1702459,1640827,61632
2016-08-01,Kansas,2215338,1489730,1428192,61538
2016-08-01,Kentucky,3461891,2022067,1921669,100398
2016-08-01,Louisiana,3586312,2121376,1991224,130152
2016-08-01,Maine,1095131,695716,669786,25930
2016-08-01,Maryland,4716465,3157347,3023343,134004
2016-08-01,Massachusetts,5548563,3625768,3484610,141158
2016-08-01,Michigan,7922091,4860940,4616444,244496
2016-08-01,Minnesota,4323214,3022594,2904394,118200
2016-08-01,Mississippi,2285881,1272319,1196860,75459
2016-08-01,Missouri,4757964,3077411,2932194,145217
2016-08-01,Montana,825155,521668,499311,22357
2016-08-01,Nebraska,1453909,1015208,983589,31619
2016-08-01,Nevada,2284685,1416277,1335898,80379
2016-08-01,Ohio,9162085,5749164,5459942,289222
2016-08-01,Oklahoma,2992749,1826152,1738948,87204
2016-08-01,Oregon,3288289,2049413,1951419,97994
2016-08-01,Pennsylvania,10234047,6460382,6111927,348455
2016-08-01,Tennessee,5220640,3148996,2997016,151980
2016-08-01,Texas,20954163,13386060,12750754,635306
2016-08-01,Utah,2200587,1505706,1456380,49326
2016-08-01,Vermont,515403,345995,335259,10736
2016-08-01,Virginia,6548312,4261151,4088025,173126
2016-08-01,Washington,5746009,3660154,3470082,190072
2016-08-01,Wisconsin,4568957,3112627,2991530,121097
2016-08-01,Wyoming,450983,299501,283660,15841
2016-09-01,Alabama,3820951,2163777,2036649,127128
2016-09-01,Alaska,547374,361974,337799,24175
2016-09-01,Arizona,5407618,3268544,3092046,176498
2016-09-01,Arkansas,2314999,1343648,1290648,53000
2016-09-01,California,30626494,19061155,18015129,1046026
2016-09-01,Colorado,4340722,2908090,2819516,88574
2016-09-01,Connecticut,2875660,1896690,1807641,89049
2016-09-01,Delaware,756102,468865,447328,21537
2016-09-01,Florida,16689784,9894617,9411626,482991
2016-09-01,Georgia,7910767,5007844,4736489,271355
2016-09-01,Hawaii,1094839,681639,662483,19156
2016-09-01,Idaho,1280709,816266,786512,29754
2016-09-01,Illinois,10047781,6539107,6164292,374815
2016-09-01,Indiana,5155140,3331610,3191886,139724
2016-09-01,Iowa,2445007,1700400,1639444,60956
2016-09-01,Kansas,2215863,1488560,1426801,61759
2016-09-01,Kentucky,3463726,2026061,1924543,101518
2016-09-01,Louisiana,3586737,2117470,1987810,129660
2016-09-01,Maine,1095713,696481,670673,25808
2016-09-01,Maryland,4719113,3162687,3028270,134417
2016-09-01,Massachusetts,5552657,3630818,3490335,140483
2016-09-01,Michigan,7925989,4866256,4620323,245933
2016-09-01,Minnesota,4326878,3024432,2904939,119493
2016-09-01,Mississippi,2286653,1273642,1198270,75372
2016-09-01,Missouri,4760235,3075144,2931162,143982
2016-09-01,Montana,826169,521755,499476,22279
2016-09-01,Nebraska,1454904,1014279,982416,31863
2016-09-01,Nevada,2289002,1418474,1338773,79701
2016-09-01,Ohio,9166161,5752040,5458133,293907
2016-09-01,Oklahoma,2993771,1825492,1738937,86555
2016-09-01,Oregon,3293114,2051528,1955705,95823
2016-09-01,Pennsylvania,10236775,6453159,6106573,346586
2016-09-01,Tennessee,5226225,3154762,3001280,153482
2016-09-01,Texas,20985782,13403980,12763563,640417
2016-09-01,Utah,2205274,1509362,1460215,49147
2016-09-01,Vermont,515579,346058,335351,10707
2016-09-01,Virginia,6554563,4269034,4094058,174976
2016-09-01,Washington,5756519,3665002,3477143,187859
2016-09-01,Wisconsin,4571331,3112289,2992319,119970
2016-09-01,Wyoming,450823,298941,283384,15557
2016-10-01,Alabama,3822861,2166110,2039127,126983
2016-10-01,Alaska,547373,362112,337870,24242
2016-10-01,Arizona,5417057,3274187,3098339,175848
2016-10-01,Arkansas,2316340,1342910,1290250,52660
2016-10-01,California,30648257,19071727,18028383,1043344
2016-10-01,Colorado,4347159,2912869,2826596,86273
2016-10-01,Connecticut,2876331,1898583,1810005,88578
2016-10-01,Delaware,756884,469237,447444,21793
2016-10-01,Florida,16718944,9912032,9428996,483036
2016-10-01,Georgia,7920402,5065858,4793054,272804
2016-10-01,Hawaii,1094781,681999,663144,18855
2016-10-01,Idaho,1283493,817413,787865,29548
2016-10-01,Illinois,10048334,6529612,6158816,370796
2016-10-01,Indiana,5158013,3326557,3188983,137574
2016-10-01,Iowa,2446168,1697326,1637247,60079
2016-10-01,Kansas,2216246,1487280,1425871,61409
2016-10-01,Kentucky,3465422,2029535,1926913,102622
2016-10-01,Louisiana,3587044,2113467,1984845,128622
2016-10-01,Maine,1096317,697115,671499,25616
2016-10-01,Maryland,4721604,3167854,3033190,134664
2016-10-01,Massachusetts,5556771,3635097,3494693,140404
2016-10-01,Michigan,7930030,4870453,4623219,247234
2016-10-01,Minnesota,4330635,3026209,2906061,120148
2016-10-01,Mississippi,2287376,1274607,1199606,75001
2016-10-01,Missouri,4762631,3071352,2930190,141162
2016-10-01,Montana,827139,521828,499594,22234
2016-10-01,Nebraska,1455876,1013352,981360,31992
2016-10-01,Nevada,2293207,1420709,1341689,79020
2016-10-01,Ohio,9170273,5757428,5457993,299435
2016-10-01,Oklahoma,2994760,1824350,1738956,85394
2016-10-01,Oregon,3297913,2052451,1959271,93180
2016-10-01,Pennsylvania,10239633,6444103,6100196,343907
2016-10-01,Tennessee,5231683,3158441,3004295,154146
2016-10-01,Texas,21016880,13419163,12774408,644755
2016-10-01,Utah,2210053,1512986,1463848,49138
2016-10-01,Vermont,515777,346102,335396,10706
2016-10-01,Virginia,6559961,4276217,4100496,175721
2016-10-01,Washington,5766564,3669217,3483903,185314
2016-10-01,Wisconsin,4573809,3111091,2992589,118502
2016-10-01,Wyoming,450635,298556,283145,15411
2016-11-01,Alabama,3824434,2167734,2042073,125661
2016-11-01,Alaska,547491,362298,338067,24231
2016-11-01,Arizona,5426062,3280006,3105116,174890
2016-11-01,Arkansas,2317392,1342237,1290085,52152
2016-11-01,California,30668672,19079948,18044658,1035290
2016-11-01,Colorado,4353436,2917546,2834159,83387
2016-11-01,Connecticut,2876745,1900809,1812673,88136
2016-11-01,Delaware,757580,469756,447782,21974
2016-11-01,Florida,16746204,9926694,9446908,479786
2016-11-01,Georgia,7929986,5066497,4794312,272185
2016-11-01,Hawaii,1095019,682195,663687,18508
2016-11-01,Idaho,1286128,818658,789438,29220
2016-11-01,Illinois,10048158,6518407,6154569,363838
2016-11-01,Indiana,5160413,3321175,3186375,134800
2016-11-01,Iowa,2447065,1693569,1634566,59003
2016-11-01,Kansas,2216532,1486064,1425661,60403
2016-11-01,Kentucky,3466939,2033028,1929665,103363
2016-11-01,Louisiana,3587097,2110081,1983120,126961
2016-11-01,Maine,1096776,697657,672408,25249
2016-11-01,Maryland,4723739,3172830,3038452,134378
2016-11-01,Massachusetts,5560400,3639080,3498632,140448
2016-11-01,Michigan,7933209,4873086,4626288,246798
2016-11-01,Minnesota,4333928,3028316,2908696,119620
2016-11-01,Mississippi,2287980,1275297,1201112,74185
2016-11-01,Missouri,4764665,3066907,2929960,136947
2016-11-01,Montana,828064,521938,499776,22162
2016-11-01,Nebraska,1456682,1012567,980719,31848
2016-11-01,Nevada,2297276,1423131,1344990,78141
2016-11-01,Ohio,9173416,5763754,5460359,303395
2016-11-01,Oklahoma,2995627,1822914,1739205,83709
2016-11-01,Oregon,3302377,2052819,1962568,90251
2016-11-01,Pennsylvania,10241288,6435694,6095476,340218
2016-11-01,Tennessee,5236761,3160471,3007297,153174
2016-11-01,Texas,21046899,13434311,12787312,646999
2016-11-01,Utah,2214643,1516777,1467644,49133
2016-11-01,Vermont,515880,346202,335457,10745
2016-11-01,Virginia,6565331,4283055,4107886,175169
2016-11-01,Washington,5776410,3673004,3490923,182081
2016-11-01,Wisconsin,4575836,3109627,2993340,116287
2016-11-01,Wyoming,450398,298248,282998,15250
2016-12-01,Alabama,3825968,2168771,2045834,122937
2016-12-01,Alaska,547590,362459,338328,24131
2016-12-01,Arizona,5434795,3286375,3112781,173594
2016-12-01,Arkansas,2318409,1342177,1290651,51526
2016-12-01,California,30688153,19090083,18068401,1021682
2016-12-01,Colorado,4359555,2922961,2842900,80061
2016-12-01,Connecticut,2877085,1903587,1815897,87690
2016-12-01,Delaware,758249,470473,448430,22043
2016-12-01,Florida,16773010,9941833,9468761,473072
2016-12-01,Georgia,7939421,5068628,4799051,269577
2016-12-01,Hawaii,1095214,682432,664308,18124
2016-12-01,Idaho,1288749,820142,791352,28790
2016-12-01,Illinois,10047713,6506520,6152559,353961
2016-12-01,Indiana,5162688,3317083,3185941,131142
2016-12-01,Iowa,2447876,1689919,1632092,57827
2016-12-01,Kansas,2216707,1485099,1426125,58974
2016-12-01,Kentucky,3468367,2036870,1933310,103560
2016-12-01,Louisiana,3587029,2107951,1982995,124956
2016-12-01,Maine,1097189,698186,673402,24784
2016-12-01,Maryland,4725774,3177879,3044323,133556
2016-12-01,Massachusetts,5563855,3643795,3503296,140499
2016-12-01,Michigan,7936205,4874253,4630737,243516
2016-12-01,Minnesota,4337066,3031048,2913051,117997
2016-12-01,Mississippi,2288535,1275809,1202794,73015
2016-12-01,Missouri,4766621,3063183,2930971,132212
2016-12-01,Montana,828950,522219,500168,22051
2016-12-01,Nebraska,1457487,1012214,980735,31479
2016-12-01,Nevada,2301284,1426046,1348939,77107
2016-12-01,Ohio,9176341,5770112,5465690,304422
2016-12-01,Oklahoma,2996384,1821747,1740013,81734
2016-12-01,Oregon,3306702,2053931,1966524,87407
2016-12-01,Pennsylvania,10242658,6430351,6094481,335870
2016-12-01,Tennessee,5241716,3161953,3011886,150067
2016-12-01,Texas,21076258,13452830,12805992,646838
2016-12-01,Utah,2219183,1520948,1471879,49069
2016-12-01,Vermont,515998,346418,335584,10834
2016-12-01,Virginia,6570569,4290653,4116919,173734
2016-12-01,Washington,5786076,3677076,3498667,178409
2016-12-01,Wisconsin,4577736,3108972,2995667,113305
2016-12-01,Wyoming,450188,297901,282982,14919
2017-01-01,Alabama,3827336,2169189,2050155,119034
2017-01-01,Alaska,547623,362577,338607,23970
2017-01-01,Arizona,5443325,3293551,3121383,172168
2017-01-01,Arkansas,2319332,1343005,1292124,50881
2017-01-01,California,30706378,19104295,18099840,1004455
2017-01-01,Colorado,4365315,2929729,2852981,76748
2017-01-01,Connecticut,2877354,1906632,1819374,87258
2017-01-01,Delaware,758922,471348,449362,21986
2017-01-01,Florida,16799082,9959680,9495705,463975
2017-01-01,Georgia,7948388,5072698,4807043,265655
2017-01-01,Hawaii,1095136,682762,665044,17718
2017-01-01,Idaho,1291268,821939,793663,28276
2017-01-01,Illinois,10046909,6496269,6153055,343214
2017-01-01,Indiana,5164740,3315526,3188666,126860
2017-01-01,Iowa,2448593,1687324,1630667,56657
2017-01-01,Kansas,2216729,1484359,1426926,57433
2017-01-01,Kentucky,3469500,2040998,1937727,103271
2017-01-01,Louisiana,3586792,2106911,1984300,122611
2017-01-01,Maine,1097564,698709,674366,24343
2017-01-01,Maryland,4727477,3183120,3050617,132503
2017-01-01,Massachusetts,5567147,3650057,3509430,140627
2017-01-01,Michigan,7938921,4874232,4637189,237043
2017-01-01,Minnesota,4340091,3034846,2919266,115580
2017-01-01,Mississippi,2288902,1276109,1204436,71673
2017-01-01,Missouri,4768305,3060674,2932864,127810
2017-01-01,Montana,829814,522736,500829,21907
2017-01-01,Nebraska,1458153,1012343,981325,31018
2017-01-01,Nevada,2305093,1429587,1353517,76070
2017-01-01,Ohio,9178815,5776773,5473846,302927
2017-01-01,Oklahoma,2996974,1821261,1741505,79756
2017-01-01,Oregon,3310911,2056713,1971741,84972
2017-01-01,Pennsylvania,10243590,6428773,6097160,331613
2017-01-01,Tennessee,5246270,3163878,3018945,144933
2017-01-01,Texas,21104864,13475517,12831319,644198
2017-01-01,Utah,2223546,1525486,1476505,48981
2017-01-01,Vermont,516063,346696,335767,10929
2017-01-01,Virginia,6574870,4299497,4127652,171845
2017-01-01,Washington,5795156,3682399,3507480,174919
2017-01-01,Wisconsin,4579412,3109927,2999980,109947
2017-01-01,Wyoming,449900,297484,283090,14394
2017-02-01,Alabama,3828265,2169168,2054720,114448
2017-02-01,Alaska,547523,362605,338829,23776
2017-02-01,Arizona,5451183,3301274,3130805,170469
2017-02-01,Arkansas,2319981,1344688,1294415,50273
2017-02-01,California,30720743,19121397,18136366,985031
2017-02-01,Colorado,4370670,2938091,2864182,73909
2017-02-01,Connecticut,2877294,1909269,1822563,86706
2017-02-01,Delaware,759440,472237,450433,21804
2017-02-01,Florida,16822770,9980408,9527052,453356
2017-02-01,Georgia,7956361,5078100,4817250,260850
2017-02-01,Hawaii,1094820,683131,665872,17259
2017-02-01,Idaho,1293661,823968,796281,27687
2017-02-01,Illinois,10044983,6488487,6155316,333171
2017-02-01,Indiana,5166404,3316422,3194259,122163
2017-02-01,Iowa,2449040,1686199,1630708,55491
2017-02-01,Kansas,2216489,1483907,1427958,55949
2017-02-01,Kentucky,3470348,2045074,1942386,102688
2017-02-01,Louisiana,3586192,2106351,1986682,119669
2017-02-01,Maine,1097810,699228,675229,23999
2017-02-01,Maryland,4728764,3188452,3057065,131387
2017-02-01,Massachusetts,5569963,3657344,3516653,140691
2017-02-01,Michigan,7940951,4873554,4645337,228217
2017-02-01,Minnesota,4342753,3039709,2927040,112669
2017-02-01,Mississippi,2289079,1276237,1205892,70345
2017-02-01,Missouri,4769419,3059217,2935347,123870
2017-02-01,Montana,830555,523443,501711,21732
2017-02-01,Nebraska,1458699,1012904,982401,30503
2017-02-01,Nevada,2308708,1433636,1358554,75082
2017-02-01,Ohio,9180547,5783542,5483674,299868
2017-02-01,Oklahoma,2997232,1821588,1743748,77840
2017-02-01,Oregon,3314845,2061602,1978539,83063
2017-02-01,Pennsylvania,10243625,6430102,6102515,327587
2017-02-01,Tennessee,5250360,3166548,3028406,138142
2017-02-01,Texas,21131020,13499782,12862492,637290
2017-02-01,Utah,2227847,1530178,1481315,48863
2017-02-01,Vermont,516120,346946,335994,10952
2017-02-01,Virginia,6578630,4309148,4139557,169591
2017-02-01,Washington,5803711,3689536,3517700,171836
2017-02-01,Wisconsin,4580718,3112689,3006097,106592
2017-02-01,Wyoming,449600,297008,283273,13735
2017-03-01,Alabama,3829333,2169063,2059199,109864
2017-03-01,Alaska,547417,362524,338908,23616
2017-03-01,Arizona,5459193,3308948,3140297,168651
2017-03-01,Arkansas,2320778,1346836,1296965,49871
2017-03-01,California,30735267,19138738,18171800,966938
2017-03-01,Colorado,4376278,2947782,2875727,72055
2017-03-01,Connecticut,2877313,1910761,1824688,86073
2017-03-01,Delaware,760014,473009,451426,21583
2017-03-01,Florida,16846758,10002242,9559207,443035
2017-03-01,Georgia,7964783,5084089,4828075,256014
2017-03-01,Hawaii,1094525,683299,666542,16757
2017-03-01,Idaho,1296159,826061,798974,27087
2017-03-01,Illinois,10043386,6483032,6157292,325740
2017-03-01,Indiana,5168285,3318619,3200762,117857
2017-03-01,Iowa,2449719,1686230,1631800,54430
2017-03-01,Kansas,2216375,1483866,1429048,54818
2017-03-01,Kentucky,3471436,2048431,1946296,102135
2017-03-01,Louisiana,3585727,2106037,1989661,116376
2017-03-01,Maine,1098136,699670,675848,23822
2017-03-01,Maryland,4730125,3193349,3062891,130458
2017-03-01,Massachusetts,5572949,3664380,3523611,140769
2017-03-01,Michigan,7943239,4872774,4653439,219335
2017-03-01,Minnesota,4345594,3044443,2934574,109869
2017-03-01,Mississippi,2289330,1276233,1206961,69272
2017-03-01,Missouri,4770874,3058640,2938027,120613
2017-03-01,Montana,831334,524216,502647,21569
2017-03-01,Nebraska,1459369,1013791,983736,30055
2017-03-01,Nevada,2312390,1437984,1363702,74282
2017-03-01,Ohio,9182728,5789264,5492641,296623
2017-03-01,Oklahoma,2997625,1822754,1746581,76173
2017-03-01,Oregon,3318897,2068264,1986270,81994
2017-03-01,Pennsylvania,10244043,6432034,6107865,324169
2017-03-01,Tennessee,5254762,3169775,3039106,130669
2017-03-01,Texas,21157545,13521412,12895119,626293
2017-03-01,Utah,2232281,1534721,1485912,48809
2017-03-01,Vermont,516208,347125,336240,10885
2017-03-01,Virginia,6582701,4318271,4151048,167223
2017-03-01,Washington,5812551,3698062,3528462,169600
2017-03-01,Wisconsin,4582253,3116581,3012701,103880
2017-03-01,Wyoming,449313,296518,283446,13072
2017-04-01,Alabama,3830510,2169397,2063832,105565
2017-04-01,Alaska,547545,362324,338797,23527
2017-04-01,Arizona,5467393,3316282,3149472,166810
2017-04-01,Arkansas,2321575,1349136,1299404,49732
2017-04-01,California,30752193,19156417,18204216,952201
2017-04-01,Colorado,4382200,2958477,2886975,71502
2017-04-01,Connecticut,2877417,1910872,1825493,85379
2017-04-01,Delaware,760618,473786,452398,21388
2017-04-01,Florida,16871541,10021874,9587640,434234
2017-04-01,Georgia,7973759,5091222,4839659,251563
2017-04-01,Hawaii,1094624,683102,666882,16220
2017-04-01,Idaho,1298673,828212,801688,26524
2017-04-01,Illinois,10042277,6480395,6158728,321667
2017-04-01,Indiana,5170204,3321686,3206865,114821
2017-04-01,Iowa,2450329,1687055,1633446,53609
2017-04-01,Kansas,2216468,1484339,1430129,54210
2017-04-01,Kentucky,3472662,2050906,1949344,101562
2017-04-01,Louisiana,3585365,2106249,1993148,113101
2017-04-01,Maine,1098491,700067,676260,23807
2017-04-01,Maryland,4731712,3197993,3068197,129796
2017-04-01,Massachusetts,5575973,3670870,3529989,140881
2017-04-01,Michigan,7945516,4873671,4660416,213255
2017-04-01,Minnesota,4348459,3048561,2940884,107677
2017-04-01,Mississippi,2289668,1276242,1207760,68482
2017-04-01,Missouri,4772470,3058858,2940847,118011
2017-04-01,Montana,832173,524980,503516,21464
2017-04-01,Nebraska,1460051,1014926,985145,29781
2017-04-01,Nevada,2316135,1442558,1368857,73701
2017-04-01,Ohio,9184900,5793990,5500107,293883
2017-04-01,Oklahoma,2998224,1825034,1750143,74891
2017-04-01,Oregon,3322961,2075771,1993891,81880
2017-04-01,Pennsylvania,10244449,6432707,6111244,321463
2017-04-01,Tennessee,5259299,3173752,3050343,123409
2017-04-01,Texas,21185490,13539599,12926792,612807
2017-04-01,Utah,2236716,1539025,1490178,48847
2017-04-01,Vermont,516283,347240,336510,10730
2017-04-01,Virginia,6587696,4326576,4161649,164927
2017-04-01,Washington,5821915,3707560,3538912,168648
2017-04-01,Wisconsin,4583785,3120906,3018674,102232
2017-04-01,Wyoming,449046,296125,283584,12541
2017-05-01,Alabama,3831738,2170254,2068766,101488
2017-05-01,Alaska,547568,362029,338550,23479
2017-05-01,Arizona,5475632,3322775,3157971,164804
2017-05-01,Arkansas,2322473,1351283,1301495,49788
2017-05-01,California,30768143,19173509,18233484,940025
2017-05-01,Colorado,4388075,2969650,2897307,72343
2017-05-01,Connecticut,2877571,1909656,1825046,84610
2017-05-01,Delaware,761229,474681,453457,21224
2017-05-01,Florida,16896488,10035568,9608502,427066
2017-05-01,Georgia,7982640,5099686,4852300,247386
2017-05-01,Hawaii,1094527,682436,666824,15612
2017-05-01,Idaho,1301254,830435,804386,26049
2017-05-01,Illinois,10041245,6480342,6160153,320189
2017-05-01,Indiana,5172316,3325107,3211596,113511
2017-05-01,Iowa,2451132,1688010,1635031,52979
2017-05-01,Kansas,2216547,1485132,1431168,53964
2017-05-01,Kentucky,3473934,2052494,1951741,100753
2017-05-01,Louisiana,3585080,2106810,1996900,109910
2017-05-01,Maine,1098886,700407,676534,23873
2017-05-01,Maryland,4733208,3202591,3073263,129328
2017-05-01,Massachusetts,5579253,3676709,3535808,140901
2017-05-01,Michigan,7948140,4877498,4665848,211650
2017-05-01,Minnesota,4351521,3051857,2945848,106009
2017-05-01,Mississippi,2290029,1276089,1208352,67737
2017-05-01,Missouri,4774274,3059510,2943719,115791
2017-05-01,Montana,833044,525640,504229,21411
2017-05-01,Nebraska,1460788,1016136,986512,29624
2017-05-01,Nevada,2319911,1447183,1373995,73188
2017-05-01,Ohio,9187468,5798349,5506621,291728
2017-05-01,Oklahoma,2998855,1828387,1754403,73984
2017-05-01,Oregon,3327202,2082873,2000363,82510
2017-05-01,Pennsylvania,10245398,6430882,6111812,319070
2017-05-01,Tennessee,5263952,3178589,3061471,117118
2017-05-01,Texas,21212877,13554747,12956771,597976
2017-05-01,Utah,2241236,1542965,1494109,48856
2017-05-01,Vermont,516395,347293,336775,10518
2017-05-01,Virginia,6592107,4334159,4171541,162618
2017-05-01,Washington,5831159,3717174,3548309,168865
2017-05-01,Wisconsin,4585572,3125083,3023465,101618
2017-05-01,Wyoming,448807,295897,283669,12228
2017-06-01,Alabama,3833212,2171313,2073459,97854
2017-06-01,Alaska,547498,361709,338239,23470
2017-06-01,Arizona,5484293,3328309,3165349,162960
2017-06-01,Arkansas,2323505,1352962,1302925,50037
2017-06-01,California,30785787,19188584,18258506,930078
2017-06-01,Colorado,4394135,2980602,2906089,74513
2017-06-01,Connecticut,2877943,1907293,1823366,83927
2017-06-01,Delaware,761894,475693,454570,21123
2017-06-01,Florida,16922604,10042754,9620715,422039
2017-06-01,Georgia,7991681,5108679,4864903,243776
2017-06-01,Hawaii,1094338,681277,666324,14953
2017-06-01,Idaho,1303917,832754,807001,25753
2017-06-01,Illinois,10040833,6482173,6161540,320633
2017-06-01,Indiana,5174848,3328244,3214341,113903
2017-06-01,Iowa,2452121,1688463,1635980,52483
2017-06-01,Kansas,2216714,1485827,1431955,53872
2017-06-01,Kentucky,3475403,2053206,1953465,99741
2017-06-01,Louisiana,3584978,2107644,2000528,107116
2017-06-01,Maine,1099367,700618,676626,23992
2017-06-01,Maryland,4735001,3206885,3077664,129221
2017-06-01,Massachusetts,5582922,3681881,3540960,140921
2017-06-01,Michigan,7951337,4883773,4669549,214224
2017-06-01,Minnesota,4354936,3054311,2949555,104756
2017-06-01,Mississippi,2290451,1275600,1208597,67003
2017-06-01,Missouri,4776343,3060109,2946086,114023
2017-06-01,Montana,833938,526118,504679,21439
2017-06-01,Nebraska,1461662,1017213,987682,29531
2017-06-01,Nevada,2323776,1451672,1378935,72737
2017-06-01,Ohio,9190673,5803149,5512740,290409
2017-06-01,Oklahoma,2999600,1832045,1758622,73423
2017-06-01,Oregon,3331658,2088296,2004680,83616
2017-06-01,Pennsylvania,10247076,6426822,6109464,317358
2017-06-01,Tennessee,5268917,3184073,3071416,112657
2017-06-01,Texas,21241618,13567834,12983477,584357
2017-06-01,Utah,2245932,1546385,1497558,48827
2017-06-01,Vermont,516530,347283,336961,10322
2017-06-01,Virginia,6596798,4340500,4180059,160441
2017-06-01,Washington,5840658,3725985,3555963,170022
2017-06-01,Wisconsin,4587663,3128427,3026599,101828
2017-06-01,Wyoming,448586,295839,283652,12187
2017-07-01,Alabama,3834828,2172434,2077532,94902
2017-07-01,Alaska,547459,361372,337880,23492
2017-07-01,Arizona,5493149,3333523,3171760,161763
2017-07-01,Arkansas,2324707,1353952,1303536,50416
2017-07-01,California,30803890,19201013,18279336,921677
2017-07-01,Colorado,4400398,2991064,2913469,77595
2017-07-01,Connecticut,2878402,1904292,1820854,83438
2017-07-01,Delaware,762579,476718,455623,21095
2017-07-01,Florida,16949383,10045858,9626706,419152
2017-07-01,Georgia,8000403,5117098,4876282,240816
2017-07-01,Hawaii,1094083,679818,665480,14338
2017-07-01,Idaho,1306643,835212,809546,25666
2017-07-01,Illinois,10040493,6485261,6163441,321820
2017-07-01,Indiana,5177619,3330989,3215762,115227
2017-07-01,Iowa,2453207,1688210,1636179,52031
2017-07-01,Kansas,2216971,1486048,1432274,53774
2017-07-01,Kentucky,3477035,2053360,1954844,98516
2017-07-01,Louisiana,3585050,2108807,2003873,104934
2017-07-01,Maine,1099895,700664,676579,24085
2017-07-01,Maryland,4737038,3210414,3080784,129630
2017-07-01,Massachusetts,5586853,3686544,3545472,141072
2017-07-01,Michigan,7954986,4891251,4671432,219819
2017-07-01,Minnesota,4358552,3056135,2952276,103859
2017-07-01,Mississippi,2291018,1274892,1208572,66320
2017-07-01,Missouri,4778332,3060236,2947425,112811
2017-07-01,Montana,834883,526397,504854,21543
2017-07-01,Nebraska,1462522,1018050,988499,29551
2017-07-01,Nevada,2327779,1456066,1383638,72428
2017-07-01,Ohio,9194409,5808288,5518553,289735
2017-07-01,Oklahoma,3000330,1835214,1762128,73086
2017-07-01,Oregon,3336293,2091404,2006490,84914
2017-07-01,Pennsylvania,10249321,6422159,6105265,316894
2017-07-01,Tennessee,5274154,3190171,3079880,110291
2017-07-01,Texas,21270568,13580571,13006707,573864
2017-07-01,Utah,2250729,1549348,1500540,48808
2017-07-01,Vermont,516703,347261,337065,10196
2017-07-01,Virginia,6601547,4345164,4186663,158501
2017-07-01,Washington,5850357,3733560,3561691,171869
2017-07-01,Wisconsin,4590052,3130392,3027959,102433
2017-07-01,Wyoming,448383,295849,283529,12320
2017-08-01,Alabama,3836284,2173420,2080982,92438
2017-08-01,Alaska,547544,360967,337476,23491
2017-08-01,Arizona,5503164,3338499,3177252,161247
2017-08-01,Arkansas,2325716,1354029,1303256,50773
2017-08-01,California,30819479,19207201,18295260,911941
2017-08-01,Colorado,4407473,3000310,2919729,80581
2017-08-01,Connecticut,2879206,1900892,1817915,82977
2017-08-01,Delaware,763394,477559,456485,21074
2017-08-01,Florida,16972737,10047193,9630155,417038
2017-08-01,Georgia,8008915,5123228,4885270,237958
2017-08-01,Hawaii,1094423,678281,664462,13819
2017-08-01,Idaho,1309260,837672,811937,25735
2017-08-01,Illinois,10039057,6487193,6165765,321428
2017-08-01,Indiana,5180760,3332632,3216545,116087
2017-08-01,Iowa,2453951,1687256,1635852,51404
2017-08-01,Kansas,2217666,1485446,1431965,53481
2017-08-01,Kentucky,3478094,2052817,1956097,96720
2017-08-01,Louisiana,3585268,2109984,2006905,103079
2017-08-01,Maine,1100450,700393,676405,23988
2017-08-01,Maryland,4738850,3212288,3081991,130297
2017-08-01,Massachusetts,5589635,3690538,3549475,141063
2017-08-01,Michigan,7957470,4897535,4671469,226066
2017-08-01,Minnesota,4361737,3056876,2954054,102822
2017-08-01,Mississippi,2290790,1273694,1208366,65328
2017-08-01,Missouri,4779763,3059314,2947410,111904
2017-08-01,Montana,835644,526441,504835,21606
2017-08-01,Nebraska,1463343,1018474,988890,29584
2017-08-01,Nevada,2332350,1460204,1388027,72177
2017-08-01,Ohio,9197134,5810790,5522691,288099
2017-08-01,Oklahoma,3001447,1837411,1764665,72746
2017-08-01,Oregon,3339709,2092306,2006395,85911
2017-08-01,Pennsylvania,10251862,6417593,6100495,317098
2017-08-01,Tennessee,5279315,3196140,3086679,109461
2017-08-01,Texas,21298416,13593327,13027129,566198
2017-08-01,Utah,2254998,1551755,1503031,48724
2017-08-01,Vermont,516820,347209,337067,10142
2017-08-01,Virginia,6605682,4347497,4191060,156437
2017-08-01,Washington,5858523,3739479,3565829,173650
2017-08-01,Wisconsin,4592196,3130281,3027790,102491
2017-08-01,Wyoming,448464,295767,283306,12461
2017-09-01,Alabama,3838035,2174284,2083955,90329
2017-09-01,Alaska,547502,360456,337018,23438
2017-09-01,Arizona,5513490,3343281,3181931,161350
2017-09-01,Arkansas,2326910,1353191,1302198,50993
2017-09-01,California,30836381,19205489,18305583,899906
2017-09-01,Colorado,4414637,3007904,2925084,82820
2017-09-01,Connecticut,2880192,1897481,1815026,82455
2017-09-01,Delaware,764246,478093,457096,20997
2017-09-01,Florida,16996993,10049386,9634812,414574
2017-09-01,Georgia,8017782,5126244,4891272,234972
2017-09-01,Hawaii,1094481,676852,663397,13455
2017-09-01,Idaho,1311939,839874,814038,25836
2017-09-01,Illinois,10038262,6486526,6167822,318704
2017-09-01,Indiana,5184267,3332796,3217165,115631
2017-09-01,Iowa,2454856,1685957,1635376,50581
2017-09-01,Kansas,2218423,1484004,1431031,52973
2017-09-01,Kentucky,3479282,2051538,1957165,94373
2017-09-01,Louisiana,3585673,2110547,2009169,101378
2017-09-01,Maine,1101052,699765,676114,23651
2017-09-01,Maryland,4740827,3212242,3081233,131009
2017-09-01,Massachusetts,5592879,3694046,3553339,140707
2017-09-01,Michigan,7960565,4900650,4670169,230481
2017-09-01,Minnesota,4365287,3056493,2955002,101491
2017-09-01,Mississippi,2290654,1272142,1207988,64154
2017-09-01,Missouri,4781508,3057184,2946127,111057
2017-09-01,Montana,836473,526314,504715,21599
2017-09-01,Nebraska,1464244,1018517,988939,29578
2017-09-01,Nevada,2337073,1463974,1392071,71903
2017-09-01,Ohio,9200536,5807977,5523756,284221
2017-09-01,Oklahoma,3002702,1838590,1766356,72234
2017-09-01,Oregon,3343356,2091858,2005446,86412
2017-09-01,Pennsylvania,10255068,6413273,6095963,317310
2017-09-01,Tennessee,5284708,3200884,3091335,109549
2017-09-01,Texas,21327298,13607109,13046231,560878
2017-09-01,Utah,2259385,1553597,1505038,48559
2017-09-01,Vermont,516929,347119,336971,10148
2017-09-01,Virginia,6609542,4347495,4193599,153896
2017-09-01,Washington,5866671,3743944,3569329,174615
2017-09-01,Wisconsin,4594649,3128052,3026722,101330
2017-09-01,Wyoming,448572,295569,282993,12576
2017-10-01,Alabama,3839599,2175287,2086645,88642
2017-10-01,Alaska,547573,359848,336528,23320
2017-10-01,Arizona,5523611,3348460,3186515,161945
2017-10-01,Arkansas,2327969,1351778,1300709,51069
2017-10-01,California,30852515,19197839,18311750,886089
2017-10-01,Colorado,4421760,3014208,2929814,84394
2017-10-01,Connecticut,2881056,1894614,1812716,81898
2017-10-01,Delaware,765073,478334,457505,20829
2017-10-01,Florida,17020550,10055130,9643784,411346
2017-10-01,Georgia,8026805,5126458,4894551,231907
2017-10-01,Hawaii,1094821,675743,662435,13308
2017-10-01,Idaho,1314549,841736,815904,25832
2017-10-01,Illinois,10037181,6484232,6169848,314384
2017-10-01,Indiana,5187398,3332592,3218745,113847
2017-10-01,Iowa,2455642,1684906,1635230,49676
2017-10-01,Kansas,2219134,1482030,1429661,52369
2017-10-01,Kentucky,3480379,2049805,1957957,91848
2017-10-01,Louisiana,3585905,2110276,2010339,99937
2017-10-01,Maine,1101594,698877,675770,23107
2017-10-01,Maryland,4742681,3210692,3079083,131609
2017-10-01,Massachusetts,5595748,3697825,3557753,140072
2017-10-01,Michigan,7963143,4900628,4668899,231729
2017-10-01,Minnesota,4368498,3055419,2955517,99902
2017-10-01,Mississippi,2290413,1270674,1207493,63181
2017-10-01,Missouri,4783136,3054135,2944066,110069
2017-10-01,Montana,837239,526175,504652,21523
2017-10-01,Nebraska,1465130,1018455,988846,29609
2017-10-01,Nevada,2341692,1467530,1395936,71594
2017-10-01,Ohio,9203275,5800315,5522183,278132
2017-10-01,Oklahoma,3003945,1839031,1767593,71438
2017-10-01,Oregon,3346759,2090739,2004265,86474
2017-10-01,Pennsylvania,10257611,6409099,6092440,316659
2017-10-01,Tennessee,5289889,3204138,3094084,110054
2017-10-01,Texas,21355857,13623107,13065751,557356
2017-10-01,Utah,2263655,1555070,1506746,48324
2017-10-01,Vermont,517040,347009,336825,10184
2017-10-01,Virginia,6613781,4345973,4195160,150813
2017-10-01,Washington,5874858,3748170,3573613,174557
2017-10-01,Wisconsin,4596797,3124552,3025510,99042
2017-10-01,Wyoming,448675,295266,282642,12624
2017-11-01,Alabama,3840846,2176815,2089251,87564
2017-11-01,Alaska,547493,359183,336030,23153
2017-11-01,Arizona,5533249,3354747,3191841,162906
2017-11-01,Arkansas,2328862,1350238,1299105,51133
2017-11-01,California,30866794,19188228,18315925,872303
2017-11-01,Colorado,4428527,3019710,2934083,85627
2017-11-01,Connecticut,2881667,1892550,1811201,81349
2017-11-01,Delaware,765819,478380,457801,20579
2017-11-01,Florida,17042366,10065132,9657617,407515
2017-11-01,Georgia,8035420,5124644,4895693,228951
2017-11-01,Hawaii,1094907,675091,661704,13387
2017-11-01,Idaho,1317091,843277,817568,25709
2017-11-01,Illinois,10035540,6480972,6172168,308804
2017-11-01,Indiana,5190316,3333287,3221704,111583
2017-11-01,Iowa,2456255,1684439,1635605,48834
2017-11-01,Kansas,2219649,1480090,1428313,51777
2017-11-01,Kentucky,3481197,2048118,1958520,89598
2017-11-01,Louisiana,3585883,2109668,2010670,98998
2017-11-01,Maine,1102055,697884,675446,22438
2017-11-01,Maryland,4744069,3208246,3076318,131928
2017-11-01,Massachusetts,5598288,3702569,3563231,139338
2017-11-01,Michigan,7965234,4899063,4668803,230260
2017-11-01,Minnesota,4371458,3053958,2955548,98410
2017-11-01,Mississippi,2289988,1269533,1206957,62576
2017-11-01,Missouri,4784494,3050948,2942075,108873
2017-11-01,Montana,837939,526100,504706,21394
2017-11-01,Nebraska,1465866,1018576,988849,29727
2017-11-01,Nevada,2346147,1471033,1399784,71249
2017-11-01,Ohio,9205445,5789953,5518469,271484
2017-11-01,Oklahoma,3005018,1839077,1768585,70492
2017-11-01,Oregon,3349993,2089217,2003003,86214
2017-11-01,Pennsylvania,10259423,6404762,6090015,314747
2017-11-01,Tennessee,5294714,3206656,3095949,110707
2017-11-01,Texas,21383059,13642082,13086199,555883
2017-11-01,Utah,2267884,1556391,1508305,48086
2017-11-01,Vermont,517098,346902,336660,10242
2017-11-01,Virginia,6617090,4344061,4196626,147435
2017-11-01,Washington,5882465,3753036,3579389,173647
2017-11-01,Wisconsin,4598712,3120718,3024296,96422
2017-11-01,Wyoming,448765,294918,282312,12606
2017-12-01,Alabama,3842023,2179230,2092237,86993
2017-12-01,Alaska,547432,358526,335617,22909
2017-12-01,Arizona,5542691,3362580,3199046,163534
2017-12-01,Arkansas,2329671,1349031,1297910,51121
2017-12-01,California,30879995,19182534,18323965,858569
2017-12-01,Colorado,4435085,3025458,2938973,86485
2017-12-01,Connecticut,2882187,1891578,1810954,80624
2017-12-01,Delaware,766575,478425,458213,20212
2017-12-01,Florida,17063554,10078698,9676332,402366
2017-12-01,Georgia,8043726,5122032,4896327,225705
2017-12-01,Hawaii,1094964,675014,661427,13587
2017-12-01,Idaho,1319571,844659,819217,25442
2017-12-01,Illinois,10033620,6477489,6175723,301766
2017-12-01,Indiana,5193094,3336523,3226789,109734
2017-12-01,Iowa,2456773,1684895,1636887,48008
2017-12-01,Kansas,2220045,1478871,1427761,51110
2017-12-01,Kentucky,3481919,2047042,1959220,87822
2017-12-01,Louisiana,3585740,2109360,2010854,98506
2017-12-01,Maine,1102473,697064,675379,21685
2017-12-01,Maryland,4745331,3205929,3074412,131517
2017-12-01,Massachusetts,5600704,3709437,3571124,138313
2017-12-01,Michigan,7967152,4898103,4671444,226659
2017-12-01,Minnesota,4374313,3052877,2955820,97057
2017-12-01,Mississippi,2289575,1268984,1206654,62330
2017-12-01,Missouri,4785721,3048580,2941381,107199
2017-12-01,Montana,838625,526159,504981,21178
2017-12-01,Nebraska,1466539,1019080,989285,29795
2017-12-01,Nevada,2350496,1474724,1404048,70676
2017-12-01,Ohio,9207338,5779940,5514338,265602
2017-12-01,Oklahoma,3005976,1839259,1769890,69369
2017-12-01,Oregon,3353105,2087613,2001932,85681
2017-12-01,Pennsylvania,10260876,6400997,6090204,310793
2017-12-01,Tennessee,5299362,3209518,3098335,111183
2017-12-01,Texas,21409531,13665077,13109868,555209
2017-12-01,Utah,2272008,1557913,1510140,47773
2017-12-01,Vermont,517141,346882,336590,10292
2017-12-01,Virginia,6620166,4343279,4199520,143759
2017-12-01,Washington,5889827,3759169,3587252,171917
2017-12-01,Wisconsin,4600474,3117484,3023479,94005
2017-12-01,Wyoming,448829,294626,282110,12516
2018-01-01,Alabama,3842844,2182961,2096016,86945
2018-01-01,Alaska,547313,357976,335376,22600
2018-01-01,Arizona,5551621,3371802,3208269,163533
2018-01-01,Arkansas,2330250,1348493,1297465,51028
2018-01-01,California,30890810,19186939,18340530,846409
2018-01-01,Colorado,4441224,3032602,2945476,87126
2018-01-01,Connecticut,2882546,1891941,1812205,79736
2018-01-01,Delaware,767213,478737,458994,19743
2018-01-01,Florida,17083177,10094868,9698758,396110
2018-01-01,Georgia,8051351,5120617,4898384,222233
2018-01-01,Hawaii,1094930,675532,661678,13854
2018-01-01,Idaho,1321923,846096,821038,25058
2018-01-01,Illinois,10030718,6474645,6180172,294473
2018-01-01,Indiana,5195245,3343628,3234462,109166
2018-01-01,Iowa,2457002,1686760,1639603,47157
2018-01-01,Kansas,2220190,1478888,1428440,50448
2018-01-01,Kentucky,3482222,2047270,1960528,86742
2018-01-01,Louisiana,3585241,2110256,2011412,98844
2018-01-01,Maine,1102745,696715,675727,20988
2018-01-01,Maryland,4746158,3204969,3074606,130363
2018-01-01,Massachusetts,5602485,3719210,3582134,137076
2018-01-01,Michigan,7968173,4899799,4677844,221955
2018-01-01,Minnesota,4376667,3052881,2957004,95877
2018-01-01,Mississippi,2288841,1269247,1206837,62410
2018-01-01,Missouri,4786436,3047945,2942676,105269
2018-01-01,Montana,839190,526475,505573,20902
2018-01-01,Nebraska,1467060,1020119,990360,29759
2018-01-01,Nevada,2354665,1478950,1409064,69886
2018-01-01,Ohio,9208200,5773937,5512010,261927
2018-01-01,Oklahoma,3006598,1840123,1772069,68054
2018-01-01,Oregon,3355813,2086480,2001475,85005
2018-01-01,Pennsylvania,10261172,6399720,6094610,305110
2018-01-01,Tennessee,5303405,3214031,3102578,111453
2018-01-01,Texas,21434170,13693123,13138321,554802
2018-01-01,Utah,2275847,1559995,1512589,47406
2018-01-01,Vermont,517147,347008,336691,10317
2018-01-01,Virginia,6622634,4345082,4204892,140190
2018-01-01,Washington,5896573,3766857,3597102,169755
2018-01-01,Wisconsin,4601689,3115813,3023388,92425
2018-01-01,Wyoming,448752,294468,282098,12370
2018-02-01,Alabama,3843324,2188262,2100950,87312
2018-02-01,Alaska,547162,357584,335332,22252
2018-02-01,Arizona,5560108,3382193,3219201,162992
2018-02-01,Arkansas,2330637,1348774,1297946,50828
2018-02-01,California,30899826,19204510,18367883,836627
2018-02-01,Colorado,4447177,3041757,2953788,87969
2018-02-01,Connecticut,2882640,1893797,1815043,78754
2018-02-01,Delaware,767793,479452,460238,19214
2018-02-01,Florida,17100836,10112442,9722964,389478
2018-02-01,Georgia,8058536,5121972,4903215,218757
2018-02-01,Hawaii,1094855,676487,662313,14174
2018-02-01,Idaho,1324143,847823,823192,24631
2018-02-01,Illinois,10027117,6473960,6185619,288341
2018-02-01,Indiana,5197039,3354808,3244681,110127
2018-02-01,Iowa,2457017,1690160,1643877,46283
2018-02-01,Kansas,2220217,1480139,1430270,49869
2018-02-01,Kentucky,3482315,2049235,1962904,86331
2018-02-01,Louisiana,3584500,2112853,2012697,100156
2018-02-01,Maine,1102935,697051,676495,20556
2018-02-01,Maryland,4746675,3206152,3077411,128741
2018-02-01,Massachusetts,5604017,3731705,3595898,135807
2018-02-01,Michigan,7968592,4905018,4687974,217044
2018-02-01,Minnesota,4378743,3054190,2959364,94826
2018-02-01,Mississippi,2287915,1270291,1207670,62621
2018-02-01,Missouri,4786746,3049442,2945977,103465
2018-02-01,Montana,839690,527129,506506,20623
2018-02-01,Nebraska,1467492,1021728,992075,29653
2018-02-01,Nevada,2358680,1483928,1414984,68944
2018-02-01,Ohio,9208371,5773989,5513002,260987
2018-02-01,Oklahoma,3007027,1841719,1775155,66564
2018-02-01,Oregon,3358353,2086099,2001846,84253
2018-02-01,Pennsylvania,10260662,6402748,6103969,298779
2018-02-01,Tennessee,5307103,3221015,3109516,111499
2018-02-01,Texas,21457851,13726198,13171861,554337
2018-02-01,Utah,2279686,1562818,1515805,47013
2018-02-01,Vermont,517110,347283,336985,10298
2018-02-01,Virginia,6624733,4350085,4213072,137013
2018-02-01,Washington,5903000,3775904,3608234,167670
2018-02-01,Wisconsin,4602577,3116020,3023966,92054
2018-02-01,Wyoming,448751,294517,282309,12208
2018-03-01,Alabama,3844151,2194413,2106567,87846
2018-03-01,Alaska,547013,357334,335453,21881
2018-03-01,Arizona,5568852,3393031,3230988,162043
2018-03-01,Arkansas,2331244,1349706,1299277,50429
2018-03-01,California,30909161,19230515,18402166,828349
2018-03-01,Colorado,4453360,3052129,2962859,89270
2018-03-01,Connecticut,2882894,1896858,1819188,77670
2018-03-01,Delaware,768427,480397,461728,18669
2018-03-01,Florida,17119346,10129065,9746259,382806
2018-03-01,Georgia,8066189,5125263,4910072,215191
2018-03-01,Hawaii,1094601,677536,663025,14511
2018-03-01,Idaho,1326556,849801,825587,24214
2018-03-01,Illinois,10024274,6475075,6191213,283862
2018-03-01,Indiana,5199477,3368255,3256239,112016
2018-03-01,Iowa,2457371,1694429,1649080,45349
2018-03-01,Kansas,2220385,1482004,1432705,49299
2018-03-01,Kentucky,3482775,2052231,1966007,86224
2018-03-01,Louisiana,3584009,2116436,2014495,101941
2018-03-01,Maine,1103257,697913,677414,20499
2018-03-01,Maryland,4747351,3209128,3082124,127004
2018-03-01,Massachusetts,5605957,3745005,3610502,134503
2018-03-01,Michigan,7969842,4911910,4699988,211922
2018-03-01,Minnesota,4381261,3056279,2962612,93667
2018-03-01,Mississippi,2287263,1271591,1208890,62701
2018-03-01,Missouri,4787572,3051958,2950244,101714
2018-03-01,Montana,840283,528027,507660,20367
2018-03-01,Nebraska,1468056,1023608,994139,29469
2018-03-01,Nevada,2362787,1489418,1421502,67916
2018-03-01,Ohio,9209589,5778905,5516995,261910
2018-03-01,Oklahoma,3007661,1843317,1778506,64811
2018-03-01,Oregon,3361174,2086069,2002748,83321
2018-03-01,Pennsylvania,10261195,6409669,6116996,292673
2018-03-01,Tennessee,5311385,3229830,3118348,111482
2018-03-01,Texas,21481979,13760252,13207711,552541
2018-03-01,Utah,2283762,1566099,1519478,46621
2018-03-01,Vermont,517126,347602,337411,10191
2018-03-01,Virginia,6627094,4357000,4222810,134190
2018-03-01,Washington,5909842,3785391,3619556,165835
2018-03-01,Wisconsin,4603990,3117125,3024438,92687
2018-03-01,Wyoming,448769,294716,282659,12057
2018-04-01,Alabama,3845163,2199908,2111657,88251
2018-04-01,Alaska,546953,357074,335568,21506
2018-04-01,Arizona,5577991,3403018,3242081,160937
2018-04-01,Arkansas,2331994,1350582,1300793,49789
2018-04-01,California,30920923,19253408,18432929,820479
2018-04-01,Colorado,4459903,3061667,2970736,90931
2018-04-01,Connecticut,2883318,1900268,1823822,76446
2018-04-01,Delaware,769129,481109,462946,18163
2018-04-01,Florida,17138968,10142429,9766492,375937
2018-04-01,Georgia,8074439,5126921,4915738,211183
2018-04-01,Hawaii,1094559,678188,663346,14842
2018-04-01,Idaho,1329009,851659,827821,23838
2018-04-01,Illinois,10022064,6475418,6194840,280578
2018-04-01,Indiana,5202122,3380235,3266486,113749
2018-04-01,Iowa,2457850,1698163,1653820,44343
2018-04-01,Kansas,2220716,1483562,1434887,48675
2018-04-01,Kentucky,3483458,2054773,1968609,86164
2018-04-01,Louisiana,3583789,2119160,2015748,103412
2018-04-01,Maine,1103646,698806,677999,20807
2018-04-01,Maryland,4748453,3211975,3086643,125332
2018-04-01,Massachusetts,5608217,3756373,3623302,133071
2018-04-01,Michigan,7971408,4916643,4710297,206346
2018-04-01,Minnesota,4384009,3057591,2965374,92217
2018-04-01,Mississippi,2286692,1272237,1209728,62509
2018-04-01,Missouri,4788659,3053598,2953666,99932
2018-04-01,Montana,840926,528864,508721,20143
2018-04-01,Nebraska,1468702,1025187,996003,29184
2018-04-01,Nevada,2367014,1494703,1427845,66858
2018-04-01,Ohio,9211216,5784668,5521643,263025
2018-04-01,Oklahoma,3008550,1843631,1780922,62709
2018-04-01,Oregon,3364161,2085619,2003488,82131
2018-04-01,Pennsylvania,10262265,6417656,6130260,287396
2018-04-01,Tennessee,5315866,3238203,3126526,111677
2018-04-01,Texas,21507743,13787345,13239109,548236
2018-04-01,Utah,2287936,1569078,1522836,46242
2018-04-01,Vermont,517166,347794,337818,9976
2018-04-01,Virginia,6630075,4362275,4230745,131530
2018-04-01,Washington,5917125,3793493,3629330,164163
2018-04-01,Wisconsin,4605623,3117197,3023573,93624
2018-04-01,Wyoming,448778,294881,282952,11929
2018-05-01,Alabama,3846214,2204018,2115600,88418
2018-05-01,Alaska,546849,356751,335562,21189
2018-05-01,Arizona,5587102,3411942,3251635,160307
2018-05-01,Arkansas,2332706,1350984,1301886,49098
2018-05-01,California,30932127,19266305,18452187,814118
2018-05-01,Colorado,4466430,3069014,2976321,92693
2018-05-01,Connecticut,2883769,1903173,1827941,75232
2018-05-01,Delaware,769793,481368,463601,17767
2018-05-01,Florida,17159029,10152646,9783249,369397
2018-05-01,Georgia,8082472,5124874,4917827,207047
2018-05-01,Hawaii,1094494,678080,662878,15202
2018-05-01,Idaho,1331478,853206,829637,23569
2018-05-01,Illinois,10019843,6474084,6195369,278715
2018-05-01,Indiana,5204828,3388093,3273253,114840
2018-05-01,Iowa,2458351,1700602,1657136,43466
2018-05-01,Kansas,2221142,1484310,1436137,48173
2018-05-01,Kentucky,3484178,2055956,1969707,86249
2018-05-01,Louisiana,3583521,2120097,2015790,104307
2018-05-01,Maine,1104078,699368,677975,21393
2018-05-01,Maryland,4749436,3213273,3089369,123904
2018-05-01,Massachusetts,5610576,3764502,3632876,131626
2018-05-01,Michigan,7973138,4917756,4716518,201238
2018-05-01,Minnesota,4386886,3057515,2966661,90854
2018-05-01,Mississippi,2286106,1271766,1209656,62110
2018-05-01,Missouri,4789836,3053492,2955112,98380
2018-05-01,Montana,841612,529432,509458,19974
2018-05-01,Nebraska,1469394,1026190,997262,28928
2018-05-01,Nevada,2371246,1499417,1433492,65925
2018-05-01,Ohio,9212935,5788378,5524996,263382
2018-05-01,Oklahoma,3009443,1842245,1781734,60511
2018-05-01,Oregon,3367204,2084570,2003509,81061
2018-05-01,Pennsylvania,10263521,6424860,6140956,283904
2018-05-01,Tennessee,5320415,3244648,3132230,112418
2018-05-01,Texas,21533031,13804383,13261553,542830
2018-05-01,Utah,2292135,1571338,1525399,45939
2018-05-01,Vermont,517233,347768,338091,9677
2018-05-01,Virginia,6632998,4363522,4234415,129107
2018-05-01,Washington,5924416,3799729,3636666,163063
2018-05-01,Wisconsin,4607399,3115023,3020609,94414
2018-05-01,Wyoming,448836,294922,283074,11848
2018-06-01,Alabama,3847544,2207073,2118912,88161
2018-06-01,Alaska,546842,356386,335437,20949
2018-06-01,Arizona,5596687,3420589,3260103,160486
2018-06-01,Arkansas,2333693,1351120,1302603,48517
2018-06-01,California,30945958,19270242,18460417,809825
2018-06-01,Colorado,4473320,3074101,2979881,94220
2018-06-01,Connecticut,2884412,1905435,1831333,74102
2018-06-01,Delaware,770534,481274,463790,17484
2018-06-01,Florida,17180446,10160799,9797419,363380
2018-06-01,Georgia,8091122,5120023,4916843,203180
2018-06-01,Hawaii,1094527,677250,661656,15594
2018-06-01,Idaho,1334068,854488,831059,23429
2018-06-01,Illinois,10018412,6471829,6193825,278004
2018-06-01,Indiana,5207986,3391359,3276087,115272
2018-06-01,Iowa,2459105,1701899,1659049,42850
2018-06-01,Kansas,2221740,1484247,1436387,47860
2018-06-01,Kentucky,3485194,2055805,1969481,86324
2018-06-01,Louisiana,3583497,2119425,2014944,104481
2018-06-01,Maine,1104553,699517,677472,22045
2018-06-01,Maryland,4750835,3213197,3090654,122543
2018-06-01,Massachusetts,5613358,3769575,3639452,130123
2018-06-01,Michigan,7975494,4916598,4718713,197885
2018-06-01,Minnesota,4390089,3056725,2966924,89801
2018-06-01,Mississippi,2285729,1270400,1208844,61556
2018-06-01,Missouri,4791444,3051919,2954854,97065
2018-06-01,Montana,842349,529731,509881,19850
2018-06-01,Nebraska,1470220,1026709,997935,28774
2018-06-01,Nevada,2375683,1503645,1438463,65182
2018-06-01,Ohio,9215446,5789189,5526823,262366
2018-06-01,Oklahoma,3010581,1839765,1781269,58496
2018-06-01,Oregon,3370550,2083578,2003041,80537
2018-06-01,Pennsylvania,10265616,6430815,6148676,282139
2018-06-01,Tennessee,5325367,3249692,3136100,113592
2018-06-01,Texas,21560149,13813952,13276750,537202
2018-06-01,Utah,2296468,1573018,1527284,45734
2018-06-01,Vermont,517318,347508,338197,9311
2018-06-01,Virginia,6636443,4361696,4234693,127003
2018-06-01,Washington,5932181,3805332,3642504,162828
2018-06-01,Wisconsin,4609561,3110709,3015956,94753
2018-06-01,Wyoming,448910,294888,283058,11830
2018-07-01,Alabama,3848927,2209486,2122081,87405
2018-07-01,Alaska,546800,355997,335238,20759
2018-07-01,Arizona,5606364,3429631,3268114,161517
2018-07-01,Arkansas,2334646,1351324,1303180,48144
2018-07-01,California,30959830,19268853,18461524,807329
2018-07-01,Colorado,4480233,3077524,2982172,95352
2018-07-01,Connecticut,2885151,1907281,1834216,73065
2018-07-01,Delaware,771294,481027,463754,17273
2018-07-01,Florida,17202053,10168495,9810226,358269
2018-07-01,Georgia,8099961,5114194,4914255,199939
2018-07-01,Hawaii,1094542,675970,659970,16000
2018-07-01,Idaho,1336679,855618,832227,23391
2018-07-01,Illinois,10017132,6469057,6191198,277859
2018-07-01,Indiana,5211178,3390366,3275234,115132
2018-07-01,Iowa,2459864,1702498,1659981,42517
2018-07-01,Kansas,2222318,1483713,1435984,47729
2018-07-01,Kentucky,3486211,2054538,1968263,86275
2018-07-01,Louisiana,3583576,2117389,2013613,103776
2018-07-01,Maine,1105094,699250,676703,22547
2018-07-01,Maryland,4752274,3212560,3091527,121033
2018-07-01,Massachusetts,5616196,3772277,3643761,128516
2018-07-01,Michigan,7977918,4914886,4718428,196458
2018-07-01,Minnesota,4393361,3056034,2966981,89053
2018-07-01,Mississippi,2285366,1268712,1207617,61095
2018-07-01,Missouri,4793072,3049568,2953691,95877
2018-07-01,Montana,843114,529899,510161,19738
2018-07-01,Nebraska,1471009,1027013,998342,28671
2018-07-01,Nevada,2380077,1507577,1442964,64613
2018-07-01,Ohio,9218047,5788201,5527800,260401
2018-07-01,Oklahoma,3011765,1836927,1780107,56820
2018-07-01,Oregon,3373930,2083007,2002204,80803
2018-07-01,Pennsylvania,10267863,6435383,6154147,281236
2018-07-01,Tennessee,5330423,3253735,3139083,114652
2018-07-01,Texas,21587399,13820010,13288411,531599
2018-07-01,Utah,2300883,1574389,1528807,45582
2018-07-01,Vermont,517426,347042,338124,8918
2018-07-01,Virginia,6639962,4358677,4233607,125070
2018-07-01,Washington,5940044,3811529,3648109,163420
2018-07-01,Wisconsin,4611747,3105219,3010677,94542
2018-07-01,Wyoming,448998,294834,282972,11862
2018-08-01,Alabama,3850814,2212016,2125526,86490
2018-08-01,Alaska,546781,355617,334975,20642
2018-08-01,Arizona,5617446,3440243,3276561,163682
2018-08-01,Arkansas,2335827,1352139,1303997,48142
2018-08-01,California,30970329,19270079,18461462,808617
2018-08-01,Colorado,4486530,3080565,2984346,96219
2018-08-01,Connecticut,2885383,1909124,1836818,72306
2018-08-01,Delaware,772185,480933,463791,17142
2018-08-01,Florida,17223189,10178508,9823085,355423
2018-08-01,Georgia,8109883,5110058,4911908,198150
2018-08-01,Hawaii,1094296,674563,658106,16457
2018-08-01,Idaho,1339682,856913,833422,23491
2018-08-01,Illinois,10016480,6467671,6188958,278713
2018-08-01,Indiana,5214498,3387434,3272499,114935
2018-08-01,Iowa,2461141,1703333,1660747,42586
2018-08-01,Kansas,2223002,1483428,1435542,47886
2018-08-01,Kentucky,3487490,2053047,1966805,86242
2018-08-01,Louisiana,3584025,2114941,2012209,102732
2018-08-01,Maine,1105765,698811,675981,22830
2018-08-01,Maryland,4753977,3213051,3093337,119714
2018-08-01,Massachusetts,5618480,3774325,3647139,127186
2018-08-01,Michigan,7979891,4915118,4718222,196896
2018-08-01,Minnesota,4396490,3056843,2967632,89211
2018-08-01,Mississippi,2285791,1267636,1206365,61271
2018-08-01,Missouri,4795418,3047803,2952775,95028
2018-08-01,Montana,843928,530192,510521,19671
2018-08-01,Nebraska,1471841,1027610,998876,28734
2018-08-01,Nevada,2384929,1511751,1447388,64363
2018-08-01,Ohio,9221239,5789478,5530446,259032
2018-08-01,Oklahoma,3013749,1834604,1778785,55819
2018-08-01,Oregon,3377359,2083770,2001773,81997
2018-08-01,Pennsylvania,10269662,6439999,6159078,280921
2018-08-01,Tennessee,5335262,3258019,3142661,115358
2018-08-01,Texas,21619194,13828877,13300862,528015
2018-08-01,Utah,2305312,1575998,1530465,45533
2018-08-01,Vermont,517535,346511,337949,8562
2018-08-01,Virginia,6644538,4357084,4233403,123681
2018-08-01,Washington,5947638,3819548,3654812,164736
2018-08-01,Wisconsin,4614177,3100243,3006087,94156
2018-08-01,Wyoming,449256,294837,282913,11924
2018-09-01,Alabama,3852862,2215093,2129494,85599
2018-09-01,Alaska,546810,355262,334648,20614
2018-09-01,Arizona,5628819,3452490,3285694,166796
2018-09-01,Arkansas,2337119,1353808,1305242,48566
2018-09-01,California,30982488,19278256,18464140,814116
2018-09-01,Colorado,4493046,3084266,2987503,96763
2018-09-01,Connecticut,2885801,1911006,1839115,71891
2018-09-01,Delaware,773154,481160,464075,17085
2018-09-01,Florida,17245228,10191438,9836152,355286
2018-09-01,Georgia,8120220,5108726,4910760,197966
2018-09-01,Hawaii,1094105,673225,656251,16974
2018-09-01,Idaho,1342766,858575,834807,23768
2018-09-01,Illinois,10016318,6468643,6187856,280787
2018-09-01,Indiana,5218075,3384907,3269816,115091
2018-09-01,Iowa,2462548,1704965,1662001,42964
2018-09-01,Kansas,2223814,1483781,1435489,48292
2018-09-01,Kentucky,3488910,2052059,1965835,86224
2018-09-01,Louisiana,3584643,2113166,2011109,102057
2018-09-01,Maine,1106507,698422,675550,22872
2018-09-01,Maryland,4755987,3215658,3096714,118944
2018-09-01,Massachusetts,5621085,3776708,3650408,126300
2018-09-01,Michigan,7982196,4918359,4719671,198688
2018-09-01,Minnesota,4399843,3059533,2968877,90656
2018-09-01,Mississippi,2286353,1267533,1205274,62259
2018-09-01,Missouri,4797969,3047698,2952946,94752
2018-09-01,Montana,844790,530703,511062,19641
2018-09-01,Nebraska,1472783,1028717,999678,29039
2018-09-01,Nevada,2389933,1516485,1452009,64476
2018-09-01,Ohio,9224861,5795216,5535911,259305
2018-09-01,Oklahoma,3015886,1833310,1777570,55740
2018-09-01,Oregon,3380908,2086354,2002439,83915
2018-09-01,Pennsylvania,10271919,6445572,6164598,280974
2018-09-01,Tennessee,5340338,3263749,3148219,115530
2018-09-01,Texas,21652158,13843885,13316200,527685
2018-09-01,Utah,2309837,1578152,1532590,45562
2018-09-01,Vermont,517681,346038,337762,8276
2018-09-01,Virginia,6649427,4358761,4235458,123303
2018-09-01,Washington,5955494,3829378,3662492,166886
2018-09-01,Wisconsin,4616745,3096571,3002676,93895
2018-09-01,Wyoming,449533,294898,282959,11939
2018-10-01,Alabama,3854756,2218770,2134057,84713
2018-10-01,Alaska,546788,354987,334327,20660
2018-10-01,Arizona,5639899,3465247,3294961,170286
2018-10-01,Arkansas,2338313,1356111,1306904,49207
2018-10-01,California,30992869,19293358,18471026,822332
2018-10-01,Colorado,4499357,3088998,2992253,96745
2018-10-01,Connecticut,2886031,1912705,1840959,71746
2018-10-01,Delaware,774073,481767,464695,17072
2018-10-01,Florida,17266363,10205938,9848907,357031
2018-10-01,Georgia,8130168,5109997,4911177,198820
2018-10-01,Hawaii,1093829,672060,654568,17492
2018-10-01,Idaho,1345769,860610,836399,24211
2018-10-01,Illinois,10015684,6471017,6187236,283781
2018-10-01,Indiana,5221428,3384050,3268290,115760
2018-10-01,Iowa,2463857,1707672,1664072,43600
2018-10-01,Kansas,2224508,1484784,1435982,48802
2018-10-01,Kentucky,3490193,2051989,1965753,86236
2018-10-01,Louisiana,3585062,2112204,2010424,101780
2018-10-01,Maine,1107211,698151,675484,22667
2018-10-01,Maryland,4757696,3220485,3101703,118782
2018-10-01,Massachusetts,5623415,3779466,3653764,125702
2018-10-01,Michigan,7984164,4924179,4722933,201246
2018-10-01,Minnesota,4402999,3063412,2970270,93142
2018-10-01,Mississippi,2286775,1268334,1204462,63872
2018-10-01,Missouri,4800342,3049782,2954580,95202
2018-10-01,Montana,845583,531356,511722,19634
2018-10-01,Nebraska,1473613,1030316,1000760,29556
2018-10-01,Nevada,2394798,1521728,1456914,64814
2018-10-01,Ohio,9228042,5804046,5543346,260700
2018-10-01,Oklahoma,3017853,1833190,1776737,56453
2018-10-01,Oregon,3384353,2090454,2004408,86046
2018-10-01,Pennsylvania,10273714,6452492,6171169,281323
2018-10-01,Tennessee,5345197,3271345,3156200,115145
2018-10-01,Texas,21683967,13864768,13335259,529509
2018-10-01,Utah,2314283,1580850,1535286,45564
2018-10-01,Vermont,517774,345660,337597,8063
2018-10-01,Virginia,6654002,4364231,4240248,123983
2018-10-01,Washington,5963059,3840188,3670355,169833
2018-10-01,Wisconsin,4619204,3094379,3000471,93908
2018-10-01,Wyoming,449778,294995,283131,11864
2018-11-01,Alabama,3856154,2222802,2139030,83772
2018-11-01,Alaska,546733,354791,334087,20704
2018-11-01,Arizona,5650376,3477513,3304082,173431
2018-11-01,Arkansas,2339226,1358656,1308923,49733
2018-11-01,California,31000966,19311991,18481262,830729
2018-11-01,Colorado,4505271,3094552,2998449,96103
2018-11-01,Connecticut,2885954,1914128,1842422,71706
2018-11-01,Delaware,774895,482709,465633,17076
2018-11-01,Florida,17285441,10220222,9861136,359086
2018-11-01,Georgia,8139345,5113084,4913287,199797
2018-11-01,Hawaii,1093583,671088,653151,17937
2018-11-01,Idaho,1348642,862994,838269,24725
2018-11-01,Illinois,10013950,6474852,6187073,287779
2018-11-01,Indiana,5224176,3385579,3268810,116769
2018-11-01,Iowa,2464858,1711649,1667225,44424
2018-11-01,Kansas,2224934,1486153,1436908,49245
2018-11-01,Kentucky,3491101,2052885,1966565,86320
2018-11-01,Louisiana,3585137,2111546,2010065,101481
2018-11-01,Maine,1107768,697896,675669,22227
2018-11-01,Maryland,4758978,3227063,3107999,119064
2018-11-01,Massachusetts,5625242,3782165,3657030,125135
2018-11-01,Michigan,7985290,4931644,4727384,204260
2018-11-01,Minnesota,4405705,3067728,2971706,96022
2018-11-01,Mississippi,2286954,1269864,1203942,65922
2018-11-01,Missouri,4802145,3053543,2957393,96150
2018-11-01,Montana,846300,532085,512437,19648
2018-11-01,Nebraska,1474305,1032250,1002062,30188
2018-11-01,Nevada,2399462,1527304,1462170,65134
2018-11-01,Ohio,9230154,5813355,5552197,261158
2018-11-01,Oklahoma,3019516,1834179,1776669,57510
2018-11-01,Oregon,3387402,2095533,2007705,87828
2018-11-01,Pennsylvania,10274249,6460337,6178551,281786
2018-11-01,Tennessee,5349521,3280821,3166444,114377
2018-11-01,Texas,21713757,13888671,13357878,530793
2018-11-01,Utah,2318480,1584026,1538597,45429
2018-11-01,Vermont,517846,345389,337476,7913
2018-11-01,Virginia,6657983,4372860,4247614,125246
2018-11-01,Washington,5970124,3851215,3678279,172936
2018-11-01,Wisconsin,4621113,3093703,2999369,94334
2018-11-01,Wyoming,449941,295102,283416,11686
2018-12-01,Alabama,3857442,2226751,2144197,82554
2018-12-01,Alaska,546663,354566,333931,20635
2018-12-01,Arizona,5660505,3488395,3312873,175522
2018-12-01,Arkansas,2340021,1360949,1311102,49847
2018-12-01,California,31007415,19327664,18492465,835199
2018-12-01,Colorado,4510886,3099887,3005135,94752
2018-12-01,Connecticut,2885775,1915020,1843489,71531
2018-12-01,Delaware,775662,483777,466721,17056
2018-12-01,Florida,17303538,10232330,9872842,359488
2018-12-01,Georgia,8148150,5116798,4916885,199913
2018-12-01,Hawaii,1093269,670180,651974,18206
2018-12-01,Idaho,1351412,865525,840393,25132
2018-12-01,Illinois,10011743,6479035,6187431,291604
2018-12-01,Indiana,5226671,3388040,3270676,117364
2018-12-01,Iowa,2465707,1716455,1671199,45256
2018-12-01,Kansas,2225238,1487403,1437993,49410
2018-12-01,Kentucky,3491863,2054479,1968189,86290
2018-12-01,Louisiana,3585010,2110632,2009979,100653
2018-12-01,Maine,1108245,697440,675886,21554
2018-12-01,Maryland,4760033,3234226,3114968,119258
2018-12-01,Massachusetts,5626729,3784000,3659729,124271
2018-12-01,Michigan,7986018,4938752,4731861,206891
2018-12-01,Minnesota,4408141,3071438,2973113,98325
2018-12-01,Mississippi,2287035,1271512,1203781,67731
2018-12-01,Missouri,4803671,3057685,2960620,97065
2018-12-01,Montana,846955,532808,513165,19643
2018-12-01,Nebraska,1474901,1034171,1003405,30766
2018-12-01,Nevada,2403986,1532865,1467684,65181
2018-12-01,Ohio,9231796,5820069,5561420,258649
2018-12-01,Oklahoma,3020959,1835859,1777527,58332
2018-12-01,Oregon,3390287,2100526,2011924,88602
2018-12-01,Pennsylvania,10274249,6467194,6185428,281766
2018-12-01,Tennessee,5353537,3291684,3178225,113459
2018-12-01,Texas,21742357,13910127,13382106,528021
2018-12-01,Utah,2322551,1587436,1542359,45077
2018-12-01,Vermont,517887,345196,337387,7809
2018-12-01,Virginia,6661589,4383123,4256692,126431
2018-12-01,Washington,5976850,3861335,3686272,175063
2018-12-01,Wisconsin,4622766,3093618,2998620,94998
2018-12-01,Wyoming,450154,295151,283759,11392
2019-01-01,Alabama,3858512,2229899,2149188,80711
2019-01-01,Alaska,546579,354226,333822,20404
2019-01-01,Arizona,5670393,3497563,3321318,176245
2019-01-01,Arkansas,2340710,1362495,1313091,49404
2019-01-01,California,31012788,19334306,18501317,832989
2019-01-01,Colorado,4516317,3104049,3011353,92696
2019-01-01,Connecticut,2885407,1915116,1844065,71051
2019-01-01,Delaware,776420,484604,467642,16962
2019-01-01,Florida,17320950,10240878,9884007,356871
2019-01-01,Georgia,8156579,5119814,4921294,198520
2019-01-01,Hawaii,1092891,669216,650983,18233
2019-01-01,Idaho,1354143,867880,842597,25283
2019-01-01,Illinois,10009039,6481193,6188462,292731
2019-01-01,Indiana,5228912,3389065,3272106,116959
2019-01-01,Iowa,2466434,1720862,1674943,45919
2019-01-01,Kansas,2225406,1488175,1439031,49144
2019-01-01,Kentucky,3492386,2056192,1970166,86026
2019-01-01,Louisiana,3584760,2109231,2010280,98951
2019-01-01,Maine,1108679,696627,675932,20695
2019-01-01,Maryland,4760866,3240729,3121909,118820
2019-01-01,Massachusetts,5627960,3784356,3661520,122836
2019-01-01,Michigan,7986297,4943420,4735037,208383
2019-01-01,Minnesota,4410297,3073895,2974372,99523
2019-01-01,Mississippi,2287007,1272778,1203954,68824
2019-01-01,Missouri,4804992,3061111,2963576,97535
2019-01-01,Montana,847596,533342,513765,19577
2019-01-01,Nebraska,1475406,1035771,1004580,31191
2019-01-01,Nevada,2408437,1538037,1473244,64793
2019-01-01,Ohio,9232906,5821680,5569078,252602
2019-01-01,Oklahoma,3022283,1837515,1778982,58533
2019-01-01,Oregon,3392962,2104052,2016017,88035
2019-01-01,Pennsylvania,10273786,6471515,6190529,280986
2019-01-01,Tennessee,5357263,3302421,3189960,112461
2019-01-01,Texas,21770174,13925005,13405426,519579
2019-01-01,Utah,2326530,1590728,1546260,44468
2019-01-01,Vermont,517878,345044,337315,7729
2019-01-01,Virginia,6664897,4392956,4266093,126863
2019-01-01,Washington,5983264,3869370,3694099,175271
2019-01-01,Wisconsin,4624157,3093213,2997422,95791
2019-01-01,Wyoming,450258,295087,284091,10996
2019-02-01,Alabama,3859089,2231539,2153542,77997
2019-02-01,Alaska,546404,353848,333818,20030
2019-02-01,Arizona,5679559,3505030,3329490,175540
2019-02-01,Arkansas,2341109,1363048,1314551,48497
2019-02-01,California,31014817,19329357,18505844,823513
2019-02-01,Colorado,4521344,3106730,3016857,89873
2019-02-01,Connecticut,2884720,1914273,1844132,70141
2019-02-01,Delaware,777040,485013,468253,16760
2019-02-01,Florida,17335625,10246115,9895249,350866
2019-02-01,Georgia,8164162,5121124,4925912,195212
2019-02-01,Hawaii,1092373,668172,650161,18011
2019-02-01,Idaho,1356695,869873,844753,25120
2019-02-01,Illinois,10005294,6479413,6189942,289471
2019-02-01,Indiana,5230605,3387179,3271793,115386
2019-02-01,Iowa,2466914,1724077,1677806,46271
2019-02-01,Kansas,2225385,1488377,1439945,48432
2019-02-01,Kentucky,3492597,2057471,1971899,85572
2019-02-01,Louisiana,3584066,2107156,2010838,96318
2019-02-01,Maine,1108981,695458,675738,19720
2019-02-01,Maryland,4761146,3245796,3128338,117458
2019-02-01,Massachusetts,5628669,3783198,3662566,120632
2019-02-01,Michigan,7985730,4945098,4736749,208349
2019-02-01,Minnesota,4412091,3075308,2975818,99490
2019-02-01,Mississippi,2286684,1273521,1204365,69156
2019-02-01,Missouri,4805762,3063239,2965866,97373
2019-02-01,Montana,848103,533591,514177,19414
2019-02-01,Nebraska,1475799,1036833,1005468,31365
2019-02-01,Nevada,2412610,1542686,1478727,63959
2019-02-01,Ohio,9233071,5818965,5574672,244293
2019-02-01,Oklahoma,3023300,1838736,1780731,58005
2019-02-01,Oregon,3395298,2105435,2019199,86236
2019-02-01,Pennsylvania,10272066,6472348,6193118,279230
2019-02-01,Tennessee,5360432,3311358,3200006,111352
2019-02-01,Texas,21795969,13933148,13426644,506504
2019-02-01,Utah,2330395,1593690,1550084,43606
2019-02-01,Vermont,517850,344853,337215,7638
2019-02-01,Virginia,6667480,4400891,4274830,126061
2019-02-01,Washington,5989125,3875239,3702019,173220
2019-02-01,Wisconsin,4625075,3092376,2995774,96602
2019-02-01,Wyoming,450382,294948,284366,10582
2019-03-01,Alabama,3860039,2231949,2157197,74752
2019-03-01,Alaska,546284,353549,333909,19640
2019-03-01,Arizona,5689006,3511703,3337412,174291
2019-03-01,Arkansas,2341740,1362776,1315205,47571
2019-03-01,California,31017497,19317936,18507077,810859
2019-03-01,Colorado,4526747,3108718,3022045,86673
2019-03-01,Connecticut,2884267,1913006,1843951,69055
2019-03-01,Delaware,777740,485202,468646,16556
2019-03-01,Florida,17351326,10251856,9908175,343681
2019-03-01,Georgia,8172347,5121857,4930893,190964
2019-03-01,Hawaii,1091842,667192,649533,17659
2019-03-01,Idaho,1359388,871655,846865,24790
2019-03-01,Illinois,10002260,6474417,6192065,282352
2019-03-01,Indiana,5232865,3382749,3269690,113059
2019-03-01,Iowa,2467642,1726422,1679946,46476
2019-03-01,Kansas,2225581,1488364,1440776,47588
2019-03-01,Kentucky,3493161,2058799,1973474,85325
2019-03-01,Louisiana,3583666,2105146,2011546,93600
2019-03-01,Maine,1109377,694264,675443,18821
2019-03-01,Maryland,4761718,3249927,3134185,115742
2019-03-01,Massachusetts,5629802,3781651,3663545,118106
2019-03-01,Michigan,7985849,4945693,4737913,207780
2019-03-01,Minnesota,4414293,3076838,2978103,98735
2019-03-01,Mississippi,2286551,1274119,1204988,69131
2019-03-01,Missouri,4807015,3064481,2967585,96896
2019-03-01,Montana,848735,533751,514527,19224
2019-03-01,Nebraska,1476308,1037455,1006093,31362
2019-03-01,Nevada,2416855,1547115,1484140,62975
2019-03-01,Ohio,9234157,5816150,5579091,237059
2019-03-01,Oklahoma,3024561,1839713,1782614,57099
2019-03-01,Oregon,3397908,2105348,2021425,83923
2019-03-01,Pennsylvania,10271309,6471650,6193849,277801
2019-03-01,Tennessee,5364123,3318354,3207976,110378
2019-03-01,Texas,21822493,13939862,13446764,493098
2019-03-01,Utah,2334391,1596458,1553781,42677
2019-03-01,Vermont,517867,344585,337039,7546
2019-03-01,Virginia,6670614,4406888,4282641,124247
2019-03-01,Washington,5995444,3880632,3710734,169898
2019-03-01,Wisconsin,4626472,3091788,2994026,97762
2019-03-01,Wyoming,450554,294879,284585,10294
2019-04-01,Alabama,3861170,2231885,2160522,71363
2019-04-01,Alaska,546243,353455,334118,19337
2019-04-01,Arizona,5698836,3518531,3345552,172979
2019-04-01,Arkansas,2342453,1362147,1315218,46929
2019-04-01,California,31022564,19307869,18509723,798146
2019-04-01,Colorado,4532350,3111401,3027728,83673
2019-04-01,Connecticut,2883945,1912141,1844115,68026
2019-04-01,Delaware,778516,485472,469010,16462
2019-04-01,Florida,17368100,10262411,9924815,337596
2019-04-01,Georgia,8180996,5124177,4937384,186793
2019-04-01,Hawaii,1091436,666492,649218,17274
2019-04-01,Idaho,1362162,873540,849086,24454
2019-04-01,Illinois,9999793,6468028,6195174,272854
2019-04-01,Indiana,5235328,3377518,3267048,110470
2019-04-01,Iowa,2468454,1728498,1681846,46652
2019-04-01,Kansas,2225860,1488596,1441764,46832
2019-04-01,Kentucky,3493890,2060715,1975453,85262
2019-04-01,Louisiana,3583469,2104457,2012866,91591
2019-04-01,Maine,1109866,693551,675339,18212
2019-04-01,Maryland,4762584,3254220,3139974,114246
2019-04-01,Massachusetts,5631202,3780674,3664967,115707
2019-04-01,Michigan,7986340,4947165,4739875,207290
2019-04-01,Minnesota,4416696,3079545,2981872,97673
2019-04-01,Mississippi,2286578,1275117,1205974,69143
2019-04-01,Missouri,4808486,3065787,2969425,96362
2019-04-01,Montana,849362,534099,515027,19072
2019-04-01,Nebraska,1476899,1037923,1006710,31213
2019-04-01,Nevada,2421273,1551757,1489729,62028
2019-04-01,Ohio,9235661,5816663,5583268,233395
2019-04-01,Oklahoma,3025979,1840830,1784644,56186
2019-04-01,Oregon,3400710,2104724,2023005,81719
2019-04-01,Pennsylvania,10271002,6472106,6194704,277402
2019-04-01,Tennessee,5368049,3324074,3214505,109569
2019-04-01,Texas,21850614,13951498,13468880,482618
2019-04-01,Utah,2338541,1599362,1557593,41769
2019-04-01,Vermont,517854,344265,336792,7473
2019-04-01,Virginia,6674083,4411682,4289972,121710
2019-04-01,Washington,6002058,3887284,3720954,166330
2019-04-01,Wisconsin,4628057,3091979,2992614,99365
2019-04-01,Wyoming,450675,294998,284810,10188
2019-05-01,Alabama,3862424,2232174,2163952,68222
2019-05-01,Alaska,546150,353548,334381,19167
2019-05-01,Arizona,5708829,3525840,3353848,171992
2019-05-01,Arkansas,2343292,1361669,1314928,46741
2019-05-01,California,31027526,19304550,18515934,788616
2019-05-01,Colorado,4538098,3115281,3033852,81429
2019-05-01,Connecticut,2883745,1912281,1844977,67304
2019-05-01,Delaware,779251,485988,469399,16589
2019-05-01,Florida,17385414,10279930,9945628,334302
2019-05-01,Georgia,8189728,5129326,4945860,183466
2019-05-01,Hawaii,1091012,666331,649390,16941
2019-05-01,Idaho,1364985,875679,851447,24232
2019-05-01,Illinois,9997605,6460957,6197805,263152
2019-05-01,Indiana,5238060,3373177,3264961,108216
2019-05-01,Iowa,2469440,1730668,1683725,46943
2019-05-01,Kansas,2226234,1489343,1443000,46343
2019-05-01,Kentucky,3494766,2063398,1978208,85190
2019-05-01,Louisiana,3583350,2105899,2014912,90987
2019-05-01,Maine,1110412,693551,675536,18015
2019-05-01,Maryland,4763531,3259436,3146040,113396
2019-05-01,Massachusetts,5632822,3780393,3666566,113827
2019-05-01,Michigan,7987208,4949277,4742543,206734
2019-05-01,Minnesota,4419361,3083737,2987022,96715
2019-05-01,Mississippi,2286635,1276925,1207363,69562
2019-05-01,Missouri,4810200,3067922,2971711,96211
2019-05-01,Montana,850047,534802,515782,19020
2019-05-01,Nebraska,1477544,1038432,1007448,30984
2019-05-01,Nevada,2425739,1556867,1495541,61326
2019-05-01,Ohio,9237539,5821487,5587417,234070
2019-05-01,Oklahoma,3027519,1842273,1786601,55672
2019-05-01,Oregon,3403640,2104117,2024197,79920
2019-05-01,Pennsylvania,10271186,6475481,6196790,278691
2019-05-01,Tennessee,5372175,3328478,3219371,109107
2019-05-01,Texas,21878787,13971880,13494116,477764
2019-05-01,Utah,2342806,1602567,1561589,40978
2019-05-01,Vermont,517915,343936,336481,7455
2019-05-01,Virginia,6677682,4416125,4297055,119070
2019-05-01,Washington,6008920,3895753,3732380,163373
2019-05-01,Wisconsin,4629921,3092979,2991772,101207
2019-05-01,Wyoming,450891,295316,285047,10269
2019-06-01,Alabama,3863995,2233402,2167676,65726
2019-06-01,Alaska,546141,353731,334599,19132
2019-06-01,Arizona,5719237,3533838,3362138,171700
2019-06-01,Arkansas,2344321,1361790,1314740,47050
2019-06-01,California,31035051,19311393,18526089,785304
2019-06-01,Colorado,4544250,3120345,3040081,80264
2019-06-01,Connecticut,2883772,1913645,1846526,67119
2019-06-01,Delaware,780094,486815,469813,17002
2019-06-01,Florida,17404169,10304147,9970073,334074
2019-06-01,Georgia,8199141,5137205,4955924,181281
2019-06-01,Hawaii,1090709,666771,650122,16649
2019-06-01,Idaho,1367964,878119,853906,24213
2019-06-01,Illinois,9996220,6453401,6198247,255154
2019-06-01,Indiana,5241157,3371205,3264478,106727
2019-06-01,Iowa,2470620,1733102,1685595,47507
2019-06-01,Kansas,2226826,1490822,1444540,46282
2019-06-01,Kentucky,3495916,2066908,1981633,85275
2019-06-01,Louisiana,3583530,2109754,2017549,92205
2019-06-01,Maine,1111030,694253,676002,18251
2019-06-01,Maryland,4764863,3265661,3152291,113370
2019-06-01,Massachusetts,5634880,3780828,3668102,112726
2019-06-01,Michigan,7988642,4951350,4745349,206001
2019-06-01,Minnesota,4422372,3089207,2992843,96364
2019-06-01,Mississippi,2286865,1279530,1208933,70597
2019-06-01,Missouri,4812270,3071618,2974560,97058
2019-06-01,Montana,850830,535862,516760,19102
2019-06-01,Nebraska,1478351,1039213,1008354,30859
2019-06-01,Nevada,2430418,1562556,1501566,60990
2019-06-01,Ohio,9240152,5830138,5591950,238188
2019-06-01,Oklahoma,3029295,1843994,1788112,55882
2019-06-01,Oregon,3406868,2104097,2025554,78543
2019-06-01,Pennsylvania,10272181,6482360,6200143,282217
2019-06-01,Tennessee,5376724,3331228,3221931,109297
2019-06-01,Texas,21908726,14001987,13521952,480035
2019-06-01,Utah,2347248,1606145,1565787,40358
2019-06-01,Vermont,518005,343701,336152,7549
2019-06-01,Virginia,6681878,4421093,4304002,117091
2019-06-01,Washington,6016231,3905366,3743850,161516
2019-06-01,Wisconsin,4632110,3094520,2991596,102924
2019-06-01,Wyoming,451126,295794,285278,10516
2019-07-01,Alabama,3865605,2235879,2171719,64160
2019-07-01,Alaska,546124,353957,334776,19181
2019-07-01,Arizona,5729725,3542350,3370439,171911
2019-07-01,Arkansas,2345384,1362767,1315064,47703
2019-07-01,California,31042729,19328532,18540122,788410
2019-07-01,Colorado,4550388,3126269,3046294,79975
2019-07-01,Connecticut,2883814,1915887,1848378,67509
2019-07-01,Delaware,780911,487919,470296,17623
2019-07-01,Florida,17423120,10332690,9996851,335839
2019-07-01,Georgia,8208646,5146869,4966970,179899
2019-07-01,Hawaii,1090419,667702,651326,16376
2019-07-01,Idaho,1370929,880762,856393,24369
2019-07-01,Illinois,9994924,6445778,6196074,249704
2019-07-01,Indiana,5244373,3372715,3266416,106299
2019-07-01,Iowa,2471822,1735802,1687468,48334
2019-07-01,Kansas,2227416,1493014,1446400,46614
2019-07-01,Kentucky,3497135,2071101,1985516,85585
2019-07-01,Louisiana,3583771,2115698,2020553,95145
2019-07-01,Maine,1111651,695443,676713,18730
2019-07-01,Maryland,4766235,3272522,3158624,113898
2019-07-01,Massachusetts,5637007,3781940,3669520,112420
2019-07-01,Michigan,7990228,4953147,4748325,204822
2019-07-01,Minnesota,4425397,3095230,2998435,96795
2019-07-01,Mississippi,2287134,1282461,1210441,72020
2019-07-01,Missouri,4814438,3077086,2978080,99006
2019-07-01,Montana,851600,537145,517862,19283
2019-07-01,Nebraska,1479137,1040368,1009438,30930
2019-07-01,Nevada,2435079,1568679,1507794,60885
2019-07-01,Ohio,9242913,5840899,5597492,243407
2019-07-01,Oklahoma,3031109,1845998,1789265,56733
2019-07-01,Oregon,3410117,2105063,2027770,77293
2019-07-01,Pennsylvania,10273325,6492519,6204677,287842
2019-07-01,Tennessee,5381375,3333056,3222787,110269
2019-07-01,Texas,21938858,14039457,13551722,487735
2019-07-01,Utah,2351704,1610100,1570182,39918
2019-07-01,Vermont,518111,343661,335893,7768
2019-07-01,Virginia,6686119,4427256,4311089,116167
2019-07-01,Washington,6023628,3915017,3754579,160438
2019-07-01,Wisconsin,4634420,3096087,2991888,104199
2019-07-01,Wyoming,451343,296350,285492,10858
2019-08-01,Alabama,3867674,2239172,2175837,63335
2019-08-01,Alaska,546150,354167,335004,19163
2019-08-01,Arizona,5742211,3550819,3378991,171828
2019-08-01,Arkansas,2346922,1364569,1316245,48324
2019-08-01,California,31051769,19352881,18558815,794066
2019-08-01,Colorado,4556290,3132792,3052730,80062
2019-08-01,Connecticut,2884364,1918619,1850457,68162
2019-08-01,Delaware,781909,489118,470836,18282
2019-08-01,Florida,17446500,10362186,10024780,337406
2019-08-01,Georgia,8217762,5157087,4978768,178319
2019-08-01,Hawaii,1090268,669054,652992,16062
2019-08-01,Idaho,1374226,883352,858885,24467
2019-08-01,Illinois,9993687,6437758,6192198,245560
2019-08-01,Indiana,5247759,3377418,3270800,106618
2019-08-01,Iowa,2472948,1738561,1689416,49145
2019-08-01,Kansas,2228430,1495521,1448506,47015
2019-08-01,Kentucky,3498575,2075521,1989597,85924
2019-08-01,Louisiana,3584102,2122853,2023921,98932
2019-08-01,Maine,1112377,696744,677613,19131
2019-08-01,Maryland,4767772,3279210,3165105,114105
2019-08-01,Massachusetts,5639040,3783223,3670782,112441
2019-08-01,Michigan,7992084,4954309,4751549,202760
2019-08-01,Minnesota,4428165,3100765,3003367,97398
2019-08-01,Mississippi,2287500,1285009,1211834,73175
2019-08-01,Missouri,4817071,3083765,2982141,101624
2019-08-01,Montana,852602,538480,519016,19464
2019-08-01,Nebraska,1480038,1041747,1010685,31062
2019-08-01,Nevada,2439491,1574877,1514207,60670
2019-08-01,Ohio,9245841,5851393,5604276,247117
2019-08-01,Oklahoma,3033521,1848246,1790611,57635
2019-08-01,Oregon,3413384,2106623,2030826,75797
2019-08-01,Pennsylvania,10275707,6504482,6210321,294161
2019-08-01,Tennessee,5387165,3335043,3223344,111699
2019-08-01,Texas,21973020,14078792,13582783,496009
2019-08-01,Utah,2356169,1614348,1574747,39601
2019-08-01,Vermont,518273,343841,335776,8065
2019-08-01,Virginia,6690638,4434846,4319000,115846
2019-08-01,Washington,6031259,3923782,3764361,159421
2019-08-01,Wisconsin,4636987,3097266,2992435,104831
2019-08-01,Wyoming,451683,296892,285705,11187
2019-09-01,Alabama,3869937,2242568,2179776,62792
2019-09-01,Alaska,546193,354265,335381,18884
2019-09-01,Arizona,5754979,3559219,3388474,170745
2019-09-01,Arkansas,2348558,1367000,1318483,48517
2019-09-01,California,31062463,19381576,18584676,796900
2019-09-01,Colorado,4562413,3139764,3059740,80024
2019-09-01,Connecticut,2885043,1921554,1852927,68627
2019-09-01,Delaware,782978,490313,471510,18803
2019-09-01,Florida,17470770,10391422,10054571,336851
2019-09-01,Georgia,8227288,5167986,4992227,175759
2019-09-01,Hawaii,1090192,670771,655171,15600
2019-09-01,Idaho,1377619,885757,861511,24246
2019-09-01,Illinois,9992956,6429207,6188739,240468
2019-09-01,Indiana,5251359,3384123,3277361,106762
2019-09-01,Iowa,2474160,1741239,1691639,49600
2019-09-01,Kansas,2229568,1498108,1450972,47136
2019-09-01,Kentucky,3500176,2079723,1993779,85944
2019-09-01,Louisiana,3584700,2130301,2028230,102071
2019-09-01,Maine,1113156,697848,678669,19179
2019-09-01,Maryland,4769535,3285417,3172340,113077
2019-09-01,Massachusetts,5641308,3784702,3672571,112131
2019-09-01,Michigan,7994298,4954741,4755863,198878
2019-09-01,Minnesota,4431178,3105451,3008299,97152
2019-09-01,Mississippi,2287965,1286610,1213257,73353
2019-09-01,Missouri,4819891,3090723,2986755,103968
2019-09-01,Montana,853702,539844,520319,19525
2019-09-01,Nebraska,1481039,1043236,1012221,31015
2019-09-01,Nevada,2443975,1581000,1520987,60013
2019-09-01,Ohio,9249209,5860933,5613289,247644
2019-09-01,Oklahoma,3036112,1850817,1792888,57929
2019-09-01,Oregon,3416813,2108206,2034404,73802
2019-09-01,Pennsylvania,10278544,6516504,6217673,298831
2019-09-01,Tennessee,5393158,3338025,3225049,112976
2019-09-01,Texas,22008347,14115779,13616230,499549
2019-09-01,Utah,2360793,1618931,1579660,39271
2019-09-01,Vermont,518428,344211,335862,8349
2019-09-01,Virginia,6695531,4443686,4328656,115030
2019-09-01,Washington,6039196,3931891,3774351,157540
2019-09-01,Wisconsin,4639751,3098154,2993572,104582
2019-09-01,Wyoming,452040,297378,285966,11412
2019-10-01,Alabama,3872005,2245134,2182927,62207
2019-10-01,Alaska,546253,354160,335789,18371
2019-10-01,Arizona,5767426,3567196,3398108,169088
2019-10-01,Arkansas,2350098,1369548,1321163,48385
2019-10-01,California,31071318,19409073,18611910,797163
2019-10-01,Colorado,4568307,3146155,3066205,79950
2019-10-01,Connecticut,2885631,1923882,1855057,68825
2019-10-01,Delaware,783996,491392,472205,19187
2019-10-01,Florida,17494169,10417919,10083201,334718
2019-10-01,Georgia,8236438,5178965,5006146,172819
2019-10-01,Hawaii,1090017,672425,657423,15002
2019-10-01,Idaho,1380905,887783,864059,23724
2019-10-01,Illinois,9991696,6419051,6185129,233922
2019-10-01,Indiana,5254766,3389710,3283284,106426
2019-10-01,Iowa,2475313,1742983,1693374,49609
2019-10-01,Kansas,2230598,1500323,1453350,46973
2019-10-01,Kentucky,3501637,2082967,1997368,85599
2019-10-01,Louisiana,3585062,2137472,2033350,104122
2019-10-01,Maine,1113920,698672,679614,19058
2019-10-01,Maryland,4771088,3290807,3179659,111148
2019-10-01,Massachusetts,5643397,3785377,3674106,111271
2019-10-01,Michigan,7996150,4953762,4760278,193484
2019-10-01,Minnesota,4434016,3109362,3013162,96200
2019-10-01,Mississippi,2288305,1287058,1214486,72572
2019-10-01,Missouri,4822582,3096557,2990876,105681
2019-10-01,Montana,854715,541118,521645,19473
2019-10-01,Nebraska,1481955,1044517,1013744,30773
2019-10-01,Nevada,2448374,1586738,1527688,59050
2019-10-01,Ohio,9252182,5869890,5623254,246636
2019-10-01,Oklahoma,3038533,1853060,1795497,57563
2019-10-01,Oregon,3420102,2109607,2037899,71708
2019-10-01,Pennsylvania,10280988,6526543,6224885,301658
2019-10-01,Tennessee,5398996,3341366,3227055,114311
2019-10-01,Texas,22042462,14145807,13647759,498048
2019-10-01,Utah,2365287,1623452,1584461,38991
2019-10-01,Vermont,518595,344591,336052,8539
2019-10-01,Virginia,6700112,4452045,4338608,113437
2019-10-01,Washington,6046858,3939393,3784478,154915
2019-10-01,Wisconsin,4642347,3098170,2994445,103725
2019-10-01,Wyoming,452379,297774,286188,11586
2019-11-01,Alabama,3873710,2245681,2184363,61318
2019-11-01,Alaska,546204,353902,336054,17848
2019-11-01,Arizona,5779302,3573493,3405586,167907
2019-11-01,Arkansas,2351416,1371392,1323096,48296
2019-11-01,California,31078032,19428005,18629523,798482
2019-11-01,Colorado,4573834,3150945,3070651,80294
2019-11-01,Connecticut,2885855,1924643,1855727,68916
2019-11-01,Delaware,784946,492180,472634,19546
2019-11-01,Florida,17515663,10438251,10104965,333286
2019-11-01,Georgia,8244931,5188077,5017472,170605
2019-11-01,Hawaii,1089866,673465,659069,14396
2019-11-01,Idaho,1384052,889088,866032,23056
2019-11-01,Illinois,9989539,6405026,6178403,226623
2019-11-01,Indiana,5257617,3390052,3284278,105774
2019-11-01,Iowa,2476140,1742464,1693168,49296
2019-11-01,Kansas,2231343,1501501,1454798,46703
2019-11-01,Kentucky,3502739,2084262,1999126,85136
2019-11-01,Louisiana,3585109,2143640,2038123,105517
2019-11-01,Maine,1114519,699245,680075,19170
2019-11-01,Maryland,4772202,3294632,3185322,109310
2019-11-01,Massachusetts,5644916,3783053,3673157,109896
2019-11-01,Michigan,7997211,4949900,4762274,187626
2019-11-01,Minnesota,4436354,3112333,3016931,95402
2019-11-01,Mississippi,2288427,1286445,1214960,71485
2019-11-01,Missouri,4824710,3099989,2992970,107019
2019-11-01,Montana,855635,542047,522638,19409
2019-11-01,Nebraska,1482720,1045143,1014641,30502
2019-11-01,Nevada,2452584,1591578,1533376,58202
2019-11-01,Ohio,9254101,5878907,5630337,248570
2019-11-01,Oklahoma,3040628,1853848,1797021,56827
2019-11-01,Oregon,3423008,2110217,2040020,70197
2019-11-01,Pennsylvania,10282189,6532247,6228361,303886
2019-11-01,Tennessee,5404250,3342928,3226750,116178
2019-11-01,Texas,22074778,14164707,13669808,494899
2019-11-01,Utah,2369514,1627137,1588237,38900
2019-11-01,Vermont,518664,344687,336111,8576
2019-11-01,Virginia,6704073,4457320,4345864,111456
2019-11-01,Washington,6053960,3945768,3792879,152889
2019-11-01,Wisconsin,4644458,3096036,2993399,102637
2019-11-01,Wyoming,452666,298072,286213,11859
2019-12-01,Alabama,3875217,2243805,2183474,60331
2019-12-01,Alaska,546167,353626,336041,17585
2019-12-01,Arizona,5790821,3577998,3409326,168672
2019-12-01,Arkansas,2352592,1372227,1323423,48804
2019-12-01,California,31082947,19436766,18629682,807084
2019-12-01,Colorado,4579096,3153757,3072012,81745
2019-12-01,Connecticut,2885994,1923545,1854195,69350
2019-12-01,Delaware,785852,492735,472624,20111
2019-12-01,Florida,17536150,10451550,10115912,335638
2019-12-01,Georgia,8252983,5194430,5023703,170727
2019-12-01,Hawaii,1089657,673650,659676,13974
2019-12-01,Idaho,1387150,889686,867044,22642
2019-12-01,Illinois,9986797,6387664,6166253,221411
2019-12-01,Indiana,5260181,3384041,3278446,105595
2019-12-01,Iowa,2476859,1739293,1690212,49081
2019-12-01,Kansas,2232017,1501433,1454675,46758
2019-12-01,Kentucky,3503649,2083463,1998285,85178
2019-12-01,Louisiana,3584977,2148287,2041203,107084
2019-12-01,Maine,1115080,699593,679814,19779
2019-12-01,Maryland,4773117,3296994,3187889,109105
2019-12-01,Massachusetts,5646173,3776027,3667667,108360
2019-12-01,Michigan,7997875,4943738,4759897,183841
2019-12-01,Minnesota,4438470,3114576,3018498,96078
2019-12-01,Mississippi,2288447,1285312,1214113,71199
2019-12-01,Missouri,4826623,3100780,2992178,108602
2019-12-01,Montana,856541,542499,522984,19515
2019-12-01,Nebraska,1483375,1044977,1014498,30479
2019-12-01,Nevada,2456633,1595314,1537291,58023
2019-12-01,Ohio,9255603,5887786,5631692,256094
2019-12-01,Oklahoma,3042581,1852804,1796353,56451
2019-12-01,Oregon,3425727,2109883,2039745,70138
2019-12-01,Pennsylvania,10282920,6533827,6225747,308080
2019-12-01,Tennessee,5409243,3341819,3222404,119415
2019-12-01,Texas,22105815,14174181,13677859,496322
2019-12-01,Utah,2373687,1629570,1590354,39216
2019-12-01,Vermont,518756,344333,335826,8507
2019-12-01,Virginia,6707692,4457736,4347665,110071
2019-12-01,Washington,6060751,3951421,3798056,153365
2019-12-01,Wisconsin,4646321,3091661,2989464,102197
2019-12-01,Wyoming,452928,298339,285925,12414
2020-01-01,Alabama,3876526,2240277,2180872,59405
2020-01-01,Alaska,546109,353349,335692,17657
2020-01-01,Arizona,5802213,3581294,3409624,171670
2020-01-01,Arkansas,2353674,1372291,1322159,50132
2020-01-01,California,31086836,19437115,18613291,823824
2020-01-01,Colorado,4584112,3154544,3070164,84380
2020-01-01,Connecticut,2885953,1921041,1850746,70295
2020-01-01,Delaware,786721,493327,472306,21021
2020-01-01,Florida,17555962,10458937,10116910,342027
2020-01-01,Georgia,8260627,5198431,5024604,173827
2020-01-01,Hawaii,1089395,673017,659237,13780
2020-01-01,Idaho,1390161,889944,867117,22827
2020-01-01,Illinois,9983613,6370035,6149010,221025
2020-01-01,Indiana,5262529,3372996,3266538,106458
2020-01-01,Iowa,2477479,1734173,1684860,49313
2020-01-01,Kansas,2232550,1500177,1453029,47148
2020-01-01,Kentucky,3504469,2081086,1995321,85765
2020-01-01,Louisiana,3584646,2150907,2041637,109270
2020-01-01,Maine,1115592,699646,678873,20773
2020-01-01,Maryland,4773748,3298221,3187160,111061
2020-01-01,Massachusetts,5647161,3763790,3657139,106651
2020-01-01,Michigan,7998157,4936707,4753182,183525
2020-01-01,Minnesota,4440365,3116174,3017331,98843
2020-01-01,Mississippi,2288349,1284171,1211954,72217
2020-01-01,Missouri,4828271,3099592,2989051,110541
2020-01-01,Montana,857398,542553,522727,19826
2020-01-01,Nebraska,1484013,1044199,1013444,30755
2020-01-01,Nevada,2460603,1597920,1539287,58633
2020-01-01,Ohio,9256594,5895125,5627571,267554
2020-01-01,Oklahoma,3044378,1850300,1793406,56894
2020-01-01,Oregon,3428283,2108977,2037231,71746
2020-01-01,Pennsylvania,10283103,6532104,6216949,315155
2020-01-01,Tennessee,5413972,3338446,3214183,124263
2020-01-01,Texas,22136086,14178765,13673709,505056
2020-01-01,Utah,2377669,1630818,1590908,39910
2020-01-01,Vermont,518807,343628,335164,8464
2020-01-01,Virginia,6711014,4453855,4343866,109989
2020-01-01,Washington,6067267,3957004,3799953,157051
2020-01-01,Wisconsin,4647953,3084954,2982788,102166
2020-01-01,Wyoming,453129,298600,285320,13280
2020-02-01,Alabama,3877055,2236491,2177852,58639
2020-02-01,Alaska,545922,352940,335023,17917
2020-02-01,Arizona,5812433,3584045,3407756,176289
2020-02-01,Arkansas,2354279,1371944,1319917,52027
2020-02-01,California,31086594,19433049,18587756,845293
2020-02-01,Colorado,4588565,3153582,3065913,87669
2020-02-01,Connecticut,2885386,1917993,1846218,71775
2020-02-01,Delaware,787402,494035,471865,22170
2020-02-01,Florida,17571923,10461404,10111574,349830
2020-02-01,Georgia,8266924,5201435,5021666,179769
2020-02-01,Hawaii,1088920,671901,658112,13789
2020-02-01,Idaho,1392964,890044,866502,23542
2020-02-01,Illinois,9978724,6355061,6128641,226420
2020-02-01,Indiana,5263980,3359160,3250571,108589
2020-02-01,Iowa,2477569,1727949,1678066,49883
2020-02-01,Kansas,2232676,1498044,1450486,47558
2020-02-01,Kentucky,3504588,2077898,1991434,86464
2020-02-01,Louisiana,3583665,2151507,2039411,112096
2020-02-01,Maine,1115854,699067,677448,21619
2020-02-01,Maryland,4773523,3298443,3184239,114204
2020-02-01,Massachusetts,5647178,3747222,3642616,104606
2020-02-01,Michigan,7996913,4927949,4743379,184570
2020-02-01,Minnesota,4441480,3117081,3013513,103568
2020-02-01,Mississippi,2287820,1283304,1209022,74282
2020-02-01,Missouri,4828978,3097559,2984967,112592
2020-02-01,Montana,858070,542368,522142,20226
2020-02-01,Nebraska,1484359,1043340,1012002,31338
2020-02-01,Nevada,2464244,1599451,1539656,59795
2020-02-01,Ohio,9255817,5899009,5619606,279403
2020-02-01,Oklahoma,3045622,1847072,1788930,58142
2020-02-01,Oregon,3430274,2107699,2033344,74355
2020-02-01,Pennsylvania,10281185,6528498,6204448,324050
2020-02-01,Tennessee,5417729,3333471,3203564,129907
2020-02-01,Texas,22163701,14182317,13662942,519375
2020-02-01,Utah,2381430,1631216,1590455,40761
2020-02-01,Vermont,518755,342887,334270,8617
2020-02-01,Virginia,6713131,4448623,4337089,111534
2020-02-01,Washington,6072840,3961975,3799304,162671
2020-02-01,Wisconsin,4648731,3075655,2974233,101422
2020-02-01,Wyoming,453321,298818,284507,14311
2020-03-01,Alabama,3878006,2234170,2176275,57895
2020-03-01,Alaska,545866,352404,334331,18073
2020-03-01,Arizona,5823018,3587701,3406748,180953
2020-03-01,Arkansas,2355118,1372102,1318251,53851
2020-03-01,California,31087184,19168665,18304574,864091
2020-03-01,Colorado,4593310,3099232,2953112,146120
2020-03-01,Connecticut,2885051,1915644,1842200,73444
2020-03-01,Delaware,788163,481344,458200,23144
2020-03-01,Florida,17589075,10629624,10106833,522791
2020-03-01,Georgia,8273938,5205472,5018477,186995
2020-03-01,Hawaii,1088470,671079,657086,13993
2020-03-01,Idaho,1395898,890190,865860,24330
2020-03-01,Illinois,9974673,6345433,6109809,235624
2020-03-01,Indiana,5265950,3346411,3235038,111373
2020-03-01,Iowa,2477947,1721723,1671622,50101
2020-03-01,Kansas,2233058,1495882,1448406,47476
2020-03-01,Kentucky,3505113,2075112,1988308,86804
2020-03-01,Louisiana,3583040,2150787,2036022,114765
2020-03-01,Maine,1116239,697728,676175,21553
2020-03-01,Maryland,4773662,3298663,3181957,116706
2020-03-01,Massachusetts,5647723,3728887,3627179,101708
2020-03-01,Michigan,7996478,4917789,4734860,182929
2020-03-01,Minnesota,4443088,3118380,3008879,109501
2020-03-01,Mississippi,2287475,1283188,1206406,76782
2020-03-01,Missouri,4830226,3096593,2982405,114188
2020-03-01,Montana,858828,542146,521657,20489
2020-03-01,Nebraska,1484852,1043236,1011133,32103
2020-03-01,Nevada,2467941,1587900,1485811,102089
2020-03-01,Ohio,9256097,5836682,5549718,286964
2020-03-01,Oklahoma,3047166,1844387,1784671,59716
2020-03-01,Oregon,3432553,2106741,2030098,76643
2020-03-01,Pennsylvania,10280347,6525913,6194061,331852
2020-03-01,Tennessee,5422052,3328051,3193850,134201
2020-03-01,Texas,22192219,13986789,13306781,680008
2020-03-01,Utah,2385460,1631706,1590309,41397
2020-03-01,Vermont,518754,342487,333471,9016
2020-03-01,Virginia,6715837,4447482,4333184,114298
2020-03-01,Washington,6078919,3932003,3724793,207210
2020-03-01,Wisconsin,4649987,3065273,2966524,98749
2020-03-01,Wyoming,453558,299040,283757,15283
2020-04-01,Alabama,3879108,2187272,1899019,288253
2020-04-01,Alaska,545788,345671,304991,40680
2020-04-01,Arizona,5834004,3545107,3040409,504698
2020-04-01,Arkansas,2356097,1371571,1234204,137367
2020-04-01,California,31090131,18590864,15624429,2966435
2020-04-01,Colorado,4598343,2983132,2621363,361769
2020-04-01,Connecticut,2884884,1826611,1669743,156868
2020-04-01,Delaware,788966,474498,411017,63481
2020-04-01,Florida,17607252,9765316,8400513,1364803
2020-04-01,Georgia,8281411,4985895,4365055,620840
2020-04-01,Hawaii,1088090,637563,497928,139635
2020-04-01,Idaho,1398886,876528,775219,101309
2020-04-01,Illinois,9971141,6026243,5029765,996478
2020-04-01,Indiana,5268170,3225032,2680097,544935
2020-04-01,Iowa,2478425,1712557,1522362,190195
2020-04-01,Kansas,2233522,1485985,1298910,187075
2020-04-01,Kentucky,3505783,2087483,1734915,352568
2020-04-01,Louisiana,3582557,2041667,1773471,268196
2020-04-01,Maine,1116663,654335,594673,59662
2020-04-01,Maryland,4774055,3131058,2848836,282222
2020-04-01,Massachusetts,5648468,3409863,2851481,558382
2020-04-01,Michigan,7996378,4586421,3502065,1084356
2020-04-01,Minnesota,4444837,3012976,2740570,272406
2020-04-01,Mississippi,2287269,1218052,1027052,191000
2020-04-01,Missouri,4831693,2980434,2606915,373519
2020-04-01,Montana,859622,543608,479153,64455
2020-04-01,Nebraska,1485441,1051562,973730,77832
2020-04-01,Nevada,2471833,1497652,1055435,442217
2020-04-01,Ohio,9256776,5539776,4630914,908862
2020-04-01,Oklahoma,3048864,1821680,1585139,236541
2020-04-01,Oregon,3434992,2049533,1778695,270838
2020-04-01,Pennsylvania,10279924,6313806,5290771,1023035
2020-04-01,Tennessee,5426617,3183054,2679469,503585
2020-04-01,Texas,22222320,13368039,11640170,1727869
2020-04-01,Utah,2389585,1624093,1460079,164014
2020-04-01,Vermont,518778,353857,301638,52219
2020-04-01,Virginia,6718918,4391242,3895532,495710
2020-04-01,Washington,6085331,3988363,3336286,652077
2020-04-01,Wisconsin,4651479,3061130,2607992,453138
2020-04-01,Wyoming,453794,290960,274922,16038
2020-05-01,Alabama,3879383,2218789,2044109,174680
2020-05-01,Alaska,545650,345359,305247,40112
2020-05-01,Arizona,5843415,3619124,3236482,382642
2020-05-01,Arkansas,2356584,1352008,1237273,114735
2020-05-01,California,31081351,18392528,15529319,2863209
2020-05-01,Colorado,4602402,3105848,2744873,360975
2020-05-01,Connecticut,2883940,1886540,1671130,215410
2020-05-01,Delaware,789583,475201,412227,62974
2020-05-01,Florida,17620672,9949585,8533164,1416421
2020-05-01,Georgia,8286668,5030665,4558036,472629
2020-05-01,Hawaii,1087260,638894,498685,140209
2020-05-01,Idaho,1401631,882245,808995,73250
2020-05-01,Illinois,9965041,6158659,5211779,946880
2020-05-01,Indiana,5269325,3264747,2874299,390448
2020-05-01,Iowa,2478455,1660842,1523062,137780
2020-05-01,Kansas,2233534,1488938,1354666,134272
2020-05-01,Kentucky,3505869,2073314,1846754,226560
2020-05-01,Louisiana,3581304,2039684,1771746,267938
2020-05-01,Maine,1116950,681019,624764,56255
2020-05-01,Maryland,4773107,3135302,2854474,280828
2020-05-01,Massachusetts,5647805,3609060,3056433,552627
2020-05-01,Michigan,7994582,4695183,3718354,976829
2020-05-01,Minnesota,4445755,3087954,2739692,348262
2020-05-01,Mississippi,2286517,1227107,1091934,135173
2020-05-01,Missouri,4832218,2891970,2613065,278905
2020-05-01,Montana,860294,528223,480130,48093
2020-05-01,Nebraska,1485719,1031661,975917,55744
2020-05-01,Nevada,2474993,1435029,1083335,351694
2020-05-01,Ohio,9255576,5831829,4965227,866602
2020-05-01,Oklahoma,3049957,1831486,1657368,174118
2020-05-01,Oregon,3436725,2121025,1873383,247642
2020-05-01,Pennsylvania,10277311,6412123,5549484,862639
2020-05-01,Tennessee,5430156,3150509,2848150,302359
2020-05-01,Texas,22245728,13567930,11992731,1575199
2020-05-01,Utah,2393257,1583682,1463992,119690
2020-05-01,Vermont,518699,332962,301923,31039
2020-05-01,Virginia,6720219,4274171,3912282,361889
2020-05-01,Washington,6090159,3904883,3417587,487296
2020-05-01,Wisconsin,4652037,3052908,2736271,316637
2020-05-01,Wyoming,453942,300611,275096,25515
2020-06-01,Alabama,3879980,2221436,2049715,171721
2020-06-01,Alaska,545489,345254,306122,39132
2020-06-01,Arizona,5853318,3561870,3180733,381137
2020-06-01,Arkansas,2357230,1347387,1242595,104792
2020-06-01,California,31075328,18813142,16161036,2652106
2020-06-01,Colorado,4606805,3154711,2796909,357802
2020-06-01,Connecticut,2883299,1890666,1675483,215183
2020-06-01,Delaware,790266,475871,414294,61577
2020-06-01,Florida,17635636,9898486,8749388,1149098
2020-06-01,Georgia,8292650,4990499,4569851,420648
2020-06-01,Hawaii,1086459,639357,549249,90108
2020-06-01,Idaho,1404514,884808,822839,61969
2020-06-01,Illinois,9959743,6356264,5452932,903332
2020-06-01,Indiana,5270927,3284240,2950944,333296
2020-06-01,Iowa,2478689,1645540,1528543,116997
2020-06-01,Kansas,2233723,1481232,1377977,103255
2020-06-01,Kentucky,3506224,1962690,1851652,111038
2020-06-01,Louisiana,3580287,1955017,1772157,182860
2020-06-01,Maine,1117286,661977,626891,35086
2020-06-01,Maryland,4772600,3235141,2957538,277603
2020-06-01,Massachusetts,5647618,3683679,3138699,544980
2020-06-01,Michigan,7993462,4917012,4221930,695082
2020-06-01,Minnesota,4446981,3178494,2894566,283928
2020-06-01,Mississippi,2285922,1235797,1117094,118703
2020-06-01,Missouri,4833125,2994804,2752806,241998
2020-06-01,Montana,861056,549295,507756,41539
2020-06-01,Nebraska,1486137,1048401,979531,68870
2020-06-01,Nevada,2478346,1504348,1272287,232061
2020-06-01,Ohio,9255121,5680927,5093233,587694
2020-06-01,Oklahoma,3051282,1838543,1687262,151281
2020-06-01,Oregon,3438732,2133140,1913733,219407
2020-06-01,Pennsylvania,10275510,6421698,5567918,853780
2020-06-01,Tennessee,5434065,3156214,2862152,294062
2020-06-01,Texas,22271053,14068625,12638796,1429829
2020-06-01,Utah,2397123,1650824,1547616,103208
2020-06-01,Vermont,518679,327912,302806,25106
2020-06-01,Virginia,6722117,4320856,3939193,381663
2020-06-01,Washington,6095478,3877618,3457295,420323
2020-06-01,Wisconsin,4653004,3049234,2786485,262749
2020-06-01,Wyoming,454118,297883,275846,22037
2020-07-01,Alabama,3880648,2221858,2056348,165510
2020-07-01,Alaska,545364,345354,307513,37841
2020-07-01,Arizona,5863335,3610878,3233654,377224
2020-07-01,Arkansas,2357952,1344406,1249195,95211
2020-07-01,California,31069557,18731539,16268045,2463494
2020-07-01,Colorado,4611317,3070601,2844310,226291
2020-07-01,Connecticut,2882679,1895751,1681865,213886
2020-07-01,Delaware,790928,489517,449079,40438
2020-07-01,Florida,17650810,10108143,8940935,1167208
2020-07-01,Georgia,8298770,4966280,4587883,378397
2020-07-01,Hawaii,1085710,641845,551240,90605
2020-07-01,Idaho,1407405,887190,835264,51926
2020-07-01,Illinois,9954618,6146834,5409563,737271
2020-07-01,Indiana,5272639,3304366,3019818,284548
2020-07-01,Iowa,2478961,1637807,1538161,99646
2020-07-01,Kansas,2233951,1497429,1398770,98659
2020-07-01,Kentucky,3506659,1968434,1858922,109512
2020-07-01,Louisiana,3579383,1952856,1775157,177699
2020-07-01,Maine,1117659,690375,629790,60585
2020-07-01,Maryland,4772159,3151830,2877939,273891
2020-07-01,Massachusetts,5647519,3563106,3213230,349876
2020-07-01,Michigan,7992512,4835421,4399525,435896
2020-07-01,Minnesota,4448291,3136773,2898989,237784
2020-07-01,Mississippi,2285425,1245129,1138838,106291
2020-07-01,Missouri,4834175,3101654,2891126,210528
2020-07-01,Montana,861803,545747,509831,35916
2020-07-01,Nebraska,1486531,1028806,983881,44925
2020-07-01,Nevada,2481749,1512588,1261549,251039
2020-07-01,Ohio,9254910,5735320,5199086,536234
2020-07-01,Oklahoma,3052681,1846738,1714448,132290
2020-07-01,Oregon,3440819,2037847,1842992,194855
2020-07-01,Pennsylvania,10273917,6431720,5592719,839001
2020-07-01,Tennessee,5438126,3167388,2884231,283157
2020-07-01,Texas,22296608,14005509,12704427,1301082
2020-07-01,Utah,2401050,1645536,1556112,89424
2020-07-01,Vermont,518664,324705,304020,20685
2020-07-01,Virginia,6724104,4313312,3972148,341164
2020-07-01,Washington,6100875,3920431,3497219,423212
2020-07-01,Wisconsin,4654069,3049237,2829923,219314
2020-07-01,Wyoming,454334,297259,277055,20204
2020-08-01,Alabama,3882472,2218586,2061877,156709
2020-08-01,Alaska,545315,332996,308923,24073
2020-08-01,Arizona,5875190,3518731,3272951,245780
2020-08-01,Arkansas,2359375,1341356,1254825,86531
2020-08-01,California,31074765,18666663,16365343,2301320
2020-08-01,Colorado,4616798,3105843,2884052,221791
2020-08-01,Connecticut,2882475,1841890,1687722,154168
2020-08-01,Delaware,791842,490233,451598,38635
2020-08-01,Florida,17669527,9991016,9206578,784438
2020-08-01,Georgia,8306713,4951494,4606347,345147
2020-08-01,Hawaii,1085305,643435,552752,90683
2020-08-01,Idaho,1410666,889123,845684,43439
2020-08-01,Illinois,9951889,6251739,5556088,695651
2020-08-01,Indiana,5275194,3320857,3077335,243522
2020-08-01,Iowa,2479628,1634482,1548511,85971
2020-08-01,Kansas,2234666,1509706,1415790,93916
2020-08-01,Kentucky,3507887,1974553,1865892,108661
2020-08-01,Louisiana,3579331,2096160,1924464,171696
2020-08-01,Maine,1118255,666897,632379,34518
2020-08-01,Maryland,4772659,3161767,2890448,271319
2020-08-01,Massachusetts,5647588,3614444,3277606,336838
2020-08-01,Michigan,7993400,4841531,4428898,412633
2020-08-01,Minnesota,4450313,3107608,2903291,204317
2020-08-01,Mississippi,2285698,1253922,1156630,97292
2020-08-01,Missouri,4836296,3089395,2904372,185023
2020-08-01,Montana,862714,542642,511307,31335
2020-08-01,Nebraska,1487267,1028809,987515,41294
2020-08-01,Nevada,2485827,1523576,1302740,220836
2020-08-01,Ohio,9256696,5803203,5280326,522877
2020-08-01,Oklahoma,3054823,1853864,1736890,116974
2020-08-01,Oregon,3443733,2086120,1911571,174549
2020-08-01,Pennsylvania,10274843,6252470,5614075,638395
2020-08-01,Tennessee,5443591,3377475,3104367,273108
2020-08-01,Texas,22327142,14095792,13118386,977406
2020-08-01,Utah,2405329,1642626,1564538,78088
2020-08-01,Vermont,518754,322293,305041,17252
2020-08-01,Virginia,6727072,4376496,4068442,308054
2020-08-01,Washington,6107080,3886077,3532848,353229
2020-08-01,Wisconsin,4656094,3050916,2864676,186240
2020-08-01,Wyoming,454672,296712,278278,18434
2020-09-01,Alabama,3884533,2212712,2065378,147334
2020-09-01,Alaska,545254,333247,309975,23272
2020-09-01,Arizona,5887367,3541969,3299327,242642
2020-09-01,Arkansas,2360906,1337649,1258219,79430
2020-09-01,California,31081669,18385558,16435503,1950055
2020-09-01,Colorado,4622504,3133342,2914426,218916
2020-09-01,Connecticut,2882419,1844073,1691446,152627
2020-09-01,Delaware,792821,490907,453405,37502
2020-09-01,Florida,17689159,10052895,9333690,719205
2020-09-01,Georgia,8315078,4940860,4620784,320076
2020-09-01,Hawaii,1084946,610118,519692,90426
2020-09-01,Idaho,1414009,908599,853750,54849
2020-09-01,Illinois,9949614,6363924,5703261,660663
2020-09-01,Indiana,5277977,3331816,3121310,210506
2020-09-01,Iowa,2480410,1632810,1556751,76059
2020-09-01,Kansas,2235531,1472356,1382202,90154
2020-09-01,Kentucky,3509267,1979845,1870874,108971
2020-09-01,Louisiana,3579467,2095001,1927988,167013
2020-09-01,Maine,1118905,666384,634000,32384
2020-09-01,Maryland,4773360,3009144,2800001,209143
2020-09-01,Massachusetts,5647956,3655222,3330763,324459
2020-09-01,Michigan,7994613,4848757,4450747,398010
2020-09-01,Minnesota,4452562,3086445,2905954,180491
2020-09-01,Mississippi,2286039,1261776,1170336,91440
2020-09-01,Missouri,4838656,3079960,2914028,165932
2020-09-01,Montana,863704,539685,511783,27902
2020-09-01,Nebraska,1488070,1028194,989626,38568
2020-09-01,Nevada,2489990,1535174,1335440,199734
2020-09-01,Ohio,9258910,5668842,5250401,418441
2020-09-01,Oklahoma,3057131,1858861,1753633,105228
2020-09-01,Oregon,3446867,2107097,1948079,159018
2020-09-01,Pennsylvania,10276251,6317241,5867228,450013
2020-09-01,Tennessee,5449301,3388990,3122079,266911
2020-09-01,Texas,22358893,13978180,12872257,1105923
2020-09-01,Utah,2409740,1640259,1571099,69160
2020-09-01,Vermont,518848,320189,305589,14600
2020-09-01,Virginia,6730369,4302424,4020210,282214
2020-09-01,Washington,6113541,3870014,3560713,309301
2020-09-01,Wisconsin,4658297,3128082,2965386,162696
2020-09-01,Wyoming,454998,296176,279179,16997
2020-10-01,Alabama,3886383,2266300,2158999,107301
2020-10-01,Alaska,545223,354075,331171,22904
2020-10-01,Arizona,5899190,3556433,3315121,241312
2020-10-01,Arkansas,2362323,1333366,1259359,74007
2020-10-01,California,31086721,18904638,17050260,1854378
2020-10-01,Colorado,4627942,3153491,2935611,217880
2020-10-01,Connecticut,2882202,1844473,1692736,151737
2020-10-01,Delaware,793770,481815,454271,27544
2020-10-01,Florida,17707888,10010524,9427112,583412
2020-10-01,Georgia,8323051,5133190,4831831,301359
2020-10-01,Hawaii,1084522,643115,553195,89920
2020-10-01,Idaho,1417281,903294,859499,43795
2020-10-01,Illinois,9946882,6326464,5813987,512477
2020-10-01,Indiana,5280606,3338006,3152745,185261
2020-10-01,Iowa,2481099,1630576,1561396,69180
2020-10-01,Kansas,2236251,1508097,1437158,70939
2020-10-01,Kentucky,3510534,1983293,1873315,109978
2020-10-01,Louisiana,3579445,2094453,1929972,164481
2020-10-01,Maine,1119531,666379,634487,31892
2020-10-01,Maryland,4773863,3113628,2903239,210389
2020-10-01,Massachusetts,5648070,3688327,3373320,315007
2020-10-01,Michigan,7995545,4854613,4461770,392843
2020-10-01,Minnesota,4454624,3070211,2906452,163759
2020-10-01,Mississippi,2286309,1268234,1180316,87918
2020-10-01,Missouri,4840816,3071517,2919089,152428
2020-10-01,Montana,864626,536872,511419,25453
2020-10-01,Nebraska,1488824,1026818,990239,36579
2020-10-01,Nevada,2494084,1545744,1360394,185350
2020-10-01,Ohio,9260740,5698877,5380157,318720
2020-10-01,Oklahoma,3059281,1861590,1765143,96447
2020-10-01,Oregon,3449790,2122565,1974681,147884
2020-10-01,Pennsylvania,10277210,6314482,5870140,444342
2020-10-01,Tennessee,5454779,3396932,3131888,265044
2020-10-01,Texas,22389388,14220838,13177348,1043490
2020-10-01,Utah,2414062,1637215,1574896,62319
2020-10-01,Vermont,518954,318369,305655,12714
2020-10-01,Virginia,6733361,4290462,4027562,262900
2020-10-01,Washington,6119759,3981810,3704008,277802
2020-10-01,Wisconsin,4660353,3054307,2908317,145990
2020-10-01,Wyoming,455331,295623,279620,16003
2020-11-01,Alabama,3887946,2263901,2158343,105558
2020-11-01,Alaska,545133,354071,331069,23002
2020-11-01,Arizona,5910601,3563927,3322173,241754
2020-11-01,Arkansas,2363579,1328600,1258385,70215
2020-11-01,California,31090632,18604626,16983903,1620723
2020-11-01,Colorado,4633108,3166511,2947931,218580
2020-11-01,Connecticut,2881741,1843528,1691777,151751
2020-11-01,Delaware,794630,481873,453979,27894
2020-11-01,Florida,17725160,10025050,9485302,539748
2020-11-01,Georgia,8330547,5116371,4831240,285131
2020-11-01,Hawaii,1084113,655912,588368,67544
2020-11-01,Idaho,1420432,901615,862991,38624
2020-11-01,Illinois,9943419,6161356,5662138,499218
2020-11-01,Indiana,5282747,3340983,3173510,167473
2020-11-01,Iowa,2481531,1625043,1560883,64160
2020-11-01,Kansas,2236775,1513503,1442525,70978
2020-11-01,Kentucky,3511462,1983374,1872685,110689
2020-11-01,Louisiana,3579170,2094642,1929950,164692
2020-11-01,Maine,1120025,666706,633957,32749
2020-11-01,Maryland,4774038,3113418,2901959,211459
2020-11-01,Massachusetts,5647713,3721554,3408246,313308
2020-11-01,Michigan,7995779,4855661,4458979,396682
2020-11-01,Minnesota,4456287,3057403,2905452,151951
2020-11-01,Mississippi,2286424,1272826,1187251,85575
2020-11-01,Missouri,4842526,3061073,2918134,142939
2020-11-01,Montana,865491,534549,510758,23791
2020-11-01,Nebraska,1489408,1024861,989563,35298
2020-11-01,Nevada,2498025,1509102,1378050,131052
2020-11-01,Ohio,9261688,5732818,5413227,319591
2020-11-01,Oklahoma,3061177,1861831,1772259,89572
2020-11-01,Oregon,3452417,2132974,1992470,140504
2020-11-01,Pennsylvania,10277120,6310994,5865408,445586
2020-11-01,Tennessee,5459887,3314879,3130511,184368
2020-11-01,Texas,22418959,13992055,12989789,1002266
2020-11-01,Utah,2418202,1631847,1574574,57273
2020-11-01,Vermont,518950,316982,305386,11596
2020-11-01,Virginia,6735886,4271293,4023075,248218
2020-11-01,Washington,6125522,3842951,3586497,256454
2020-11-01,Wisconsin,4661965,3054158,2921245,132913
2020-11-01,Wyoming,455610,295063,279509,15554
2020-12-01,Alabama,3889304,2264054,2157736,106318
2020-12-01,Alaska,545002,354035,330888,23147
2020-12-01,Arizona,5921658,3569317,3326907,242410
2020-12-01,Arkansas,2364696,1379313,1312142,67171
2020-12-01,California,31092761,18705475,16957019,1748456
2020-12-01,Colorado,4638089,3176560,2957291,219269
2020-12-01,Connecticut,2881139,1842967,1690960,152007
2020-12-01,Delaware,795439,481840,453637,28203
2020-12-01,Florida,17741498,10043992,9528878,515114
2020-12-01,Georgia,8337625,5100297,4829189,271108
2020-12-01,Hawaii,1083643,655587,588168,67419
2020-12-01,Idaho,1423536,900245,865649,34596
2020-12-01,Illinois,9939435,6150544,5659671,490873
2020-12-01,Indiana,5284652,3343929,3190041,153888
2020-12-01,Iowa,2481817,1619441,1559562,59879
2020-12-01,Kansas,2237175,1518416,1446860,71556
2020-12-01,Kentucky,3512248,1982759,1871847,110912
2020-12-01,Louisiana,3578682,2095025,1929532,165493
2020-12-01,Maine,1120437,666913,633553,33360
2020-12-01,Maryland,4773973,3112292,2900385,211907
2020-12-01,Massachusetts,5647094,3753070,3438583,314487
2020-12-01,Michigan,7995651,4855353,4454983,400370
2020-12-01,Minnesota,4457728,3048729,2904806,143923
2020-12-01,Mississippi,2286392,1276640,1192792,83848
2020-12-01,Missouri,4844027,3051663,2916551,135112
2020-12-01,Montana,866314,532934,510472,22462
2020-12-01,Nebraska,1489954,1023600,989072,34528
2020-12-01,Nevada,2501811,1516397,1391773,124624
2020-12-01,Ohio,9262241,5763310,5442603,320707
2020-12-01,Oklahoma,3062909,1861928,1777990,83938
2020-12-01,Oregon,3454895,2141252,2006503,134749
2020-12-01,Pennsylvania,10276507,6310050,5862162,447888
2020-12-01,Tennessee,5464698,3313650,3127609,186041
2020-12-01,Texas,22447253,14133518,13162510,971008
2020-12-01,Utah,2422249,1626916,1573578,53338
2020-12-01,Vermont,518976,316150,305226,10924
2020-12-01,Virginia,6738044,4255079,4018875,236204
2020-12-01,Washington,6131010,3830416,3590957,239459
2020-12-01,Wisconsin,4663376,3053836,2932229,121607
2020-12-01,Wyoming,455877,294630,279346,15284
2021-01-01,Alabama,3890500,2257961,2160236,97725
2021-01-01,Alaska,544894,354958,331373,23585
2021-01-01,Arizona,5932506,3571263,3331367,239896
2021-01-01,Arkansas,2365706,1375929,1312405,63524
2021-01-01,California,31093847,18668523,16988683,1679840
2021-01-01,Colorado,4642794,3183395,2972204,211191
2021-01-01,Connecticut,2880415,1839727,1690546,149181
2021-01-01,Delaware,796235,487378,457875,29503
2021-01-01,Florida,17757100,10068685,9587059,481626
2021-01-01,Georgia,8344325,5112237,4853777,258460
2021-01-01,Hawaii,1083148,655766,588116,67650
2021-01-01,Idaho,1426574,900287,869144,31143
2021-01-01,Illinois,9935021,6146410,5673481,472929
2021-01-01,Indiana,5286270,3347810,3206431,141379
2021-01-01,Iowa,2482022,1625153,1567143,58010
2021-01-01,Kansas,2237486,1502248,1450464,51784
2021-01-01,Kentucky,3512884,1989380,1882979,106401
2021-01-01,Louisiana,3578075,2084330,1925840,158490
2021-01-01,Maine,1120850,671317,636270,35047
2021-01-01,Maryland,4773686,3106287,2907520,198767
2021-01-01,Massachusetts,5646187,3756720,3461950,294770
2021-01-01,Michigan,7995094,4736547,4465785,270762
2021-01-01,Minnesota,4458943,3025807,2889849,135958
2021-01-01,Mississippi,2286271,1279970,1197779,82191
2021-01-01,Missouri,4845259,3042955,2912406,130549
2021-01-01,Montana,867082,532910,511691,21219
2021-01-01,Nebraska,1490395,1024822,992112,32710
2021-01-01,Nevada,2505533,1536046,1405483,130563
2021-01-01,Ohio,9262261,5768594,5462512,306082
2021-01-01,Oklahoma,3064511,1864691,1783422,81269
2021-01-01,Oregon,3457167,2150483,2017032,133451
2021-01-01,Pennsylvania,10275393,6294551,5837381,457170
2021-01-01,Tennessee,5469230,3317190,3146950,170240
2021-01-01,Texas,22474687,14063544,13104983,958561
2021-01-01,Utah,2426150,1630721,1580527,50194
2021-01-01,Vermont,518952,314630,304521,10109
2021-01-01,Virginia,6739873,4254052,4026838,227214
2021-01-01,Washington,6136163,3835229,3606638,228591
2021-01-01,Wisconsin,4664495,3056717,2939823,116894
2021-01-01,Wyoming,456106,295132,280002,15130
2021-02-01,Alabama,3891139,2249475,2158410,91065
2021-02-01,Alaska,544693,351042,327734,23308
2021-02-01,Arizona,5942577,3580159,3333218,246941
2021-02-01,Arkansas,2366377,1363154,1301585,61569
2021-02-01,California,31091641,18944536,17334333,1610203
2021-02-01,Colorado,4647075,3187192,2977934,209258
2021-02-01,Connecticut,2879316,1712892,1566755,146137
2021-02-01,Delaware,796901,488849,457878,30971
2021-02-01,Florida,17769891,10124081,9649964,474117
2021-02-01,Georgia,8350072,5145311,4899537,245774
2021-02-01,Hawaii,1082480,655353,595209,60144
2021-02-01,Idaho,1429397,899796,870056,29740
2021-02-01,Illinois,9929473,6138343,5684103,454240
2021-02-01,Indiana,5287355,3342839,3208862,133977
2021-02-01,Iowa,2481881,1628644,1570309,58335
2021-02-01,Kansas,2237550,1499299,1451432,47867
2021-02-01,Kentucky,3513075,1993122,1889699,103423
2021-02-01,Louisiana,3576989,2076336,1919136,157200
2021-02-01,Maine,1121094,672438,639943,32495
2021-02-01,Maryland,4772844,3101248,2909635,191613
2021-02-01,Massachusetts,5644665,3744815,3477684,267131
2021-02-01,Michigan,7993560,4695245,4451945,243300
2021-02-01,Minnesota,4459692,3022136,2892393,129743
2021-02-01,Mississippi,2285852,1281419,1200442,80977
2021-02-01,Missouri,4845885,3050852,2921918,128934
2021-02-01,Montana,867716,531389,510726,20663
2021-02-01,Nebraska,1490687,1021103,989085,32018
2021-02-01,Nevada,2508958,1545250,1416663,128587
2021-02-01,Ohio,9261248,5755857,5467067,288790
2021-02-01,Oklahoma,3065768,1865479,1784164,81315
2021-02-01,Oregon,3459073,2152206,2021269,130937
2021-02-01,Pennsylvania,10273015,6330147,5867367,462780
2021-02-01,Tennessee,5473138,3308238,3145757,162481
2021-02-01,Texas,22500029,14005438,13034964,970474
2021-02-01,Utah,2429915,1630609,1581835,48774
2021-02-01,Vermont,518856,313279,303681,9598
2021-02-01,Virginia,6740927,4238057,4018030,220027
2021-02-01,Washington,6140754,3837392,3621486,215906
2021-02-01,Wisconsin,4665137,3059210,2942805,116405
2021-02-01,Wyoming,456315,295331,279791,15540
